Season,Player,Position,Age,Team,G,GS,MP,FG,FGA,FG%,3P,3PA,3P%,2P,2PA,2P%,FT,FTA,FT%,ORB,DRB,TRB,AST,STL,BLK,TOV,PF,PTS
2014,A.J. Price,SG,27,MIN,28,0,99,19,46,0.413,6,22,0.273,13,24,0.542,0,2,0,1,9,10,13,1,0,7,5,44
2014,Aaron Brooks,PG,29,TOT,72,12,1557,233,581,0.401,96,248,0.387,137,333,0.411,83,95,0.874,43,97,140,233,52,13,117,146,645
2014,Aaron Brooks,PG,29,HOU,43,0,716,104,263,0.395,54,132,0.409,50,131,0.382,37,44,0.841,23,39,62,83,25,6,51,76,299
2014,Aaron Brooks,PG,29,DEN,29,12,841,129,318,0.406,42,116,0.362,87,202,0.431,46,51,0.902,20,58,78,150,27,7,66,70,346
2014,Aaron Gray,C,29,TOT,37,6,355,27,61,0.443,0,1,0,27,60,0.45,11,20,0.55,42,69,111,22,10,8,31,64,65
2014,Aaron Gray,C,29,TOR,4,0,20,2,3,0.667,0,0,,2,3,0.667,1,2,0.5,3,5,8,3,0,0,4,7,5
2014,Aaron Gray,C,29,SAC,33,6,335,25,58,0.431,0,1,0,25,57,0.439,10,18,0.556,39,64,103,19,10,8,27,57,60
2014,Adonis Thomas,SF,20,TOT,6,1,37,6,14,0.429,1,5,0.2,5,9,0.556,1,1,1,0,3,3,3,0,0,1,6,14
2014,Adonis Thomas,SF,20,ORL,4,0,24,3,9,0.333,0,3,0,3,6,0.5,1,1,1,0,3,3,2,0,0,0,2,7
2014,Adonis Thomas,SF,20,PHI,2,1,13,3,5,0.6,1,2,0.5,2,3,0.667,0,0,,0,0,0,1,0,0,1,4,7
2014,Al Harrington,PF,33,WAS,34,0,511,82,207,0.396,34,100,0.34,48,107,0.449,27,35,0.771,15,65,80,28,14,0,34,72,225
2014,Al Horford,C,27,ATL,29,29,958,238,420,0.567,4,11,0.364,234,409,0.572,58,85,0.682,66,178,244,76,27,44,64,56,538
2014,Al Jefferson,C,29,CHA,73,73,2553,700,1376,0.509,3,15,0.2,697,1361,0.512,191,277,0.69,156,636,792,155,67,79,124,176,1594
2014,Al-Farouq Aminu,SF,23,NOP,80,65,2045,234,494,0.474,13,48,0.271,221,446,0.496,91,137,0.664,129,367,496,114,82,38,88,147,572
2014,Alan Anderson,SF,31,BRK,78,26,1773,194,485,0.4,84,248,0.339,110,237,0.464,92,118,0.78,40,135,175,81,48,11,62,147,564
2014,Alec Burks,SG,22,UTA,78,12,2193,380,831,0.457,50,143,0.35,330,688,0.48,279,373,0.748,59,198,257,212,69,14,149,190,1089
2014,Alex Len,C,20,PHO,42,3,362,33,78,0.423,0,0,,33,78,0.423,20,31,0.645,39,60,99,4,4,18,26,68,86
2014,Alexey Shved,SG,25,MIN,63,0,664,76,237,0.321,30,102,0.294,46,135,0.341,68,90,0.756,21,60,81,68,26,16,48,36,250
2014,Alexis Ajinça,C,25,NOP,56,30,951,136,249,0.546,0,1,0,136,248,0.548,56,67,0.836,94,183,277,40,23,46,63,187,328
2014,Allen Crabbe,SG,21,POR,15,0,100,12,33,0.364,6,14,0.429,6,19,0.316,3,4,0.75,1,8,9,6,2,1,3,10,33
2014,Alonzo Gee,SF,26,CLE,65,24,1020,98,236,0.415,19,58,0.328,79,178,0.444,43,61,0.705,35,114,149,47,39,15,44,96,258
2014,Amar'e Stoudemire,C,31,NYK,65,21,1466,311,558,0.557,0,0,,311,558,0.557,150,203,0.739,112,208,320,34,23,37,91,159,772
2014,Amir Johnson,PF,26,TOR,77,72,2214,344,612,0.562,20,66,0.303,324,546,0.593,91,143,0.636,172,333,505,115,56,88,123,271,799
2014,Anderson Varejão,C,31,CLE,65,29,1800,227,459,0.495,0,7,0,227,452,0.502,92,135,0.681,187,442,629,140,69,39,72,164,546
2014,Andray Blatche,PF,27,BRK,73,7,1618,321,674,0.476,15,54,0.278,306,620,0.494,164,221,0.742,120,270,390,112,75,38,110,166,821
2014,Andre Drummond,C,20,DET,81,81,2619,479,769,0.623,0,2,0,479,767,0.625,137,328,0.418,440,631,1071,35,101,131,110,273,1095
2014,Andre Iguodala,SF,30,GSW,63,63,2040,220,458,0.48,62,175,0.354,158,283,0.558,86,132,0.652,53,240,293,263,95,18,100,103,588
2014,Andre Miller,SG,37,TOT,58,2,982,106,231,0.459,11,21,0.524,95,210,0.452,60,77,0.779,28,102,130,197,34,9,61,75,283
2014,Andre Miller,SG,37,DEN,30,2,570,66,144,0.458,9,18,0.5,57,126,0.452,35,47,0.745,16,57,73,100,15,7,33,32,176
2014,Andre Miller,SG,37,WAS,28,0,412,40,87,0.46,2,3,0.667,38,84,0.452,25,30,0.833,12,45,57,97,19,2,28,43,107
2014,Andre Roberson,SG,22,OKC,40,16,399,33,68,0.485,2,13,0.154,31,55,0.564,7,10,0.7,36,58,94,15,19,10,19,74,75
2014,Andrea Bargnani,C,28,NYK,42,39,1257,222,502,0.442,30,108,0.278,192,394,0.487,84,102,0.824,69,153,222,45,14,52,58,100,558
2014,Andrei Kirilenko,PF,32,BRK,45,4,857,82,160,0.513,1,5,0.2,81,155,0.523,61,119,0.513,55,91,146,72,40,19,54,65,226
2014,Andrew Bogut,C,29,GSW,67,67,1769,235,375,0.627,0,0,,235,375,0.627,22,64,0.344,182,489,671,112,47,121,97,210,492
2014,Andrew Bynum,C,26,TOT,26,19,516,94,225,0.418,0,0,,94,225,0.418,37,49,0.755,53,92,145,29,6,29,34,31,225
2014,Andrew Bynum,C,26,CLE,24,19,480,85,203,0.419,0,0,,85,203,0.419,32,42,0.762,47,79,126,27,6,28,30,28,202
2014,Andrew Bynum,C,26,IND,2,0,36,9,22,0.409,0,0,,9,22,0.409,5,7,0.714,6,13,19,2,0,1,4,3,23
2014,Andrew Nicholson,PF,24,ORL,76,5,1174,180,420,0.429,28,89,0.315,152,331,0.459,47,57,0.825,53,202,255,25,18,23,51,150,435
2014,Andris Biedriņš,C,27,UTA,6,0,45,1,1,1,0,0,,1,1,1,1,6,0.167,2,15,17,0,0,0,2,6,3
2014,Antawn Jamison,PF,37,LAC,22,0,248,29,92,0.315,8,41,0.195,21,51,0.412,18,25,0.72,9,46,55,7,9,3,7,29,84
2014,Anthony Bennett,PF,20,CLE,52,0,663,80,225,0.356,13,53,0.245,67,172,0.39,44,69,0.638,49,106,155,17,21,8,47,93,217
2014,Anthony Davis,PF,20,NOP,67,66,2358,522,1005,0.519,2,9,0.222,520,996,0.522,348,440,0.791,207,466,673,105,89,189,109,200,1394
2014,Anthony Morrow,SG,28,NOP,76,9,1426,238,520,0.458,88,195,0.451,150,325,0.462,72,87,0.828,29,111,140,59,38,12,51,102,636
2014,Anthony Randolph,PF,24,DEN,43,5,527,68,176,0.386,18,61,0.295,50,115,0.435,52,69,0.754,20,102,122,32,26,19,39,64,206
2014,Anthony Tolliver,PF,28,CHA,64,9,1298,129,307,0.42,102,247,0.413,27,60,0.45,33,41,0.805,33,135,168,42,19,15,23,82,393
2014,Archie Goodwin,SG,19,PHO,52,0,533,76,167,0.455,5,36,0.139,71,131,0.542,37,55,0.673,25,62,87,20,20,11,44,45,194
2014,Arinze Onuaku,PF,26,TOT,5,0,30,1,5,0.2,0,0,,1,5,0.2,1,2,0.5,2,6,8,3,0,0,1,3,3
2014,Arinze Onuaku,PF,26,NOP,3,0,25,1,4,0.25,0,0,,1,4,0.25,1,2,0.5,2,5,7,3,0,0,1,3,3
2014,Arinze Onuaku,PF,26,CLE,2,0,5,0,1,0,0,0,,0,1,0,0,0,,0,1,1,0,0,0,0,0,0
2014,Arnett Moultrie,PF,23,PHI,12,2,187,16,38,0.421,0,0,,16,38,0.421,4,5,0.8,11,24,35,2,8,4,7,22,36
2014,Aron Baynes,C,27,SAS,53,4,491,71,163,0.436,0,0,,71,163,0.436,19,21,0.905,57,88,145,34,2,5,36,77,161
2014,Arron Afflalo,SG,28,ORL,73,73,2552,464,1011,0.459,128,300,0.427,336,711,0.473,274,336,0.815,32,230,262,248,35,3,146,136,1330
2014,Austin Daye,SF,25,TOT,22,1,148,24,68,0.353,12,37,0.324,12,31,0.387,6,10,0.6,5,22,27,8,4,4,5,18,66
2014,Austin Daye,SF,25,TOR,8,0,33,3,13,0.231,0,8,0,3,5,0.6,2,3,0.667,2,5,7,2,0,0,0,4,8
2014,Austin Daye,SF,25,SAS,14,1,115,21,55,0.382,12,29,0.414,9,26,0.346,4,7,0.571,3,17,20,6,4,4,5,14,58
2014,Austin Rivers,PG,21,NOP,69,4,1339,192,474,0.405,36,99,0.364,156,375,0.416,110,173,0.636,26,103,129,160,45,9,77,134,530
2014,Avery Bradley,SG,23,BOS,60,58,1855,361,825,0.438,79,200,0.395,282,625,0.451,90,112,0.804,48,178,226,85,63,11,96,145,891
2014,Ben Gordon,SG,30,CHA,19,0,279,37,108,0.343,8,29,0.276,29,79,0.367,17,21,0.81,3,24,27,21,10,2,21,18,99
2014,Ben McLemore,SG,20,SAC,82,55,2187,255,679,0.376,95,297,0.32,160,382,0.419,115,143,0.804,53,182,235,82,45,18,96,201,720
2014,Beno Udrih,SG,31,TOT,41,12,643,78,178,0.438,19,42,0.452,59,136,0.434,25,30,0.833,10,49,59,116,23,4,47,50,200
2014,Beno Udrih,SG,31,NYK,31,12,588,68,160,0.425,17,40,0.425,51,120,0.425,20,24,0.833,10,47,57,110,22,3,42,46,173
2014,Beno Udrih,SG,31,MEM,10,0,55,10,18,0.556,2,2,1,8,16,0.5,5,6,0.833,0,2,2,6,1,1,5,4,27
2014,Bernard James,C,28,DAL,30,0,146,11,23,0.478,0,1,0,11,22,0.5,6,11,0.545,15,27,42,3,3,8,10,24,28
2014,Bismack Biyombo,C,21,CHA,77,9,1072,88,144,0.611,0,0,,88,144,0.611,46,89,0.517,105,261,366,8,7,86,40,124,222
2014,Blake Griffin,PF,24,LAC,80,80,2863,718,1359,0.528,12,44,0.273,706,1315,0.537,482,674,0.715,192,565,757,309,92,51,224,265,1930
2014,Boris Diaw,PF,31,SAS,79,24,1974,302,580,0.521,45,112,0.402,257,468,0.549,68,92,0.739,74,252,326,222,44,32,121,140,717
2014,Bradley Beal,SG,20,WAS,73,73,2530,481,1149,0.419,138,343,0.402,343,806,0.426,149,189,0.788,54,219,273,243,71,18,128,153,1249
2014,Brandan Wright,C,26,DAL,58,0,1077,224,331,0.677,0,0,,224,331,0.677,77,106,0.726,102,142,244,31,32,55,35,94,525
2014,Brandon Bass,PF,28,BOS,82,73,2266,352,725,0.486,2,6,0.333,350,719,0.487,205,239,0.858,161,309,470,87,36,71,102,190,911
2014,Brandon Davies,PF,22,PHI,51,0,575,54,128,0.422,2,10,0.2,52,118,0.441,34,53,0.642,38,71,109,28,24,8,35,92,144
2014,Brandon Jennings,PG,24,DET,80,79,2728,423,1135,0.373,154,457,0.337,269,678,0.397,241,321,0.751,59,185,244,609,101,8,215,157,1241
2014,Brandon Knight,PG,22,MIL,72,69,2400,461,1092,0.422,110,338,0.325,351,754,0.466,259,323,0.802,46,209,255,352,69,17,188,146,1291
2014,Brandon Rush,SG,28,UTA,38,0,418,30,90,0.333,16,47,0.34,14,43,0.326,3,5,0.6,5,39,44,24,5,9,20,31,79
2014,Brian Roberts,PG,28,NOP,72,42,1667,244,581,0.42,64,178,0.36,180,403,0.447,125,133,0.94,17,119,136,234,43,7,95,132,677
2014,Brook Lopez,C,25,BRK,17,17,533,129,229,0.563,0,1,0,129,228,0.566,94,115,0.817,39,63,102,16,9,30,28,52,352
2014,Byron Mullens,C,24,TOT,45,0,414,73,165,0.442,33,89,0.371,40,76,0.526,10,20,0.5,24,68,92,14,15,11,27,64,189
2014,Byron Mullens,C,24,LAC,27,0,167,26,64,0.406,13,39,0.333,13,25,0.52,2,6,0.333,7,25,32,6,6,3,13,33,67
2014,Byron Mullens,C,24,PHI,18,0,247,47,101,0.465,20,50,0.4,27,51,0.529,8,14,0.571,17,43,60,8,9,8,14,31,122
2014,C.J. Miles,SG,26,CLE,51,34,984,178,409,0.435,83,211,0.393,95,198,0.48,64,75,0.853,18,85,103,52,46,15,44,103,503
2014,C.J. Watson,PG,29,IND,63,5,1193,146,334,0.437,53,145,0.366,93,189,0.492,69,88,0.784,19,82,101,107,60,8,60,66,414
2014,Carl Landry,PF,30,SAC,18,1,233,31,60,0.517,0,0,,31,60,0.517,14,17,0.824,15,42,57,5,3,1,9,34,76
2014,Carlos Boozer,PF,32,CHI,76,76,2141,447,980,0.456,0,2,0,447,978,0.457,148,193,0.767,137,495,632,118,53,22,154,216,1042
2014,Carmelo Anthony,PF,29,NYK,77,77,2982,743,1643,0.452,167,415,0.402,576,1228,0.469,459,541,0.848,145,477,622,242,95,51,198,224,2112
2014,Caron Butler,SF,33,TOT,56,13,1419,213,540,0.394,98,249,0.394,115,291,0.395,63,75,0.84,21,208,229,82,47,17,60,120,587
2014,Caron Butler,SF,33,MIL,34,13,821,137,354,0.387,53,147,0.361,84,207,0.406,47,56,0.839,16,142,158,56,23,11,52,64,374
2014,Caron Butler,SF,33,OKC,22,0,598,76,186,0.409,45,102,0.441,31,84,0.369,16,19,0.842,5,66,71,26,24,6,8,56,213
2014,Carrick Felix,SG,23,CLE,7,0,38,7,14,0.5,2,5,0.4,5,9,0.556,3,4,0.75,1,5,6,4,0,0,4,4,19
2014,Cartier Martin,SF,29,TOT,59,6,870,111,264,0.42,59,151,0.391,52,113,0.46,48,65,0.738,13,97,110,33,27,7,34,71,329
2014,Cartier Martin,SF,29,ATL,53,6,822,106,256,0.414,56,146,0.384,50,110,0.455,46,61,0.754,12,93,105,31,26,7,33,68,314
2014,Cartier Martin,SF,29,CHI,6,0,48,5,8,0.625,3,5,0.6,2,3,0.667,2,4,0.5,1,4,5,2,1,0,1,3,15
2014,Casper Ware,PG,24,PHI,9,0,116,18,42,0.429,7,21,0.333,11,21,0.524,5,6,0.833,0,9,9,10,8,0,5,11,48
2014,Chandler Parsons,SF,25,HOU,74,74,2783,466,987,0.472,130,351,0.37,336,636,0.528,164,221,0.742,69,340,409,298,88,29,144,168,1226
2014,Channing Frye,PF,30,PHO,82,82,2312,336,778,0.432,160,432,0.37,176,346,0.509,78,95,0.821,73,343,416,98,60,63,89,245,910
2014,Charlie Villanueva,PF,29,DET,20,0,180,35,92,0.38,14,56,0.25,21,36,0.583,8,14,0.571,6,28,34,6,4,5,7,16,92
2014,Chase Budinger,SF,25,MIN,41,8,751,100,254,0.394,42,120,0.35,58,134,0.433,32,39,0.821,19,84,103,31,19,2,24,58,274
2014,Chauncey Billups,SG,37,DET,19,7,309,24,79,0.304,14,48,0.292,10,31,0.323,10,12,0.833,4,24,28,42,8,1,25,25,72
2014,Chris Andersen,C,35,MIA,72,0,1396,177,275,0.644,3,12,0.25,174,263,0.662,120,169,0.71,129,250,379,19,32,97,53,162,477
2014,Chris Babb,SG,23,BOS,14,0,132,8,30,0.267,6,27,0.222,2,3,0.667,0,0,,4,13,17,3,6,0,3,13,22
2014,Chris Bosh*,C,29,MIA,79,79,2531,492,953,0.516,74,218,0.339,418,735,0.569,223,272,0.82,98,424,522,87,80,78,125,192,1281
2014,Chris Copeland,SF,29,IND,41,0,265,55,117,0.47,33,79,0.418,22,38,0.579,10,14,0.714,7,25,32,18,3,7,14,38,153
2014,Chris Douglas-Roberts,SF,27,CHA,49,8,1016,111,252,0.44,51,132,0.386,60,120,0.5,66,82,0.805,16,103,119,51,29,16,36,61,339
2014,Chris Johnson,SF,23,BOS,40,0,789,85,214,0.397,43,127,0.339,42,87,0.483,37,43,0.86,31,66,97,31,27,4,22,63,250
2014,Chris Kaman,C,31,LAL,39,13,736,176,346,0.509,0,3,0,176,343,0.513,52,68,0.765,54,175,229,58,11,40,74,93,404
2014,Chris Paul,PG,28,LAC,62,62,2171,406,870,0.467,78,212,0.368,328,658,0.498,295,345,0.855,38,230,268,663,154,4,145,157,1185
2014,Chris Singleton,SF,24,WAS,25,0,250,25,67,0.373,7,19,0.368,18,48,0.375,18,25,0.72,18,37,55,6,9,3,17,25,75
2014,Chris Smith,PG,26,NYK,2,0,2,0,0,,0,0,,0,0,,0,0,,0,0,0,0,0,0,0,0,0
2014,Chris Wright,SF,25,MIL,8,0,126,21,35,0.6,0,1,0,21,34,0.618,6,15,0.4,10,10,20,5,7,5,5,17,48
2014,Chuck Hayes,C,30,TOT,61,1,754,56,130,0.431,0,1,0,56,129,0.434,20,25,0.8,69,141,210,35,34,12,33,95,132
2014,Chuck Hayes,C,30,SAC,16,1,179,14,32,0.438,0,0,,14,32,0.438,5,7,0.714,20,27,47,6,11,2,7,18,33
2014,Chuck Hayes,C,30,TOR,45,0,575,42,98,0.429,0,1,0,42,97,0.433,15,18,0.833,49,114,163,29,23,10,26,77,99
2014,CJ McCollum,SG,22,POR,38,0,476,74,178,0.416,30,80,0.375,44,98,0.449,23,34,0.676,7,41,48,27,14,2,35,53,201
2014,Cody Zeller,C,21,CHA,82,3,1416,172,404,0.426,0,1,0,172,403,0.427,146,200,0.73,118,235,353,92,40,41,87,170,490
2014,Cole Aldrich,C,25,NYK,46,2,330,33,61,0.541,0,0,,33,61,0.541,26,30,0.867,37,92,129,14,8,30,18,40,92
2014,Corey Brewer,SF,27,MIN,81,81,2609,388,807,0.481,59,211,0.28,329,596,0.552,163,227,0.718,63,144,207,135,151,30,105,210,998
2014,Cory Joseph,SG,22,SAS,68,19,936,126,265,0.475,12,38,0.316,114,227,0.502,79,96,0.823,32,75,107,114,35,14,43,84,343
2014,Courtney Lee,SG,28,TOT,79,47,1973,295,614,0.48,72,194,0.371,223,420,0.531,99,112,0.884,29,158,187,115,65,28,73,127,761
2014,Courtney Lee,SG,28,BOS,30,0,504,90,183,0.492,23,52,0.442,67,131,0.511,18,22,0.818,8,41,49,32,20,9,25,37,221
2014,Courtney Lee,SG,28,MEM,49,47,1469,205,431,0.476,49,142,0.345,156,289,0.54,81,90,0.9,21,117,138,83,45,19,48,90,540
2014,D.J. Augustin,PG,26,TOT,71,9,1939,298,718,0.415,133,332,0.401,165,386,0.427,201,227,0.885,15,115,130,313,53,3,125,147,930
2014,D.J. Augustin,PG,26,TOR,10,0,82,7,24,0.292,1,11,0.091,6,13,0.462,6,6,1,0,4,4,10,1,0,9,7,21
2014,D.J. Augustin,PG,26,CHI,61,9,1857,291,694,0.419,132,321,0.411,159,373,0.426,195,221,0.882,15,111,126,303,52,3,116,140,909
2014,D.J. Stephens,SG,23,MIL,3,0,15,3,7,0.429,0,0,,3,7,0.429,1,1,1,1,4,5,0,0,0,0,0,7
2014,D.J. White,PF,27,CHA,2,0,10,0,1,0,0,0,,0,1,0,0,0,,0,2,2,0,1,0,0,1,0
2014,Damian Lillard,PG,23,POR,82,82,2937,553,1304,0.424,218,554,0.394,335,750,0.447,371,426,0.871,35,253,288,457,64,22,193,197,1695
2014,Damion James,SF,26,SAS,5,1,50,2,9,0.222,0,2,0,2,7,0.286,2,2,1,1,11,12,3,0,1,1,3,6
2014,Daniel Orton,C,23,PHI,22,4,251,21,47,0.447,0,0,,21,47,0.447,23,30,0.767,16,45,61,15,6,16,18,38,65
2014,Danny Granger,SF,30,TOT,41,2,847,116,307,0.378,43,128,0.336,73,179,0.408,63,67,0.94,31,102,133,41,12,17,46,62,338
2014,Danny Granger,SF,30,IND,29,2,653,80,223,0.359,31,94,0.33,49,129,0.38,51,53,0.962,24,81,105,33,9,13,36,41,242
2014,Danny Granger,SF,30,LAC,12,0,194,36,84,0.429,12,34,0.353,24,50,0.48,12,14,0.857,7,21,28,8,3,4,10,21,96
2014,Danny Green,SG,26,SAS,68,59,1651,218,505,0.432,132,318,0.415,86,187,0.46,50,63,0.794,25,204,229,104,65,61,76,107,618
2014,Dante Cunningham,PF,26,MIN,81,7,1635,236,509,0.464,0,5,0,236,504,0.468,38,67,0.567,112,218,330,83,62,58,42,146,510
2014,Darius Johnson-Odom,SG,24,PHI,3,0,15,0,7,0,0,3,0,0,4,0,0,2,0,0,2,2,1,1,0,2,3,0
2014,Darius Miller,SF,23,NOP,45,7,723,73,166,0.44,25,77,0.325,48,89,0.539,29,36,0.806,9,43,52,43,24,9,22,88,200
2014,Darius Morris,PG,23,TOT,27,0,313,39,96,0.406,12,38,0.316,27,58,0.466,17,26,0.654,7,19,26,44,13,0,27,33,107
2014,Darius Morris,PG,23,PHI,12,0,193,29,67,0.433,10,24,0.417,19,43,0.442,15,21,0.714,3,10,13,31,8,0,19,21,83
2014,Darius Morris,PG,23,LAC,10,0,54,4,13,0.308,0,7,0,4,6,0.667,1,2,0.5,0,5,5,5,2,0,2,9,9
2014,Darius Morris,PG,23,MEM,5,0,66,6,16,0.375,2,7,0.286,4,9,0.444,1,3,0.333,4,4,8,8,3,0,6,3,15
2014,Darrell Arthur,SF,25,DEN,68,1,1161,162,410,0.395,24,64,0.375,138,346,0.399,53,62,0.855,52,158,210,61,39,47,58,185,401
2014,Darren Collison,PG,26,LAC,80,35,2069,324,694,0.467,71,189,0.376,253,505,0.501,192,224,0.857,47,141,188,297,93,15,132,150,911
2014,David Lee,PF,30,GSW,69,67,2288,513,981,0.523,0,1,0,513,980,0.523,231,296,0.78,182,461,643,147,48,26,152,206,1257
2014,David West,PF,33,IND,80,80,2472,458,939,0.488,4,15,0.267,454,924,0.491,198,251,0.789,120,422,542,223,61,74,133,186,1118
2014,DeAndre Jordan,C,25,LAC,82,82,2870,348,515,0.676,0,0,,348,515,0.676,160,374,0.428,331,783,1114,74,80,203,123,264,856
2014,DeAndre Liggins,SG,25,MIA,1,0,1,1,1,1,0,0,,1,1,1,0,0,,1,0,1,0,0,0,0,0,2
2014,DeJuan Blair,PF,24,DAL,78,13,1214,210,393,0.534,0,2,0,210,391,0.537,77,121,0.636,139,229,368,70,60,21,77,192,497
2014,DeMar DeRozan,SG,24,TOR,79,79,3017,604,1407,0.429,64,210,0.305,540,1197,0.451,519,630,0.824,51,292,343,313,86,28,176,197,1791
2014,DeMarcus Cousins,C,23,SAC,71,71,2298,591,1191,0.496,0,7,0,591,1184,0.499,432,595,0.726,218,613,831,207,109,91,251,270,1614
2014,DeMarre Carroll,SF,27,ATL,73,73,2341,302,642,0.47,97,268,0.362,205,374,0.548,109,141,0.773,107,296,403,134,108,21,79,188,810
2014,Dennis Schröder,PG,20,ATL,49,0,641,72,188,0.383,10,42,0.238,62,146,0.425,29,43,0.674,5,55,60,93,17,0,61,54,183
2014,Derek Fisher,SG,39,OKC,81,0,1428,141,361,0.391,88,229,0.384,53,132,0.402,55,71,0.775,12,110,122,117,70,3,49,157,425
2014,Deron Williams,PG,29,BRK,64,58,2059,322,716,0.45,98,268,0.366,224,448,0.5,173,216,0.801,15,153,168,392,93,13,143,148,915
2014,Derrick Favors,PF,22,UTA,73,73,2201,390,747,0.522,0,1,0,390,746,0.523,190,284,0.669,199,438,637,91,75,108,129,236,970
2014,Derrick Rose,PG,25,CHI,10,10,311,58,164,0.354,16,47,0.34,42,117,0.359,27,32,0.844,9,23,32,43,5,1,34,15,159
2014,Derrick Williams,SF-PF,22,TOT,78,15,1820,206,482,0.427,26,99,0.263,180,383,0.47,186,259,0.718,71,252,323,56,48,20,76,114,624
2014,Derrick Williams,PF,22,MIN,11,0,162,19,54,0.352,2,15,0.133,17,39,0.436,14,16,0.875,3,23,26,1,4,4,6,9,54
2014,Derrick Williams,SF,22,SAC,67,15,1658,187,428,0.437,24,84,0.286,163,344,0.474,172,243,0.708,68,229,297,55,44,16,70,105,570
2014,Devin Harris,PG,30,DAL,40,0,818,96,254,0.378,31,101,0.307,65,153,0.425,92,115,0.8,8,77,85,178,28,2,59,72,315
2014,Dewayne Dedmon,C,24,TOT,31,6,390,38,83,0.458,0,0,,38,83,0.458,21,32,0.656,38,89,127,5,7,22,18,66,97
2014,Dewayne Dedmon,C,24,GSW,4,0,6,0,1,0,0,0,,0,1,0,1,2,0.5,0,0,0,0,0,0,0,1,1
2014,Dewayne Dedmon,C,24,PHI,11,0,150,15,29,0.517,0,0,,15,29,0.517,7,13,0.538,11,38,49,3,0,9,9,28,37
2014,Dewayne Dedmon,C,24,ORL,16,6,234,23,53,0.434,0,0,,23,53,0.434,13,17,0.765,27,51,78,2,7,13,9,37,59
2014,Dexter Pittman,C,25,ATL,2,0,3,0,1,0,0,0,,0,1,0,0,2,0,3,0,3,0,0,0,0,0,0
2014,Diante Garrett,PG,25,UTA,71,0,1048,101,265,0.381,36,96,0.375,65,169,0.385,10,12,0.833,11,86,97,120,41,5,75,75,248
2014,Dion Waiters,SG,22,CLE,70,24,2072,430,993,0.433,92,250,0.368,338,743,0.455,161,235,0.685,32,163,195,209,63,17,154,153,1113
2014,Dionte Christmas,SF,27,PHO,31,0,198,22,62,0.355,9,31,0.29,13,31,0.419,18,24,0.75,13,25,38,8,2,3,6,19,71
2014,Dirk Nowitzki,PF,35,DAL,80,80,2628,633,1273,0.497,131,329,0.398,502,944,0.532,338,376,0.899,40,458,498,216,73,45,117,165,1735
2014,Donald Sloan,SG,26,IND,48,1,392,44,117,0.376,10,42,0.238,34,75,0.453,12,20,0.6,4,40,44,50,10,1,22,19,110
2014,Donatas Motiejūnas,PF,23,HOU,62,3,952,131,296,0.443,21,84,0.25,110,212,0.519,58,96,0.604,60,165,225,34,20,21,49,132,341
2014,Dorell Wright,SF,28,POR,68,13,984,111,297,0.374,69,202,0.342,42,95,0.442,52,69,0.754,29,162,191,64,23,16,39,62,343
2014,Doron Lamb,SG,22,ORL,53,0,695,63,160,0.394,36,90,0.4,27,70,0.386,29,36,0.806,8,41,49,43,11,1,27,54,191
2014,Draymond Green,SF,23,GSW,82,12,1797,187,459,0.407,55,165,0.333,132,294,0.449,82,123,0.667,86,323,409,152,102,72,91,231,511
2014,Drew Gooden,C,32,WAS,22,0,395,76,143,0.531,7,17,0.412,69,126,0.548,24,27,0.889,37,77,114,15,10,7,17,53,183
2014,Dwight Buycks,PG,24,TOR,14,0,146,15,48,0.313,5,17,0.294,10,31,0.323,8,9,0.889,4,19,23,10,8,0,10,11,43
2014,Dwight Howard,C,28,HOU,71,71,2396,473,800,0.591,2,7,0.286,471,793,0.594,349,638,0.547,231,635,866,131,60,128,229,240,1297
2014,Dwyane Wade,SG,32,MIA,54,53,1775,415,761,0.545,9,32,0.281,406,729,0.557,189,258,0.733,60,181,241,252,79,29,161,106,1028
2014,E'Twaun Moore,SG,24,ORL,79,3,1506,195,456,0.428,57,161,0.354,138,295,0.468,52,68,0.765,29,107,136,112,60,13,55,106,499
2014,Earl Clark,PF,26,TOT,54,17,768,97,261,0.372,41,122,0.336,56,139,0.403,22,34,0.647,22,121,143,18,17,25,31,67,257
2014,Earl Clark,PF,26,CLE,45,17,698,90,240,0.375,40,116,0.345,50,124,0.403,14,24,0.583,20,107,127,16,16,19,30,61,234
2014,Earl Clark,PF,26,NYK,9,0,70,7,21,0.333,1,6,0.167,6,15,0.4,8,10,0.8,2,14,16,2,1,6,1,6,23
2014,Earl Watson,PG,34,POR,24,0,161,3,11,0.273,2,7,0.286,1,4,0.25,4,4,1,5,10,15,28,5,1,17,33,12
2014,Ed Davis,PF,24,MEM,63,4,956,155,290,0.534,0,0,,155,290,0.534,47,89,0.528,92,168,260,27,17,43,40,114,357
2014,Ekpe Udoh,PF,26,MIL,42,14,804,57,143,0.399,0,0,,57,143,0.399,30,47,0.638,61,87,148,31,15,44,38,96,144
2014,Elias Harris,SF,24,LAL,2,0,11,0,1,0,0,0,,0,1,0,0,0,,1,0,1,1,1,0,0,0,0
2014,Elliot Williams,SG,24,PHI,67,2,1157,140,337,0.415,37,125,0.296,103,212,0.486,87,119,0.731,30,100,130,72,35,3,68,126,404
2014,Elton Brand,C,34,ATL,73,15,1414,179,332,0.539,0,2,0,179,330,0.542,61,94,0.649,97,264,361,74,40,88,60,192,419
2014,Enes Freedom,C,21,UTA,80,37,2138,419,853,0.491,0,1,0,419,852,0.492,149,204,0.73,222,376,598,75,28,42,144,230,987
2014,Eric Bledsoe,PG,24,PHO,43,40,1416,265,556,0.477,50,140,0.357,215,416,0.517,183,237,0.772,27,175,202,235,69,14,143,99,763
2014,Eric Gordon,SG,25,NOP,64,64,2057,356,817,0.436,101,258,0.391,255,559,0.456,175,223,0.785,30,135,165,208,74,12,134,114,988
2014,Eric Maynor,PG,26,TOT,31,0,327,32,101,0.317,12,37,0.324,20,64,0.313,6,11,0.545,9,30,39,52,9,3,29,17,82
2014,Eric Maynor,PG,26,WAS,23,0,215,21,72,0.292,8,25,0.32,13,47,0.277,2,3,0.667,7,17,24,40,5,1,17,13,52
2014,Eric Maynor,PG,26,PHI,8,0,112,11,29,0.379,4,12,0.333,7,17,0.412,4,8,0.5,2,13,15,12,4,2,12,4,30
2014,Erik Murphy,C,23,CHI,24,0,62,3,13,0.231,0,3,0,3,10,0.3,0,0,,2,6,8,2,0,4,2,7,6
2014,Ersan İlyasova,PF,26,MIL,55,47,1478,237,579,0.409,37,131,0.282,200,448,0.446,107,130,0.823,107,235,342,72,46,8,61,135,618
2014,Evan Fournier,SG,21,DEN,76,4,1503,228,544,0.419,89,237,0.376,139,307,0.453,93,123,0.756,34,168,202,112,34,7,100,179,638
2014,Evan Turner,SF,25,TOT,81,56,2457,434,1021,0.425,50,156,0.321,384,865,0.444,213,262,0.813,62,346,408,262,67,7,189,195,1131
2014,Evan Turner,SF,25,PHI,54,54,1886,356,831,0.428,38,132,0.288,318,699,0.455,189,228,0.829,50,272,322,198,56,5,155,147,939
2014,Evan Turner,SF,25,IND,27,2,571,78,190,0.411,12,24,0.5,66,166,0.398,24,34,0.706,12,74,86,64,11,2,34,48,192
2014,Francisco García,SF,32,HOU,55,4,1083,118,294,0.401,69,193,0.358,49,101,0.485,10,19,0.526,21,101,122,63,27,33,30,120,315
2014,Gal Mekel,PG,25,DAL,31,1,292,30,86,0.349,5,20,0.25,25,66,0.379,8,12,0.667,5,22,27,63,4,1,31,31,73
2014,Garrett Temple,SG,27,WAS,75,0,638,51,141,0.362,6,29,0.207,45,112,0.402,30,43,0.698,21,47,68,72,35,11,42,72,138
2014,Gary Neal,SG,29,TOT,52,3,1114,193,471,0.41,68,180,0.378,125,291,0.43,94,105,0.895,10,80,90,83,18,0,64,65,548
2014,Gary Neal,SG,29,MIL,30,2,607,108,277,0.39,40,111,0.36,68,166,0.41,45,54,0.833,8,42,50,46,7,0,39,26,301
2014,Gary Neal,SG,29,CHA,22,1,507,85,194,0.438,28,69,0.406,57,125,0.456,49,51,0.961,2,38,40,37,11,0,25,39,247
2014,George Hill,PG,27,IND,76,76,2434,272,616,0.442,95,260,0.365,177,356,0.497,142,176,0.807,53,230,283,265,75,23,92,158,781
2014,Gerald Green,SG,28,PHO,82,48,2330,448,1006,0.445,204,510,0.4,244,496,0.492,195,230,0.848,48,227,275,122,70,42,145,220,1295
2014,Gerald Henderson,SG,26,CHA,77,77,2461,403,930,0.433,40,115,0.348,363,815,0.445,235,309,0.761,31,279,310,199,51,32,113,159,1081
2014,Gerald Wallace,SF,31,BOS,58,16,1416,116,230,0.504,19,64,0.297,97,166,0.584,47,101,0.465,36,176,212,143,73,14,97,79,298
2014,Giannis Antetokounmpo,SF,19,MIL,77,23,1897,173,418,0.414,41,118,0.347,132,300,0.44,138,202,0.683,78,261,339,150,60,61,122,173,525
2014,Gigi Datome,SF,26,DET,34,0,238,34,97,0.351,7,39,0.179,27,58,0.466,8,10,0.8,14,32,46,11,6,1,11,20,83
2014,Glen Davis,PF,28,TOT,68,44,1662,271,593,0.457,4,11,0.364,267,582,0.459,95,137,0.693,108,243,351,77,58,29,76,159,641
2014,Glen Davis,PF,28,ORL,45,43,1354,232,512,0.453,4,10,0.4,228,502,0.454,77,114,0.675,87,195,282,70,46,22,59,111,545
2014,Glen Davis,PF,28,LAC,23,1,308,39,81,0.481,0,1,0,39,80,0.488,18,23,0.783,21,48,69,7,12,7,17,48,96
2014,Glen Rice Jr.,SG,23,WAS,11,1,109,11,37,0.297,5,17,0.294,6,20,0.3,5,7,0.714,4,16,20,7,6,1,9,7,32
2014,Goran Dragić,SG,27,PHO,76,75,2668,552,1093,0.505,122,299,0.408,430,794,0.542,316,416,0.76,69,176,245,447,104,22,213,206,1542
2014,Gordon Hayward,SF,23,UTA,77,77,2800,426,1032,0.413,85,280,0.304,341,752,0.453,311,381,0.816,62,329,391,400,110,40,212,155,1248
2014,Gorgui Dieng,C,24,MIN,60,15,818,113,227,0.498,1,1,1,112,226,0.496,59,93,0.634,103,197,300,39,30,50,54,108,286
2014,Greg Monroe,PF,23,DET,82,82,2690,504,1015,0.497,0,1,0,504,1014,0.497,241,367,0.657,256,504,760,171,91,47,166,205,1249
2014,Greg Oden,C,26,MIA,23,6,212,27,49,0.551,0,0,,27,49,0.551,13,23,0.565,23,31,54,1,7,13,12,52,67
2014,Greg Smith,C,23,HOU,11,0,100,18,28,0.643,0,0,,18,28,0.643,2,5,0.4,11,16,27,0,1,2,5,17,38
2014,Greg Stiemsma,C,28,NOP,55,20,1007,70,122,0.574,0,1,0,70,121,0.579,19,32,0.594,72,154,226,36,35,57,44,169,159
2014,Greivis Vásquez,PG,27,TOT,79,23,1779,277,658,0.421,109,289,0.377,168,369,0.455,95,108,0.88,20,153,173,323,31,5,128,143,758
2014,Greivis Vásquez,PG,27,SAC,18,18,465,65,150,0.433,16,50,0.32,49,100,0.49,30,32,0.938,5,29,34,95,6,1,27,38,176
2014,Greivis Vásquez,PG,27,TOR,61,5,1314,212,508,0.417,93,239,0.389,119,269,0.442,65,76,0.855,15,124,139,228,25,4,101,105,582
2014,Gustavo Ayón,C,28,ATL,26,14,429,52,102,0.51,0,0,,52,102,0.51,8,20,0.4,42,83,125,28,25,10,29,47,112
2014,Hamady N'Diaye,C,27,SAC,14,0,74,3,9,0.333,0,0,,3,9,0.333,0,1,0,5,13,18,3,0,4,3,15,6
2014,Harrison Barnes,SF,21,GSW,78,24,2204,271,679,0.399,66,190,0.347,205,489,0.419,130,181,0.718,66,245,311,116,65,20,84,158,738
2014,Hasheem Thabeet,C,26,OKC,23,0,192,13,23,0.565,0,0,,13,23,0.565,1,5,0.2,9,31,40,1,4,9,14,47,27
2014,Hedo Türkoğlu,SF,34,LAC,38,0,392,42,109,0.385,22,50,0.44,20,59,0.339,9,18,0.5,11,78,89,33,19,10,16,50,115
2014,Henry Sims,C,23,TOT,46,25,875,130,274,0.474,0,1,0,130,273,0.476,90,121,0.744,104,133,237,52,28,20,41,116,350
2014,Henry Sims,C,23,CLE,20,0,168,18,45,0.4,0,0,,18,45,0.4,8,14,0.571,22,34,56,5,5,7,8,32,44
2014,Henry Sims,C,23,PHI,26,25,707,112,229,0.489,0,1,0,112,228,0.491,82,107,0.766,82,99,181,47,23,13,33,84,306
2014,Hilton Armstrong,C,29,GSW,15,1,97,9,19,0.474,0,0,,9,19,0.474,7,16,0.438,19,28,47,5,4,4,6,11,25
2014,Hollis Thompson,SF,22,PHI,77,41,1742,171,372,0.46,67,167,0.401,104,205,0.507,52,73,0.712,73,174,247,73,53,12,60,144,461
2014,Ian Clark,SG,22,UTA,23,0,172,26,67,0.388,11,31,0.355,15,36,0.417,5,7,0.714,3,16,19,15,8,2,14,24,68
2014,Ian Mahinmi,C,27,IND,77,1,1248,91,189,0.481,0,1,0,91,188,0.484,90,145,0.621,107,150,257,24,41,72,58,207,272
2014,Iman Shumpert,SG,23,NYK,74,58,1962,183,484,0.378,76,228,0.333,107,256,0.418,53,71,0.746,81,227,308,129,92,13,79,209,495
2014,Isaiah Canaan,PG,22,HOU,22,0,252,31,87,0.356,18,55,0.327,13,32,0.406,21,29,0.724,7,17,24,22,8,4,21,25,101
2014,Isaiah Thomas,PG,24,SAC,72,54,2497,496,1096,0.453,127,364,0.349,369,732,0.504,346,407,0.85,47,163,210,454,93,8,213,185,1465
2014,Ish Smith,PG,25,PHO,70,1,1006,119,281,0.423,1,23,0.043,118,258,0.457,22,39,0.564,31,98,129,179,49,13,65,66,261
2014,J.J. Barea,PG,29,MIN,79,1,1471,254,656,0.387,73,231,0.316,181,425,0.426,79,100,0.79,16,138,154,303,26,0,125,129,660
2014,J.J. Hickson,PF,25,DEN,69,52,1859,332,654,0.508,0,8,0,332,646,0.514,150,290,0.517,206,426,632,96,47,51,128,177,814
2014,J.J. Redick,SG,29,LAC,35,34,987,181,398,0.455,73,185,0.395,108,213,0.507,97,106,0.915,9,65,74,78,28,3,42,65,532
2014,J.R. Smith,SF,28,NYK,74,37,2421,396,955,0.415,189,480,0.394,207,475,0.436,90,138,0.652,35,261,296,219,65,20,108,196,1071
2014,Jae Crowder,SF,23,DAL,78,8,1254,130,296,0.439,50,151,0.331,80,145,0.552,46,61,0.754,46,148,194,60,59,21,41,100,356
2014,Jamaal Franklin,SG,22,MEM,21,0,161,16,39,0.41,5,11,0.455,11,28,0.393,2,2,1,4,19,23,6,4,2,11,23,39
2014,Jamaal Tinsley,PG,35,UTA,8,5,110,4,20,0.2,1,15,0.067,3,5,0.6,0,0,,2,9,11,23,2,0,9,10,9
2014,Jamal Crawford,SG,33,LAC,69,24,2094,421,1011,0.416,161,446,0.361,260,565,0.46,279,322,0.866,34,124,158,223,59,12,135,120,1282
2014,Jameer Nelson,PG,31,ORL,68,68,2179,294,747,0.394,136,391,0.348,158,356,0.444,96,112,0.857,29,202,231,476,52,5,166,146,820
2014,James Anderson,SG,24,PHI,80,62,2309,309,717,0.431,115,351,0.328,194,366,0.53,77,106,0.726,59,241,300,149,74,28,106,154,810
2014,James Harden,SG,24,HOU,73,73,2777,549,1205,0.456,177,483,0.366,372,722,0.515,576,665,0.866,61,283,344,446,115,29,265,177,1851
2014,James Johnson,SF,26,MEM,52,4,956,143,308,0.464,22,87,0.253,121,221,0.548,76,90,0.844,60,106,166,111,42,57,66,102,384
2014,James Jones,SF,33,MIA,20,6,236,31,68,0.456,28,54,0.519,3,14,0.214,7,11,0.636,2,21,23,9,3,4,4,6,97
2014,James Nunnally,SF,23,TOT,13,0,165,15,46,0.326,8,25,0.32,7,21,0.333,6,9,0.667,1,18,19,8,6,2,7,11,44
2014,James Nunnally,SF,23,ATL,4,0,54,6,18,0.333,3,10,0.3,3,8,0.375,3,4,0.75,1,7,8,2,1,1,4,2,18
2014,James Nunnally,SF,23,PHI,9,0,111,9,28,0.321,5,15,0.333,4,13,0.308,3,5,0.6,0,11,11,6,5,1,3,9,26
2014,James Southerland,SF,23,TOT,4,0,30,5,15,0.333,3,6,0.5,2,9,0.222,1,2,0.5,0,8,8,0,1,2,1,3,14
2014,James Southerland,SF,23,CHA,1,0,3,0,3,0,0,1,0,0,2,0,0,0,,0,0,0,0,0,0,0,0,0
2014,James Southerland,SF,23,NOP,3,0,27,5,12,0.417,3,5,0.6,2,7,0.286,1,2,0.5,0,8,8,0,1,2,1,3,14
2014,Jan Veselý,PF,23,TOT,54,1,776,89,173,0.514,0,0,,89,173,0.514,19,56,0.339,81,110,191,21,53,35,36,121,197
2014,Jan Veselý,PF,23,WAS,33,1,470,48,92,0.522,0,0,,48,92,0.522,8,30,0.267,53,60,113,10,26,19,22,64,104
2014,Jan Veselý,PF,23,DEN,21,0,306,41,81,0.506,0,0,,41,81,0.506,11,26,0.423,28,50,78,11,27,16,14,57,93
2014,Jannero Pargo,PG,34,CHA,29,0,242,52,118,0.441,24,60,0.4,28,58,0.483,8,11,0.727,1,19,20,52,14,1,26,17,136
2014,Jared Cunningham,SG,22,TOT,13,0,80,6,21,0.286,1,7,0.143,5,14,0.357,13,16,0.813,1,5,6,8,3,0,2,16,26
2014,Jared Cunningham,SG,22,ATL,5,0,22,1,2,0.5,0,1,0,1,1,1,0,2,0,0,1,1,3,0,0,2,3,2
2014,Jared Cunningham,SG,22,SAC,8,0,58,5,19,0.263,1,6,0.167,4,13,0.308,13,14,0.929,1,4,5,5,3,0,0,13,24
2014,Jared Dudley,SF,28,LAC,74,43,1729,196,447,0.438,81,225,0.36,115,222,0.518,38,58,0.655,36,124,160,104,41,10,56,146,511
2014,Jared Sullinger,PF,21,BOS,74,44,2041,384,899,0.427,56,208,0.269,328,691,0.475,158,203,0.778,241,360,601,118,35,49,119,251,982
2014,Jarrett Jack,PG,30,CLE,80,31,2252,286,698,0.41,63,185,0.341,223,513,0.435,125,149,0.839,22,201,223,324,56,22,133,133,760
2014,Jarvis Varnado,PF,25,TOT,24,0,339,36,60,0.6,0,0,,36,60,0.6,27,52,0.519,19,44,63,13,10,29,10,62,99
2014,Jarvis Varnado,PF,25,CHI,1,0,2,0,0,,0,0,,0,0,,0,0,,0,0,0,0,0,0,0,1,0
2014,Jarvis Varnado,PF,25,PHI,23,0,337,36,60,0.6,0,0,,36,60,0.6,27,52,0.519,19,44,63,13,10,29,10,61,99
2014,Jason Collins,C,35,BRK,22,1,172,11,24,0.458,0,3,0,11,21,0.524,3,4,0.75,7,12,19,4,8,1,7,30,25
2014,Jason Maxiell,PF,30,ORL,34,13,488,47,105,0.448,0,0,,47,105,0.448,15,31,0.484,28,58,86,9,8,20,14,47,109
2014,Jason Smith,PF,27,NOP,31,27,830,131,282,0.465,0,0,,131,282,0.465,39,50,0.78,51,130,181,29,11,29,28,100,301
2014,Jason Terry,PG,36,BRK,35,0,570,55,152,0.362,39,103,0.379,16,49,0.327,10,15,0.667,4,33,37,56,13,0,27,48,159
2014,Jason Thompson,PF,27,SAC,82,61,2007,251,496,0.506,0,0,,251,496,0.506,84,145,0.579,153,374,527,53,32,56,95,251,586
2014,JaVale McGee,C,26,DEN,5,5,79,17,38,0.447,0,0,,17,38,0.447,1,1,1,10,7,17,2,1,7,8,16,35
2014,Jeff Adrien,PF,27,TOT,53,12,961,143,275,0.52,0,0,,143,275,0.52,76,119,0.639,102,204,306,38,24,36,39,108,362
2014,Jeff Adrien,PF,27,CHA,25,0,256,22,40,0.55,0,0,,22,40,0.55,13,25,0.52,33,55,88,7,7,15,8,35,57
2014,Jeff Adrien,PF,27,MIL,28,12,705,121,235,0.515,0,0,,121,235,0.515,63,94,0.67,69,149,218,31,17,21,31,73,305
2014,Jeff Ayres,PF,26,SAS,73,10,952,101,174,0.58,0,0,,101,174,0.58,38,55,0.691,89,169,258,60,13,25,63,146,240
2014,Jeff Green,SF,27,BOS,82,82,2805,482,1171,0.412,135,396,0.341,347,775,0.448,283,356,0.795,54,326,380,138,57,47,165,180,1382
2014,Jeff Taylor,SF,24,CHA,26,8,629,82,218,0.376,18,67,0.269,64,151,0.424,26,47,0.553,15,45,60,22,13,5,25,62,208
2014,Jeff Teague,PG,25,ATL,79,79,2542,456,1040,0.438,74,225,0.329,382,815,0.469,318,376,0.846,34,174,208,528,89,17,232,158,1304
2014,Jeff Withey,C,23,NOP,58,4,684,69,129,0.535,0,1,0,69,128,0.539,52,73,0.712,49,101,150,26,15,50,20,73,190
2014,Jeremy Evans,SF,26,UTA,66,4,1209,175,332,0.527,0,2,0,175,330,0.53,51,75,0.68,120,190,310,44,42,46,40,139,401
2014,Jeremy Lamb,SG,21,OKC,78,0,1538,263,609,0.432,88,247,0.356,175,362,0.483,51,64,0.797,27,162,189,115,56,26,61,143,665
2014,Jeremy Lin,PG,25,HOU,71,33,2054,295,662,0.446,82,229,0.358,213,433,0.492,218,265,0.823,34,153,187,294,68,27,176,166,890
2014,Jeremy Tyler,C,22,NYK,41,0,398,60,116,0.517,0,0,,60,116,0.517,26,48,0.542,38,71,109,8,6,20,26,70,146
2014,Jermaine O'Neal,PF,35,GSW,44,13,883,125,248,0.504,0,0,,125,248,0.504,99,132,0.75,85,157,242,25,14,40,52,102,349
2014,Jerryd Bayless,PG,25,TOT,72,19,1686,248,617,0.402,76,212,0.358,172,405,0.425,94,118,0.797,22,123,145,194,60,9,82,161,666
2014,Jerryd Bayless,PG,25,MEM,31,5,650,90,239,0.377,25,83,0.301,65,156,0.417,45,57,0.789,8,51,59,66,20,5,22,72,250
2014,Jerryd Bayless,PG,25,BOS,41,14,1036,158,378,0.418,51,129,0.395,107,249,0.43,49,61,0.803,14,72,86,128,40,4,60,89,416
2014,Jimmer Fredette,SG,24,TOT,49,0,519,107,227,0.471,40,84,0.476,67,143,0.469,19,21,0.905,8,44,52,64,14,3,48,35,273
2014,Jimmer Fredette,SG,24,SAC,41,0,463,94,198,0.475,36,73,0.493,58,125,0.464,17,19,0.895,7,38,45,61,14,3,44,28,241
2014,Jimmer Fredette,SG,24,CHI,8,0,56,13,29,0.448,4,11,0.364,9,18,0.5,2,2,1,1,6,7,3,0,0,4,7,32
2014,Jimmy Butler,SG,24,CHI,67,67,2591,275,693,0.397,68,240,0.283,207,453,0.457,260,338,0.769,87,243,330,175,127,36,102,106,878
2014,Joakim Noah,C,28,CHI,80,80,2820,380,800,0.475,0,2,0,380,798,0.476,247,335,0.737,282,618,900,431,99,121,194,245,1007
2014,Jodie Meeks,SG,26,LAL,77,70,2556,413,892,0.463,162,404,0.401,251,488,0.514,221,258,0.857,30,164,194,138,111,4,111,119,1209
2014,Joe Johnson,SG,32,BRK,79,79,2575,462,1018,0.454,162,404,0.401,300,614,0.489,159,195,0.815,48,222,270,216,47,10,120,129,1245
2014,Joel Anthony,C,31,TOT,33,0,186,12,32,0.375,0,0,,12,32,0.375,4,8,0.5,15,23,38,2,3,12,3,17,28
2014,Joel Anthony,C,31,MIA,12,0,37,2,6,0.333,0,0,,2,6,0.333,2,2,1,2,5,7,0,0,4,1,4,6
2014,Joel Anthony,C,31,BOS,21,0,149,10,26,0.385,0,0,,10,26,0.385,2,6,0.333,13,18,31,2,3,8,2,13,22
2014,Joel Freeland,C,26,POR,52,0,727,77,162,0.475,0,2,0,77,160,0.481,20,29,0.69,88,120,208,36,10,22,32,95,174
2014,John Henson,PF,23,MIL,70,23,1856,344,639,0.538,0,1,0,344,638,0.539,91,177,0.514,171,326,497,113,41,116,114,185,779
2014,John Jenkins,SG,22,ATL,13,0,158,16,42,0.381,4,18,0.222,12,24,0.5,4,4,1,3,19,22,11,1,1,11,11,40
2014,John Lucas III,PG,31,UTA,42,6,591,62,190,0.326,25,84,0.298,37,106,0.349,10,16,0.625,12,27,39,42,14,0,22,41,159
2014,John Salmons,SG-SF,34,TOT,78,8,1726,150,413,0.363,63,163,0.387,87,250,0.348,40,52,0.769,20,143,163,147,47,19,54,124,403
2014,John Salmons,SF,34,SAC,18,8,445,41,117,0.35,16,42,0.381,25,75,0.333,7,7,1,8,38,46,44,12,8,14,32,105
2014,John Salmons,SG,34,TOR,60,0,1281,109,296,0.368,47,121,0.388,62,175,0.354,33,45,0.733,12,105,117,103,35,11,40,92,298
2014,John Wall,PG,23,WAS,82,82,2980,579,1337,0.433,108,308,0.351,471,1029,0.458,317,394,0.805,38,295,333,721,149,40,295,219,1583
2014,Jon Leuer,PF,24,MEM,49,0,642,121,246,0.492,23,49,0.469,98,197,0.497,37,47,0.787,37,121,158,20,18,13,27,63,302
2014,Jonas Jerebko,PF,26,DET,64,0,741,98,208,0.471,31,74,0.419,67,134,0.5,43,59,0.729,51,124,175,39,21,6,43,85,270
2014,Jonas Valančiūnas,C,21,TOR,81,81,2282,359,676,0.531,0,1,0,359,675,0.532,198,260,0.762,226,488,714,57,24,71,136,249,916
2014,Jordan Crawford,SG-PG,25,TOT,81,35,1859,327,788,0.415,90,285,0.316,237,503,0.471,146,169,0.864,28,155,183,281,47,5,134,120,890
2014,Jordan Crawford,PG,25,BOS,39,35,1198,188,455,0.413,50,157,0.318,138,298,0.463,110,126,0.873,18,102,120,224,34,3,84,76,536
2014,Jordan Crawford,SG,25,GSW,42,0,661,139,333,0.417,40,128,0.313,99,205,0.483,36,43,0.837,10,53,63,57,13,2,50,44,354
2014,Jordan Farmar,PG,27,LAL,41,5,912,151,364,0.415,70,160,0.438,81,204,0.397,44,59,0.746,20,84,104,199,38,8,95,65,416
2014,Jordan Hamilton,SF,23,TOT,60,12,1019,147,376,0.391,70,198,0.354,77,178,0.433,40,51,0.784,32,162,194,52,44,20,46,67,404
2014,Jordan Hamilton,SF,23,DEN,39,11,670,99,254,0.39,45,129,0.349,54,125,0.432,23,31,0.742,23,110,133,34,31,13,27,31,266
2014,Jordan Hamilton,SF,23,HOU,21,1,349,48,122,0.393,25,69,0.362,23,53,0.434,17,20,0.85,9,52,61,18,13,7,19,36,138
2014,Jordan Hill,PF,26,LAL,72,32,1500,286,521,0.549,0,1,0,286,520,0.55,124,181,0.685,194,341,535,54,29,64,75,172,696
2014,Jorge Gutiérrez,PG,25,BRK,15,2,244,25,54,0.463,3,12,0.25,22,42,0.524,9,12,0.75,3,19,22,30,10,1,14,37,62
2014,José Calderón,PG,32,DAL,81,81,2468,341,748,0.456,191,425,0.449,150,323,0.464,52,63,0.825,29,163,192,377,69,11,103,136,925
2014,Josh Childress,SF,30,NOP,4,0,24,0,0,,0,0,,0,0,,0,0,,0,3,3,2,1,0,1,1,0
2014,Josh Harrellson,C,24,DET,32,0,317,38,82,0.463,12,31,0.387,26,51,0.51,5,7,0.714,30,46,76,15,6,15,10,44,93
2014,Josh McRoberts,PF,26,CHA,78,78,2360,247,566,0.436,105,291,0.361,142,275,0.516,62,85,0.729,85,288,373,333,58,46,83,189,661
2014,Josh Powell,PF,31,HOU,1,0,19,2,6,0.333,0,0,,2,6,0.333,0,0,,0,5,5,0,0,1,1,1,4
2014,Josh Smith,SF,28,DET,77,76,2730,517,1233,0.419,70,265,0.264,447,968,0.462,160,301,0.532,102,418,520,252,105,110,199,197,1264
2014,Jrue Holiday,PG,23,NOP,34,34,1143,203,454,0.447,30,77,0.39,173,377,0.459,51,63,0.81,28,114,142,268,56,12,105,92,487
2014,Julyan Stone,SG,25,TOR,21,0,120,7,17,0.412,2,8,0.25,5,9,0.556,2,3,0.667,2,18,20,12,3,0,5,13,18
2014,Justin Hamilton,C,23,TOT,8,0,72,9,20,0.45,3,9,0.333,6,11,0.545,5,5,1,4,3,7,0,5,0,4,8,26
2014,Justin Hamilton,C,23,CHA,1,0,4,0,0,,0,0,,0,0,,0,0,,0,0,0,0,1,0,1,0,0
2014,Justin Hamilton,C,23,MIA,7,0,68,9,20,0.45,3,9,0.333,6,11,0.545,5,5,1,4,3,7,0,4,0,3,8,26
2014,Kawhi Leonard,SF,22,SAS,66,65,1923,337,645,0.522,69,182,0.379,268,463,0.579,101,126,0.802,76,336,412,133,114,50,80,127,844
2014,Keith Bogans,SG,33,BOS,6,0,55,3,6,0.5,3,6,0.5,0,0,,3,3,1,0,3,3,3,1,0,1,2,12
2014,Kelly Olynyk,C,22,BOS,70,9,1400,234,502,0.466,40,114,0.351,194,388,0.5,99,122,0.811,140,225,365,109,35,27,106,227,607
2014,Kemba Walker,PG,23,CHA,73,73,2614,449,1143,0.393,109,327,0.333,340,816,0.417,282,337,0.837,39,267,306,447,86,32,169,128,1289
2014,Kendall Marshall,PG,22,LAL,54,45,1564,170,419,0.406,71,178,0.399,99,241,0.411,19,36,0.528,15,140,155,477,48,4,150,76,430
2014,Kendrick Perkins,C,29,OKC,62,62,1207,87,193,0.451,0,1,0,87,192,0.453,37,67,0.552,82,223,305,67,26,32,90,177,211
2014,Kenneth Faried,PF,24,DEN,80,77,2178,447,820,0.545,0,3,0,447,817,0.547,202,311,0.65,238,446,684,96,70,69,135,193,1096
2014,Kent Bazemore,SG,24,TOT,67,15,911,147,343,0.429,43,128,0.336,104,215,0.484,66,109,0.606,10,107,117,91,43,13,79,102,403
2014,Kent Bazemore,SG,24,GSW,44,0,268,36,97,0.371,10,39,0.256,26,58,0.448,19,36,0.528,5,35,40,20,12,6,28,42,101
2014,Kent Bazemore,SG,24,LAL,23,15,643,111,246,0.451,33,89,0.371,78,157,0.497,47,73,0.644,5,72,77,71,31,7,51,60,302
2014,Kentavious Caldwell-Pope,SG,20,DET,80,41,1583,182,460,0.396,59,185,0.319,123,275,0.447,47,61,0.77,38,118,156,55,75,12,28,145,470
2014,Kenyon Martin,PF,36,NYK,32,15,633,63,123,0.512,0,1,0,63,122,0.516,11,19,0.579,36,98,134,50,25,27,26,85,137
2014,Kevin Durant,SF,25,OKC,81,81,3122,849,1688,0.503,192,491,0.391,657,1197,0.549,703,805,0.873,58,540,598,445,103,59,285,174,2593
2014,Kevin Garnett*,C,37,BRK,54,54,1109,157,356,0.441,0,3,0,157,353,0.445,38,47,0.809,60,298,358,82,43,40,69,123,352
2014,Kevin Love,PF,25,MIN,77,77,2797,650,1421,0.457,190,505,0.376,460,916,0.502,520,633,0.821,224,739,963,341,59,35,196,136,2010
2014,Kevin Martin,SG,30,MIN,68,68,2177,440,1023,0.43,115,297,0.387,325,726,0.448,303,340,0.891,34,169,203,121,66,6,106,123,1298
2014,Kevin Séraphin,C,24,WAS,53,1,578,111,220,0.505,0,0,,111,220,0.505,27,31,0.871,53,75,128,17,3,26,41,103,249
2014,Khris Middleton,SF,22,MIL,82,64,2460,376,854,0.44,120,290,0.414,256,564,0.454,118,137,0.861,60,250,310,169,83,20,123,243,990
2014,Kirk Hinrich,PG,33,CHI,73,61,2116,243,619,0.393,85,242,0.351,158,377,0.419,95,125,0.76,31,161,192,286,80,26,120,203,666
2014,Klay Thompson,SG,23,GSW,81,81,2868,559,1259,0.444,223,535,0.417,336,724,0.464,147,185,0.795,38,211,249,181,74,37,135,234,1488
2014,Kobe Bryant*,SG,35,LAL,6,6,177,31,73,0.425,3,16,0.188,28,57,0.491,18,21,0.857,2,24,26,38,7,1,34,9,83
2014,Kosta Koufos,C,24,MEM,80,22,1349,227,459,0.495,0,0,,227,459,0.495,60,93,0.645,160,258,418,39,32,71,67,182,514
2014,Kris Humphries,PF,28,BOS,69,30,1376,231,461,0.501,0,2,0,231,459,0.503,117,144,0.813,127,282,409,67,31,61,64,136,579
2014,Kyle Korver,SG,32,ATL,71,71,2408,289,609,0.475,185,392,0.472,104,217,0.479,87,94,0.926,22,260,282,208,70,24,102,147,850
2014,Kyle Lowry,PG,27,TOR,79,79,2862,457,1080,0.423,190,500,0.38,267,580,0.46,313,385,0.813,88,281,369,586,121,15,194,267,1417
2014,Kyle O'Quinn,C,23,ORL,69,19,1188,186,371,0.501,0,3,0,186,368,0.505,57,83,0.687,100,264,364,78,39,88,78,165,429
2014,Kyle Singler,SF,25,DET,82,36,2337,269,602,0.447,94,246,0.382,175,356,0.492,152,184,0.826,116,187,303,75,61,38,79,211,784
2014,Kyrie Irving,PG,21,CLE,71,71,2496,532,1237,0.43,123,344,0.358,409,893,0.458,291,338,0.861,52,207,259,433,108,23,190,163,1478
2014,LaMarcus Aldridge,PF,28,POR,69,69,2498,652,1423,0.458,3,15,0.2,649,1408,0.461,296,360,0.822,166,599,765,178,63,68,123,147,1603
2014,Lance Stephenson,SG,23,IND,78,78,2752,427,870,0.491,86,244,0.352,341,626,0.545,140,197,0.711,95,463,558,359,54,7,210,195,1080
2014,Lance Thomas,SF,25,NOP,5,0,42,2,9,0.222,0,0,,2,9,0.222,2,4,0.5,2,5,7,3,0,0,2,4,6
2014,Landry Fields,SF,25,TOR,30,2,322,27,67,0.403,0,5,0,27,62,0.435,14,22,0.636,15,44,59,20,10,3,11,25,68
2014,Larry Sanders,C,25,MIL,23,20,584,76,162,0.469,0,1,0,76,161,0.472,26,55,0.473,60,105,165,19,18,40,26,74,178
2014,Lavoy Allen,PF,24,TOT,65,2,1072,134,300,0.447,2,13,0.154,132,287,0.46,33,50,0.66,119,192,311,71,24,33,44,126,303
2014,Lavoy Allen,PF,24,PHI,51,2,960,117,266,0.44,2,13,0.154,115,253,0.455,27,40,0.675,106,171,277,65,22,27,40,115,263
2014,Lavoy Allen,PF,24,IND,14,0,112,17,34,0.5,0,0,,17,34,0.5,6,10,0.6,13,21,34,6,2,6,4,11,40
2014,Leandro Barbosa,PG,31,PHO,20,0,368,56,131,0.427,7,25,0.28,49,106,0.462,31,39,0.795,5,32,37,32,7,4,19,30,150
2014,LeBron James,PF,29,MIA,77,77,2902,767,1353,0.567,116,306,0.379,651,1047,0.622,439,585,0.75,81,452,533,488,121,26,270,126,2089
2014,Lorenzo Brown,PG,23,PHI,26,0,224,26,86,0.302,3,30,0.1,23,56,0.411,9,13,0.692,8,20,28,41,13,3,16,19,64
2014,Lou Amundson,PF,31,TOT,19,0,185,16,32,0.5,0,0,,16,32,0.5,6,24,0.25,28,27,55,6,9,11,14,49,38
2014,Lou Amundson,PF,31,NOP,18,0,184,16,32,0.5,0,0,,16,32,0.5,6,24,0.25,28,27,55,6,9,11,14,49,38
2014,Lou Amundson,PF,31,CHI,1,0,1,0,0,,0,0,,0,0,,0,0,,0,0,0,0,0,0,0,0,0
2014,Lou Williams,PG,27,ATL,60,7,1445,197,493,0.4,79,231,0.342,118,262,0.45,152,179,0.849,10,114,124,210,45,4,92,65,625
2014,Luc Mbah a Moute,PF-SF,27,TOT,64,7,1003,87,193,0.451,4,17,0.235,83,176,0.472,46,67,0.687,56,90,146,36,30,14,40,68,224
2014,Luc Mbah a Moute,SF,27,SAC,9,5,196,15,32,0.469,1,3,0.333,14,29,0.483,9,13,0.692,9,18,27,15,9,5,4,18,40
2014,Luc Mbah a Moute,PF,27,MIN,55,2,807,72,161,0.447,3,14,0.214,69,147,0.469,37,54,0.685,47,72,119,21,21,9,36,50,184
2014,Luis Scola,PF,33,IND,82,2,1399,263,560,0.47,1,7,0.143,262,553,0.474,99,136,0.728,86,305,391,81,26,16,108,164,626
2014,Luke Babbitt,PF,24,NOP,27,2,473,60,154,0.39,36,95,0.379,24,59,0.407,14,18,0.778,18,70,88,29,7,11,15,52,170
2014,Luke Ridnour,PG,32,TOT,61,14,1141,126,327,0.385,37,108,0.343,89,219,0.406,17,26,0.654,23,74,97,176,32,8,66,92,306
2014,Luke Ridnour,PG,32,MIL,36,12,763,84,219,0.384,25,68,0.368,59,151,0.391,13,19,0.684,15,47,62,122,23,2,46,55,206
2014,Luke Ridnour,PG,32,CHA,25,2,378,42,108,0.389,12,40,0.3,30,68,0.441,4,7,0.571,8,27,35,54,9,6,20,37,100
2014,Luol Deng,SF,28,TOT,63,63,2213,371,860,0.431,57,189,0.302,314,671,0.468,212,268,0.791,99,262,361,183,62,9,114,111,1011
2014,Luol Deng,SF,28,CHI,23,23,860,160,354,0.452,17,62,0.274,143,292,0.49,101,124,0.815,40,118,158,85,24,4,59,53,438
2014,Luol Deng,SF,28,CLE,40,40,1353,211,506,0.417,40,127,0.315,171,379,0.451,111,144,0.771,59,144,203,98,38,5,55,58,573
2014,Maalik Wayns,PG,22,LAC,2,0,9,1,2,0.5,0,0,,1,2,0.5,0,0,,0,2,2,2,2,0,0,4,2
2014,Malcolm Thomas,PF,25,TOT,8,0,63,7,16,0.438,1,4,0.25,6,12,0.5,0,2,0,5,16,21,2,0,3,9,5,15
2014,Malcolm Thomas,PF,25,SAS,1,0,15,1,4,0.25,0,0,,1,4,0.25,0,2,0,1,8,9,0,0,2,1,0,2
2014,Malcolm Thomas,PF,25,UTA,7,0,48,6,12,0.5,1,4,0.25,5,8,0.625,0,0,,4,8,12,2,0,1,8,5,13
2014,Manny Harris,SG,24,LAL,9,0,180,28,70,0.4,7,20,0.35,21,50,0.42,10,12,0.833,7,27,34,11,4,1,9,10,73
2014,Manu Ginóbili*,SG,36,SAS,68,3,1550,294,627,0.469,90,258,0.349,204,369,0.553,160,188,0.851,30,172,202,293,70,17,139,128,838
2014,Marc Gasol,C,29,MEM,59,59,1970,336,711,0.473,2,11,0.182,334,700,0.477,185,241,0.768,84,340,424,215,59,76,111,150,859
2014,Marcin Gortat,C,29,WAS,81,80,2655,455,840,0.542,1,1,1,454,839,0.541,157,229,0.686,202,565,767,138,41,121,126,201,1068
2014,Marco Belinelli,SF,27,SAS,80,25,2016,337,695,0.485,126,293,0.43,211,402,0.525,111,131,0.847,18,208,226,179,50,7,95,130,911
2014,Marcus Morris,SF,24,PHO,82,1,1800,288,651,0.442,99,260,0.381,189,391,0.483,121,159,0.761,84,235,319,88,72,18,95,157,796
2014,Marcus Thornton,SG,26,TOT,72,27,1741,252,639,0.394,109,316,0.345,143,323,0.443,90,112,0.804,57,141,198,77,58,11,67,110,703
2014,Marcus Thornton,SG,26,SAC,46,26,1121,142,373,0.381,57,179,0.318,85,194,0.438,42,52,0.808,39,85,124,47,31,8,38,74,383
2014,Marcus Thornton,SG,26,BRK,26,1,620,110,266,0.414,52,137,0.38,58,129,0.45,48,60,0.8,18,56,74,30,27,3,29,36,320
2014,Mario Chalmers,PG,27,MIA,73,73,2178,254,560,0.454,87,226,0.385,167,334,0.5,121,163,0.742,41,173,214,357,119,16,162,210,716
2014,Markieff Morris,PF,24,PHO,81,0,2153,411,845,0.486,34,108,0.315,377,737,0.512,259,327,0.792,139,346,485,144,68,51,147,232,1115
2014,Marquis Teague,SG,20,TOT,40,3,443,38,119,0.319,5,18,0.278,33,101,0.327,26,35,0.743,1,39,40,58,10,5,39,46,107
2014,Marquis Teague,SG,20,CHI,19,2,242,16,66,0.242,2,10,0.2,14,56,0.25,11,16,0.688,1,18,19,28,2,4,17,25,45
2014,Marquis Teague,SG,20,BRK,21,1,201,22,53,0.415,3,8,0.375,19,45,0.422,15,19,0.789,0,21,21,30,8,1,22,21,62
2014,Marreese Speights,C,26,GSW,79,3,982,195,442,0.441,8,31,0.258,187,411,0.455,110,134,0.821,101,189,290,32,10,34,66,148,508
2014,MarShon Brooks,SG,25,TOT,35,0,316,57,125,0.456,13,25,0.52,44,100,0.44,32,44,0.727,10,44,54,25,14,4,24,21,159
2014,MarShon Brooks,SG,25,BOS,10,0,73,9,24,0.375,2,4,0.5,7,20,0.35,11,14,0.786,1,18,19,4,1,1,7,5,31
2014,MarShon Brooks,SG,25,GSW,7,0,15,5,13,0.385,0,2,0,5,11,0.455,3,4,0.75,1,4,5,0,1,0,0,0,13
2014,MarShon Brooks,SG,25,LAL,18,0,228,43,88,0.489,11,19,0.579,32,69,0.464,18,26,0.692,8,22,30,21,12,3,17,16,115
2014,Martell Webster,SF,27,WAS,78,13,2157,254,587,0.433,146,372,0.392,108,215,0.502,105,125,0.84,38,184,222,97,41,15,58,150,759
2014,Marvin Williams,PF,27,UTA,66,50,1674,231,526,0.439,84,234,0.359,147,292,0.503,57,73,0.781,82,252,334,78,54,31,53,151,603
2014,Mason Plumlee,C,23,BRK,70,22,1275,199,302,0.659,0,3,0,199,299,0.666,122,195,0.626,99,209,308,60,49,55,77,171,520
2014,Matt Barnes,SF,33,LAC,63,40,1735,231,527,0.438,97,283,0.343,134,244,0.549,66,90,0.733,60,232,292,125,56,28,85,185,625
2014,Matt Bonner,PF,33,SAS,61,0,690,73,164,0.445,42,98,0.429,31,66,0.47,9,12,0.75,16,114,130,31,15,11,16,49,197
2014,Matthew Dellavedova,SG,23,CLE,72,4,1271,122,296,0.412,57,155,0.368,65,141,0.461,38,48,0.792,29,94,123,187,33,5,60,121,339
2014,Maurice Harkless,SF,20,ORL,80,41,1950,224,483,0.464,59,154,0.383,165,329,0.502,85,143,0.594,69,195,264,80,97,50,86,140,592
2014,Melvin Ely,C,35,NOP,2,0,27,3,6,0.5,0,0,,3,6,0.5,0,0,,0,1,1,0,0,1,0,5,6
2014,Metta World Peace,SF,34,NYK,29,1,388,56,141,0.397,17,54,0.315,39,87,0.448,10,16,0.625,18,41,59,17,24,8,19,44,139
2014,Meyers Leonard,C,21,POR,40,0,355,41,91,0.451,0,6,0,41,85,0.482,16,21,0.762,26,85,111,18,7,5,15,76,98
2014,Michael Beasley,SF,25,MIA,55,2,831,177,355,0.499,21,54,0.389,156,301,0.518,61,79,0.772,31,141,172,42,23,21,57,93,436
2014,Michael Carter-Williams,PG,22,PHI,70,70,2414,427,1054,0.405,55,208,0.264,372,846,0.44,258,367,0.703,101,336,437,441,130,43,247,213,1167
2014,Michael Kidd-Gilchrist,SF,20,CHA,62,62,1502,167,353,0.473,1,9,0.111,166,344,0.483,113,184,0.614,109,215,324,52,43,39,60,145,448
2014,Mike Conley,PG,26,MEM,73,73,2446,463,1030,0.45,105,291,0.361,358,739,0.484,225,276,0.815,41,172,213,441,110,13,150,141,1256
2014,Mike Dunleavy,SF,33,CHI,82,61,2584,333,774,0.43,123,324,0.38,210,450,0.467,140,164,0.854,46,299,345,186,64,46,108,163,929
2014,Mike Harris,PF,30,UTA,20,0,225,29,61,0.475,0,2,0,29,59,0.492,26,27,0.963,15,18,33,5,16,7,11,36,84
2014,Mike James,PG,38,CHI,11,0,77,5,21,0.238,1,5,0.2,4,16,0.25,0,2,0,0,7,7,17,2,0,5,11,11
2014,Mike Miller,SF,33,MEM,82,4,1707,213,443,0.481,107,233,0.459,106,210,0.505,46,56,0.821,30,177,207,130,26,5,77,95,579
2014,Mike Muscala,PF,22,ATL,20,0,215,31,73,0.425,0,3,0,31,70,0.443,14,14,1,17,35,52,7,3,10,12,29,76
2014,Mike Scott,PF,25,ATL,80,6,1482,301,628,0.479,62,200,0.31,239,428,0.558,103,132,0.78,62,222,284,75,30,7,79,121,767
2014,Miles Plumlee,C,25,PHO,80,79,1964,286,553,0.517,0,0,,286,553,0.517,74,132,0.561,198,428,626,43,50,90,111,185,646
2014,Miroslav Raduljica,C,26,MIL,48,2,465,68,126,0.54,0,0,,68,126,0.54,45,55,0.818,54,54,108,23,7,13,28,84,181
2014,Mirza Teletović,SF,28,BRK,72,7,1396,221,529,0.418,136,349,0.39,85,180,0.472,44,62,0.71,60,206,266,57,29,23,54,143,622
2014,Mo Williams,PG,31,POR,74,0,1834,280,672,0.417,83,225,0.369,197,447,0.441,78,89,0.876,42,111,153,321,55,10,149,197,721
2014,Monta Ellis,SG,28,DAL,82,82,3023,576,1278,0.451,69,209,0.33,507,1069,0.474,339,430,0.788,38,257,295,471,141,23,264,197,1560
2014,Mustafa Shakur,PG,29,OKC,3,0,11,0,3,0,0,1,0,0,2,0,1,2,0.5,0,0,0,4,0,0,2,2,1
2014,Nando De Colo,SF,26,TOT,47,3,494,64,153,0.418,18,53,0.34,46,100,0.46,31,35,0.886,14,59,73,65,22,6,35,48,177
2014,Nando De Colo,SF,26,SAS,26,3,301,42,93,0.452,10,31,0.323,32,62,0.516,18,22,0.818,6,39,45,32,15,3,21,25,112
2014,Nando De Colo,SF,26,TOR,21,0,193,22,60,0.367,8,22,0.364,14,38,0.368,13,13,1,8,20,28,33,7,3,14,23,65
2014,Nate Robinson,PG,29,DEN,44,1,866,164,383,0.428,58,154,0.377,106,229,0.463,71,85,0.835,21,60,81,112,36,4,58,92,457
2014,Nate Wolters,PG,22,MIL,58,31,1309,170,389,0.437,18,62,0.29,152,327,0.465,59,90,0.656,33,116,149,187,35,15,57,67,417
2014,Nazr Mohammed,C,36,CHI,80,1,562,54,126,0.429,0,0,,54,126,0.429,16,30,0.533,66,109,175,20,14,30,37,77,124
2014,Nemanja Nedović,SG,22,GSW,24,0,142,8,39,0.205,3,18,0.167,5,21,0.238,7,8,0.875,3,12,15,13,0,1,13,13,26
2014,Nenê,PF,31,WAS,53,37,1560,299,594,0.503,1,5,0.2,298,589,0.506,155,266,0.583,65,229,294,153,64,47,117,164,754
2014,Nick Calathes,SG,24,MEM,71,7,1173,142,311,0.457,19,61,0.311,123,250,0.492,44,72,0.611,23,114,137,207,66,8,101,117,347
2014,Nick Collison,PF,33,OKC,81,0,1353,134,241,0.556,4,17,0.235,130,224,0.58,66,93,0.71,116,177,293,104,30,28,71,187,338
2014,Nick Young,SG,28,LAL,64,9,1810,387,889,0.435,135,350,0.386,252,539,0.468,235,285,0.825,29,137,166,95,46,12,95,156,1144
2014,Nicolas Batum,SF,25,POR,82,82,2956,381,819,0.465,145,402,0.361,236,417,0.566,163,203,0.803,116,495,611,420,75,57,208,156,1070
2014,Nikola Peković,C,28,MIN,54,54,1663,379,701,0.541,0,0,,379,701,0.541,186,249,0.747,206,262,468,50,30,23,84,129,944
2014,Nikola Vučević,C,23,ORL,57,57,1812,353,696,0.507,0,0,,353,696,0.507,105,137,0.766,185,441,626,104,60,47,112,169,811
2014,Norris Cole,PG,25,MIA,82,6,2014,207,500,0.414,60,174,0.345,147,326,0.451,53,68,0.779,17,143,160,248,77,5,127,156,527
2014,O.J. Mayo,SG,26,MIL,52,23,1346,224,550,0.407,84,227,0.37,140,323,0.433,76,88,0.864,24,100,124,113,28,13,95,111,608
2014,Ognjen Kuzmić,C,23,GSW,21,0,92,5,13,0.385,0,0,,5,13,0.385,5,11,0.455,10,11,21,2,3,4,10,17,15
2014,Ömer Aşık,C,27,HOU,48,19,968,101,190,0.532,0,0,,101,190,0.532,78,126,0.619,101,277,378,25,14,37,59,92,280
2014,Omri Casspi,PF,25,HOU,71,2,1283,173,410,0.422,61,176,0.347,112,234,0.479,83,122,0.68,55,205,260,88,44,14,72,100,490
2014,Orlando Johnson,SG,24,TOT,45,0,392,36,113,0.319,9,47,0.191,27,66,0.409,19,26,0.731,9,46,55,20,6,2,15,26,100
2014,Orlando Johnson,SG,24,IND,38,0,342,33,96,0.344,8,41,0.195,25,55,0.455,17,22,0.773,7,44,51,16,6,1,14,23,91
2014,Orlando Johnson,SG,24,SAC,7,0,50,3,17,0.176,1,6,0.167,2,11,0.182,2,4,0.5,2,2,4,4,0,1,1,3,9
2014,Othyus Jeffers,SG,28,TOT,6,1,47,3,6,0.5,0,2,0,3,4,0.75,3,4,0.75,1,8,9,1,0,0,1,3,9
2014,Othyus Jeffers,SG,28,SAS,4,1,34,3,5,0.6,0,1,0,3,4,0.75,1,2,0.5,1,5,6,1,0,0,0,2,7
2014,Othyus Jeffers,SG,28,MIN,2,0,13,0,1,0,0,1,0,0,0,,2,2,1,0,3,3,0,0,0,1,1,2
2014,Otto Porter Jr.,SF,20,WAS,37,0,319,33,91,0.363,4,21,0.19,29,70,0.414,8,12,0.667,21,36,57,10,8,1,14,26,78
2014,P.J. Tucker,SF,28,PHO,81,81,2490,265,615,0.431,74,191,0.387,191,424,0.45,156,201,0.776,161,368,529,141,110,23,102,204,760
2014,Pablo Prigioni,PG,36,NYK,66,27,1283,88,191,0.461,65,140,0.464,23,51,0.451,11,12,0.917,36,93,129,228,67,2,60,132,252
2014,Patrick Beverley,PG,25,HOU,56,55,1751,199,481,0.414,92,255,0.361,107,226,0.473,83,102,0.814,72,124,196,151,77,23,66,174,573
2014,Patrick Patterson,PF,24,TOT,65,13,1533,225,489,0.46,55,151,0.364,170,338,0.503,50,71,0.704,117,225,342,78,55,37,65,159,555
2014,Patrick Patterson,PF,24,SAC,17,6,415,50,122,0.41,9,39,0.231,41,83,0.494,9,16,0.563,34,65,99,15,13,3,16,39,118
2014,Patrick Patterson,PF,24,TOR,48,7,1118,175,367,0.477,46,112,0.411,129,255,0.506,41,55,0.745,83,160,243,63,42,34,49,120,437
2014,Patty Mills,PG,25,SAS,81,2,1527,309,666,0.464,135,318,0.425,174,348,0.5,73,82,0.89,34,135,169,149,68,9,63,114,826
2014,Pau Gasol,C,33,LAL,60,60,1884,425,885,0.48,4,14,0.286,421,871,0.483,187,254,0.736,124,456,580,201,27,92,141,124,1041
2014,Paul George,SF,23,IND,80,80,2898,577,1362,0.424,182,500,0.364,395,862,0.458,401,464,0.864,64,478,542,283,151,22,224,198,1737
2014,Paul Millsap,PF,28,ATL,74,73,2482,483,1047,0.461,76,212,0.358,407,835,0.487,286,391,0.731,154,473,627,232,129,78,185,210,1328
2014,Paul Pierce*,SF,36,BRK,75,68,2098,321,712,0.451,112,300,0.373,209,412,0.507,256,310,0.826,26,322,348,178,86,31,153,190,1010
2014,Pero Antić,C,31,ATL,50,26,925,123,294,0.418,56,171,0.327,67,123,0.545,50,66,0.758,57,152,209,58,19,12,55,126,352
2014,Perry Jones,PF,22,OKC,62,7,764,83,181,0.459,22,61,0.361,61,120,0.508,28,42,0.667,28,86,114,26,14,19,21,62,216
2014,Peyton Siva,SG,23,DET,24,0,224,18,57,0.316,7,25,0.28,11,32,0.344,11,15,0.733,2,12,14,34,9,1,18,27,54
2014,Phil Pressey,PG,22,BOS,75,11,1132,78,253,0.308,28,106,0.264,50,147,0.34,29,45,0.644,20,85,105,241,68,5,87,97,213
2014,Quincy Acy,SF,23,TOT,63,0,847,66,141,0.468,4,15,0.267,62,126,0.492,35,53,0.66,72,144,216,28,23,26,30,122,171
2014,Quincy Acy,SF,23,TOR,7,0,61,6,14,0.429,2,5,0.4,4,9,0.444,5,8,0.625,5,10,15,4,4,3,2,8,19
2014,Quincy Acy,SF,23,SAC,56,0,786,60,127,0.472,2,10,0.2,58,117,0.496,30,45,0.667,67,134,201,24,19,23,28,114,152
2014,Quincy Miller,PF,21,DEN,52,16,789,94,256,0.367,30,94,0.319,64,162,0.395,39,55,0.709,36,111,147,26,22,32,48,70,257
2014,Quincy Pondexter,SG,25,MEM,15,2,270,31,79,0.392,11,34,0.324,20,45,0.444,21,26,0.808,10,16,26,20,5,1,15,18,94
2014,Rajon Rondo,PG,27,BOS,30,30,998,141,350,0.403,26,90,0.289,115,260,0.442,42,67,0.627,22,142,164,294,40,2,99,65,350
2014,Ramon Sessions,PG,27,TOT,83,19,2214,330,769,0.429,35,124,0.282,295,645,0.457,326,404,0.807,38,165,203,340,49,9,148,90,1021
2014,Ramon Sessions,PG,27,CHA,55,7,1305,190,465,0.409,15,68,0.221,175,397,0.441,183,234,0.782,22,95,117,206,33,6,93,50,578
2014,Ramon Sessions,PG,27,MIL,28,12,909,140,304,0.461,20,56,0.357,120,248,0.484,143,170,0.841,16,70,86,134,16,3,55,40,443
2014,Randy Foye,SG,30,DEN,81,78,2485,361,875,0.413,189,498,0.38,172,377,0.456,157,185,0.849,36,196,232,287,67,39,145,205,1068
2014,Rashard Lewis,SF,34,MIA,60,6,971,98,236,0.415,46,134,0.343,52,102,0.51,26,33,0.788,24,86,110,57,53,8,35,90,268
2014,Rasual Butler,SG,34,IND,50,2,378,51,110,0.464,26,62,0.419,25,48,0.521,8,14,0.571,6,35,41,17,7,9,11,30,136
2014,Ray Allen*,SG,38,MIA,73,9,1936,240,543,0.442,116,309,0.375,124,234,0.53,105,116,0.905,23,182,205,143,54,8,84,115,701
2014,Ray McCallum,PG,22,SAC,45,10,897,113,300,0.377,22,59,0.373,91,241,0.378,32,43,0.744,18,61,79,120,22,9,39,69,280
2014,Raymond Felton,PG,29,NYK,65,65,2017,240,608,0.395,62,195,0.318,178,413,0.431,88,122,0.721,54,143,197,365,78,27,129,157,630
2014,Reggie Bullock,SF,22,LAC,43,0,395,43,121,0.355,22,73,0.301,21,48,0.438,7,9,0.778,11,43,54,12,9,1,13,26,115
2014,Reggie Evans,PF,33,TOT,54,20,899,71,150,0.473,0,0,,71,150,0.473,72,130,0.554,115,219,334,21,37,3,58,119,214
2014,Reggie Evans,PF,33,BRK,30,6,399,23,59,0.39,0,0,,23,59,0.39,35,65,0.538,53,96,149,5,13,2,28,54,81
2014,Reggie Evans,PF,33,SAC,24,14,500,48,91,0.527,0,0,,48,91,0.527,37,65,0.569,62,123,185,16,24,1,30,65,133
2014,Reggie Jackson,PG,23,OKC,80,36,2277,403,916,0.44,83,245,0.339,320,671,0.477,158,177,0.893,43,270,313,331,85,9,168,142,1047
2014,Reggie Williams,SF,27,OKC,3,0,17,5,9,0.556,1,3,0.333,4,6,0.667,0,0,,0,0,0,1,1,0,2,1,11
2014,Richard Jefferson,SF,33,UTA,82,78,2213,294,654,0.45,123,301,0.409,171,353,0.484,120,162,0.741,18,201,219,130,56,14,94,168,831
2014,Ricky Ledo,SG,21,DAL,11,0,33,6,17,0.353,3,8,0.375,3,9,0.333,4,4,1,0,2,2,2,1,0,2,2,19
2014,Ricky Rubio,PG,23,MIN,82,82,2638,255,670,0.381,44,133,0.331,211,537,0.393,227,283,0.802,61,281,342,704,191,11,221,218,781
2014,Robbie Hummel,SF,24,MIN,53,5,655,67,177,0.379,32,89,0.36,35,88,0.398,15,16,0.938,35,97,132,23,16,2,10,57,181
2014,Robert Covington,SF,23,HOU,7,0,34,6,14,0.429,4,11,0.364,2,3,0.667,0,0,,2,3,5,0,2,0,1,3,16
2014,Robert Sacre,C,24,LAL,65,13,1089,143,300,0.477,0,0,,143,300,0.477,64,94,0.681,82,172,254,51,24,47,44,134,350
2014,Robin Lopez,C,25,POR,82,82,2603,355,644,0.551,0,1,0,355,643,0.552,198,242,0.818,326,374,700,73,25,139,84,196,908
2014,Rodney Stuckey,SG,27,DET,73,5,1950,372,853,0.436,24,88,0.273,348,765,0.455,244,292,0.836,39,130,169,152,54,10,125,131,1012
2014,Roger Mason,SG,33,MIA,25,2,260,25,67,0.373,17,48,0.354,8,19,0.421,7,7,1,1,21,22,19,6,1,9,26,74
2014,Ronnie Brewer,SF,28,TOT,24,3,160,3,15,0.2,1,8,0.125,2,7,0.286,0,2,0,2,12,14,10,6,1,2,4,7
2014,Ronnie Brewer,SF,28,HOU,23,3,158,3,15,0.2,1,8,0.125,2,7,0.286,0,2,0,2,12,14,10,6,1,2,4,7
2014,Ronnie Brewer,SF,28,CHI,1,0,2,0,0,,0,0,,0,0,,0,0,,0,0,0,0,0,0,0,0,0
2014,Ronnie Price,SG,30,ORL,31,2,377,28,92,0.304,9,43,0.209,19,49,0.388,9,13,0.692,8,35,43,66,25,2,26,50,74
2014,Ronny Turiaf,C,31,MIN,31,10,606,64,107,0.598,0,0,,64,107,0.598,21,50,0.42,55,119,174,24,8,50,24,65,149
2014,Roy Hibbert,C,27,IND,81,81,2409,331,754,0.439,2,5,0.4,329,749,0.439,207,269,0.77,202,336,538,91,29,182,148,269,871
2014,Royal Ivey,SG,32,OKC,2,0,5,0,2,0,0,1,0,0,1,0,0,0,,0,1,1,0,0,0,0,1,0
2014,Royce White,PF,22,SAC,3,0,9,0,1,0,0,0,,0,1,0,0,0,,0,0,0,0,0,0,0,2,0
2014,Rudy Gay,SF,27,TOT,73,73,2531,537,1179,0.455,65,197,0.33,472,982,0.481,318,387,0.822,113,324,437,209,95,56,224,171,1457
2014,Rudy Gay,SF,27,TOR,18,18,639,130,335,0.388,22,59,0.373,108,276,0.391,68,88,0.773,29,104,133,40,28,23,59,47,350
2014,Rudy Gay,SF,27,SAC,55,55,1892,407,844,0.482,43,138,0.312,364,706,0.516,250,299,0.836,84,220,304,169,67,33,165,124,1107
2014,Rudy Gobert,C,21,UTA,45,0,434,36,74,0.486,0,0,,36,74,0.486,32,65,0.492,51,104,155,7,8,41,32,57,104
2014,Russell Westbrook,PG,25,OKC,46,46,1412,346,791,0.437,68,214,0.318,278,577,0.482,242,293,0.826,55,208,263,319,88,7,177,104,1002
2014,Ryan Anderson,PF,25,NOP,22,14,795,155,354,0.438,67,164,0.409,88,190,0.463,59,62,0.952,66,76,142,17,10,7,20,47,436
2014,Ryan Gomes,SF,31,OKC,5,0,34,3,8,0.375,0,2,0,3,6,0.5,0,0,,0,4,4,1,0,0,1,5,6
2014,Ryan Hollins,PF,29,LAC,61,0,482,53,72,0.736,0,0,,53,72,0.736,35,56,0.625,31,59,90,8,9,31,29,87,141
2014,Ryan Kelly,PF,22,LAL,59,25,1312,157,371,0.423,48,142,0.338,109,229,0.476,110,135,0.815,42,177,219,95,32,45,47,147,472
2014,Samuel Dalembert,C,32,DAL,80,68,1614,214,377,0.568,0,1,0,214,376,0.569,101,137,0.737,200,341,541,38,41,94,90,210,529
2014,Sasha Vujačić,SG,29,LAC,2,0,10,2,5,0.4,1,2,0.5,1,3,0.333,0,0,,0,3,3,0,1,0,3,1,5
2014,Scotty Hopson,SG,24,CLE,2,0,7,0,4,0,0,2,0,0,2,0,1,2,0.5,0,0,0,1,1,0,0,0,1
2014,Serge Ibaka,PF,24,OKC,81,81,2666,524,978,0.536,23,60,0.383,501,918,0.546,156,199,0.784,224,485,709,85,39,219,123,233,1227
2014,Sergey Karasev,SF,20,CLE,22,1,156,12,35,0.343,4,19,0.211,8,16,0.5,9,10,0.9,0,16,16,6,3,1,11,22,37
2014,Seth Curry,PG,23,TOT,2,0,13,1,3,0.333,1,1,1,0,2,0,0,0,,0,1,1,0,2,0,0,0,3
2014,Seth Curry,PG,23,MEM,1,0,4,0,0,,0,0,,0,0,,0,0,,0,0,0,0,0,0,0,0,0
2014,Seth Curry,PG,23,CLE,1,0,9,1,3,0.333,1,1,1,0,2,0,0,0,,0,1,1,0,2,0,0,0,3
2014,Shabazz Muhammad,SG,21,MIN,37,0,290,57,124,0.46,3,11,0.273,54,113,0.478,26,40,0.65,24,29,53,6,8,1,16,24,143
2014,Shane Battier,SF,35,MIA,73,56,1468,105,275,0.382,73,210,0.348,32,65,0.492,15,23,0.652,34,104,138,63,50,39,21,124,298
2014,Shane Edwards,SF,26,CLE,2,0,12,1,3,0.333,0,0,,1,3,0.333,0,0,,1,1,2,0,0,0,1,1,2
2014,Shane Larkin,PG,21,DAL,48,0,489,52,137,0.38,12,38,0.316,40,99,0.404,16,25,0.64,11,31,42,71,26,1,39,46,132
2014,Shannon Brown,SG,28,TOT,29,1,251,24,66,0.364,0,2,0,24,64,0.375,15,21,0.714,7,21,28,9,13,0,18,24,63
2014,Shannon Brown,SG,28,SAS,10,1,103,8,28,0.286,0,2,0,8,26,0.308,7,9,0.778,1,12,13,5,1,0,8,12,23
2014,Shannon Brown,SG,28,NYK,19,0,148,16,38,0.421,0,0,,16,38,0.421,8,12,0.667,6,9,15,4,12,0,10,12,40
2014,Shaun Livingston,PG,28,BRK,76,54,1974,235,487,0.483,1,6,0.167,234,481,0.486,158,191,0.827,67,179,246,245,93,31,105,172,629
2014,Shavlik Randolph,PF,30,PHO,14,0,95,7,14,0.5,0,0,,7,14,0.5,6,11,0.545,7,18,25,1,3,1,5,15,20
2014,Shawn Marion,SF,35,DAL,76,76,2409,341,708,0.482,58,162,0.358,283,546,0.518,51,65,0.785,132,365,497,124,90,37,95,125,791
2014,Shawne Williams,PF,27,LAL,36,13,751,73,192,0.38,42,129,0.326,31,63,0.492,14,20,0.7,25,142,167,30,19,30,21,93,202
2014,Shelvin Mack,PG,23,ATL,73,11,1490,209,501,0.417,62,184,0.337,147,317,0.464,64,74,0.865,21,139,160,271,50,2,89,100,544
2014,Solomon Hill,SF,22,IND,28,0,226,17,40,0.425,7,23,0.304,10,17,0.588,6,7,0.857,9,32,41,12,5,2,13,19,47
2014,Solomon Jones,PF,29,ORL,11,0,85,6,17,0.353,0,0,,6,17,0.353,2,4,0.5,8,8,16,2,2,2,2,12,14
2014,Spencer Hawes,C,25,TOT,80,78,2470,403,883,0.456,128,308,0.416,275,575,0.478,119,152,0.783,131,529,660,240,44,94,173,237,1053
2014,Spencer Hawes,C,25,PHI,53,53,1666,264,586,0.451,81,203,0.399,183,383,0.478,79,101,0.782,88,364,452,176,31,67,119,154,688
2014,Spencer Hawes,C,25,CLE,27,25,804,139,297,0.468,47,105,0.448,92,192,0.479,40,51,0.784,43,165,208,64,13,27,54,83,365
2014,Stephen Curry,PG,25,GSW,78,78,2846,652,1383,0.471,261,615,0.424,391,768,0.509,308,348,0.885,46,288,334,666,128,14,294,194,1873
2014,Stephen Jackson,SF,35,LAC,9,0,107,6,26,0.231,1,14,0.071,5,12,0.417,2,4,0.5,2,8,10,5,6,1,6,11,15
2014,Steve Blake,PG,33,TOT,55,28,1498,133,353,0.377,79,210,0.376,54,143,0.378,33,43,0.767,13,146,159,307,54,8,102,85,378
2014,Steve Blake,PG,33,LAL,27,27,891,88,233,0.378,52,131,0.397,36,102,0.353,28,35,0.8,8,95,103,205,34,2,71,49,256
2014,Steve Blake,PG,33,GSW,28,1,607,45,120,0.375,27,79,0.342,18,41,0.439,5,8,0.625,5,51,56,102,20,6,31,36,122
2014,Steve Nash*,PG,39,LAL,15,10,313,36,94,0.383,8,24,0.333,28,70,0.4,22,24,0.917,4,25,29,86,7,2,31,18,102
2014,Steve Novak,PF,30,TOR,54,1,540,60,146,0.411,52,122,0.426,8,24,0.333,6,6,1,8,50,58,13,12,4,5,44,178
2014,Steven Adams,C,20,OKC,81,20,1197,93,185,0.503,0,0,,93,185,0.503,79,136,0.581,142,190,332,43,40,57,71,203,265
2014,Taj Gibson,PF,28,CHI,82,8,2351,429,896,0.479,0,7,0,429,889,0.483,211,281,0.751,200,358,558,91,41,112,150,207,1069
2014,Tayshaun Prince,SF,33,MEM,76,76,1948,200,492,0.407,20,69,0.29,180,423,0.426,34,60,0.567,32,202,234,119,39,19,41,63,454
2014,Terrence Jones,PF,22,HOU,76,71,2078,386,712,0.542,31,101,0.307,355,611,0.581,118,195,0.605,162,366,528,87,53,99,71,139,921
2014,Terrence Ross,SG,22,TOR,81,62,2159,318,751,0.423,161,408,0.395,157,343,0.458,82,98,0.837,43,209,252,79,64,27,88,183,879
2014,Thabo Sefolosha,SG,29,OKC,61,61,1584,141,340,0.415,48,152,0.316,93,188,0.495,53,69,0.768,50,170,220,94,79,17,55,90,383
2014,Thaddeus Young,PF,25,PHI,79,78,2718,582,1283,0.454,90,292,0.308,492,991,0.496,163,229,0.712,166,310,476,182,167,36,165,213,1417
2014,Thomas Robinson,PF,22,POR,70,0,873,141,293,0.481,0,1,0,141,292,0.483,57,101,0.564,105,202,307,34,23,20,57,131,339
2014,Tiago Splitter,C,29,SAS,59,50,1271,181,346,0.523,0,3,0,181,343,0.528,121,173,0.699,123,240,363,90,29,31,75,117,483
2014,Tim Duncan*,C,37,SAS,74,74,2158,444,906,0.49,0,5,0,444,901,0.493,231,316,0.731,158,563,721,220,43,139,159,134,1119
2014,Tim Hardaway Jr.,SG,21,NYK,81,1,1875,294,687,0.428,130,358,0.363,164,329,0.498,106,128,0.828,19,102,121,66,44,7,47,144,824
2014,Timofey Mozgov,C,27,DEN,82,30,1770,285,545,0.523,4,24,0.167,281,521,0.539,196,260,0.754,171,357,528,62,27,100,122,213,770
2014,Tobias Harris,PF,21,ORL,61,36,1850,332,716,0.464,32,126,0.254,300,590,0.508,197,244,0.807,88,336,424,82,41,24,78,143,893
2014,Toney Douglas,PG,27,TOT,51,17,675,73,190,0.384,31,102,0.304,42,88,0.477,25,34,0.735,18,69,87,68,19,5,34,81,202
2014,Toney Douglas,PG,27,GSW,24,0,265,32,86,0.372,19,59,0.322,13,27,0.481,5,8,0.625,4,22,26,19,6,2,16,34,88
2014,Toney Douglas,PG,27,MIA,27,17,410,41,104,0.394,12,43,0.279,29,61,0.475,20,26,0.769,14,47,61,49,13,3,18,47,114
2014,Tony Allen,SG,32,MEM,55,28,1278,204,413,0.494,11,47,0.234,193,366,0.527,76,121,0.628,79,129,208,94,90,19,90,121,495
2014,Tony Mitchell,PF,21,DET,21,0,79,5,12,0.417,1,1,1,4,11,0.364,11,19,0.579,15,11,26,2,6,3,4,9,22
2014,Tony Mitchell,SF,24,MIL,3,0,10,3,5,0.6,0,1,0,3,4,0.75,0,0,,1,0,1,1,1,0,0,0,6
2014,Tony Parker,PG,31,SAS,68,68,1997,456,914,0.499,25,67,0.373,431,847,0.509,197,243,0.811,17,138,155,388,36,9,151,86,1134
2014,Tony Snell,SG,22,CHI,77,12,1231,129,336,0.384,57,178,0.32,72,158,0.456,31,41,0.756,19,105,124,68,29,15,44,84,346
2014,Tony Wroten,PG,20,PHI,72,16,1765,345,808,0.427,40,188,0.213,305,620,0.492,209,326,0.641,69,159,228,217,78,16,204,151,939
2014,Tornike Shengelia,SF,22,TOT,26,0,154,13,28,0.464,0,6,0,13,22,0.591,3,8,0.375,4,12,16,14,3,1,12,18,29
2014,Tornike Shengelia,SF,22,BRK,17,0,137,11,24,0.458,0,6,0,11,18,0.611,3,8,0.375,4,10,14,12,2,1,11,16,25
2014,Tornike Shengelia,SF,22,CHI,9,0,17,2,4,0.5,0,0,,2,4,0.5,0,0,,0,2,2,2,1,0,1,2,4
2014,Toure' Murry,PG,24,NYK,51,0,373,56,129,0.434,5,12,0.417,51,117,0.436,23,39,0.59,13,31,44,49,19,1,34,46,140
2014,Travis Outlaw,SF,29,SAC,63,4,1065,130,326,0.399,41,117,0.35,89,209,0.426,42,52,0.808,36,132,168,48,20,19,26,94,343
2014,Trevor Ariza,SF,28,WAS,77,77,2723,389,853,0.456,180,442,0.407,209,411,0.509,149,193,0.772,99,376,475,191,126,20,132,179,1107
2014,Trevor Booker,PF,26,WAS,72,45,1553,222,403,0.551,0,2,0,222,401,0.554,47,76,0.618,149,230,379,64,41,45,58,131,491
2014,Trey Burke,PG,21,UTA,70,68,2262,341,897,0.38,111,336,0.33,230,561,0.41,102,113,0.903,37,171,208,396,42,6,131,145,895
2014,Tristan Thompson,PF,22,CLE,82,82,2594,363,761,0.477,0,1,0,363,760,0.478,235,339,0.693,269,485,754,72,42,35,108,188,961
2014,Troy Daniels,SG,22,HOU,5,1,75,15,31,0.484,12,25,0.48,3,6,0.5,0,0,,0,4,4,5,0,0,3,6,42
2014,Ty Lawson,PG,26,DEN,62,61,2222,347,806,0.431,72,202,0.356,275,604,0.455,324,406,0.798,40,175,215,543,100,10,200,113,1090
2014,Tyler Hansbrough,PF,28,TOR,64,4,978,93,196,0.474,0,2,0,93,194,0.479,126,185,0.681,120,167,287,17,28,19,47,132,312
2014,Tyler Zeller,C,24,CLE,70,9,1049,156,290,0.538,0,1,0,156,289,0.54,87,121,0.719,103,179,282,36,18,38,60,137,399
2014,Tyreke Evans,SF,24,NOP,72,22,2028,391,897,0.436,21,95,0.221,370,802,0.461,239,310,0.771,76,265,341,363,84,21,175,155,1042
2014,Tyshawn Taylor,PG,23,BRK,23,3,270,31,91,0.341,3,12,0.25,28,79,0.354,24,30,0.8,3,12,15,36,12,1,31,29,89
2014,Tyson Chandler,C,31,NYK,55,55,1662,191,322,0.593,0,1,0,191,321,0.595,98,155,0.632,159,370,529,59,36,63,71,145,480
2014,Udonis Haslem,PF,33,MIA,46,18,653,74,146,0.507,0,0,,74,146,0.507,25,44,0.568,42,133,175,13,11,15,24,79,173
2014,Vander Blue,SG,21,BOS,3,0,15,2,4,0.5,0,1,0,2,3,0.667,1,5,0.2,0,3,3,1,0,0,2,1,5
2014,Viacheslav Kravtsov,C,26,PHO,20,0,59,8,15,0.533,0,0,,8,15,0.533,4,8,0.5,9,8,17,1,0,1,6,7,20
2014,Victor Claver,SF,25,POR,21,0,184,17,42,0.405,3,18,0.167,14,24,0.583,10,11,0.909,9,30,39,12,3,3,11,16,47
2014,Victor Oladipo,PG,21,ORL,80,44,2487,392,936,0.419,74,226,0.327,318,710,0.448,248,318,0.78,43,286,329,327,129,37,256,210,1106
2014,Vince Carter,SG,37,DAL,81,0,1973,330,811,0.407,146,371,0.394,184,440,0.418,161,196,0.821,67,217,284,212,61,35,108,209,967
2014,Vítor Luiz Faverani,C,25,BOS,37,8,488,64,147,0.435,12,40,0.3,52,107,0.486,24,37,0.649,42,86,128,16,14,27,41,74,164
2014,Wayne Ellington,SG,26,DAL,45,1,393,55,126,0.437,25,59,0.424,30,67,0.448,10,11,0.909,8,35,43,19,16,2,11,33,145
2014,Wesley Johnson,SF,26,LAL,79,62,2240,277,651,0.425,100,271,0.369,177,380,0.466,61,77,0.792,70,278,348,124,86,77,90,207,715
2014,Wesley Matthews,SG,27,POR,82,82,2780,445,1009,0.441,201,511,0.393,244,498,0.49,252,301,0.837,51,238,289,197,76,14,110,176,1343
2014,Will Barton,SG,23,POR,41,0,387,65,156,0.417,10,33,0.303,55,123,0.447,26,32,0.813,16,58,74,33,9,7,18,31,166
2014,Will Bynum,PG,31,DET,56,3,1054,184,430,0.428,20,62,0.323,164,368,0.446,97,121,0.802,24,75,99,216,39,7,103,121,485
2014,Willie Green,SG,32,LAC,55,9,869,102,271,0.376,41,121,0.339,61,150,0.407,28,34,0.824,12,66,78,50,22,11,34,96,273
2014,Wilson Chandler,SF,26,DEN,62,55,1927,307,738,0.416,122,351,0.348,185,387,0.478,110,152,0.724,58,236,294,114,46,31,79,193,846
2014,Xavier Henry,SF,22,LAL,43,5,908,144,345,0.417,28,81,0.346,116,264,0.439,116,177,0.655,25,89,114,51,44,7,57,79,432
2014,Zach Randolph,PF,32,MEM,79,79,2705,560,1198,0.467,2,20,0.1,558,1178,0.474,250,337,0.742,265,530,795,200,54,23,183,210,1372
2014,Zaza Pachulia,C,29,MIL,53,43,1325,149,349,0.427,0,1,0,149,348,0.428,110,130,0.846,141,192,333,136,45,14,92,124,408
2015,A.J. Price,PG,28,TOT,26,0,324,51,137,0.372,15,57,0.263,36,80,0.45,16,24,0.667,6,26,32,46,7,0,14,15,133
2015,A.J. Price,PG,28,IND,10,0,193,39,89,0.438,15,39,0.385,24,50,0.48,12,18,0.667,2,12,14,27,4,0,10,9,105
2015,A.J. Price,PG,28,CLE,11,0,87,9,34,0.265,0,11,0,9,23,0.391,4,6,0.667,4,11,15,13,3,0,3,1,22
2015,A.J. Price,PG,28,PHO,5,0,44,3,14,0.214,0,7,0,3,7,0.429,0,0,,0,3,3,6,0,0,1,5,6
2015,Aaron Brooks,PG,30,CHI,82,21,1885,344,817,0.421,121,313,0.387,223,504,0.442,145,174,0.833,32,134,166,261,54,15,157,189,954
2015,Aaron Gordon,PF,19,ORL,47,8,797,93,208,0.447,13,48,0.271,80,160,0.5,44,61,0.721,46,123,169,33,21,22,38,83,243
2015,Adreian Payne,PF,23,TOT,32,22,739,91,220,0.414,1,9,0.111,90,211,0.427,30,46,0.652,48,114,162,30,19,9,44,88,213
2015,Adreian Payne,PF,23,ATL,3,0,19,2,7,0.286,0,1,0,2,6,0.333,1,2,0.5,1,3,4,0,1,0,0,4,5
2015,Adreian Payne,PF,23,MIN,29,22,720,89,213,0.418,1,8,0.125,88,205,0.429,29,44,0.659,47,111,158,30,18,9,44,84,208
2015,Al Horford,C,28,ATL,76,76,2318,519,965,0.538,11,36,0.306,508,929,0.547,107,141,0.759,131,413,544,244,68,98,100,121,1156
2015,Al Jefferson,C,30,CHO,65,61,1992,486,1010,0.481,2,5,0.4,484,1005,0.482,108,165,0.655,99,449,548,113,47,84,68,139,1082
2015,Al-Farouq Aminu,SF,24,DAL,74,3,1366,147,357,0.412,34,124,0.274,113,233,0.485,84,118,0.712,114,228,342,59,70,62,55,137,412
2015,Alan Anderson,SG,32,BRK,74,19,1744,195,440,0.443,73,210,0.348,122,230,0.53,82,101,0.812,31,173,204,83,56,5,60,148,545
2015,Alec Burks,SG,23,UTA,27,27,899,121,300,0.403,26,68,0.382,95,232,0.409,106,129,0.822,19,95,114,82,17,5,52,64,374
2015,Alex Kirk,C,23,CLE,5,0,14,1,4,0.25,0,0,,1,4,0.25,2,2,1,1,0,1,1,0,0,0,1,4
2015,Alex Len,C,21,PHO,69,44,1518,179,353,0.507,1,3,0.333,178,350,0.509,73,104,0.702,142,312,454,32,34,105,74,213,432
2015,Alexey Shved,SG,26,TOT,42,9,767,133,335,0.397,47,139,0.338,86,196,0.439,121,150,0.807,23,76,99,106,30,6,48,48,434
2015,Alexey Shved,SG,26,PHI,17,0,285,52,130,0.4,17,57,0.298,35,73,0.479,48,57,0.842,8,14,22,46,14,1,18,21,169
2015,Alexey Shved,SG,26,HOU,9,0,59,8,24,0.333,4,12,0.333,4,12,0.333,9,11,0.818,1,3,4,3,1,0,5,2,29
2015,Alexey Shved,SG,26,NYK,16,9,423,73,181,0.403,26,70,0.371,47,111,0.423,64,82,0.78,14,59,73,57,15,5,25,25,236
2015,Alexis Ajinça,C,26,NOP,68,8,957,181,329,0.55,0,0,,181,329,0.55,81,99,0.818,104,211,315,47,21,51,69,151,443
2015,Allen Crabbe,SG,22,POR,51,9,683,63,153,0.412,30,85,0.353,33,68,0.485,12,16,0.75,7,66,73,39,19,15,15,74,168
2015,Alonzo Gee,SF,27,TOT,54,2,662,87,186,0.468,13,35,0.371,74,151,0.49,54,77,0.701,37,57,94,25,35,7,33,58,241
2015,Alonzo Gee,SF,27,DEN,39,0,511,66,137,0.482,10,24,0.417,56,113,0.496,48,65,0.738,29,41,70,19,28,6,25,42,190
2015,Alonzo Gee,SF,27,POR,15,2,151,21,49,0.429,3,11,0.273,18,38,0.474,6,12,0.5,8,16,24,6,7,1,8,16,51
2015,Amar'e Stoudemire,PF,32,TOT,59,15,1245,273,490,0.557,0,4,0,273,486,0.562,134,186,0.72,110,219,329,45,29,38,78,161,680
2015,Amar'e Stoudemire,PF,32,NYK,36,14,865,169,311,0.543,0,3,0,169,308,0.549,94,127,0.74,83,162,245,37,20,34,63,111,432
2015,Amar'e Stoudemire,PF,32,DAL,23,1,380,104,179,0.581,0,1,0,104,178,0.584,40,59,0.678,27,57,84,8,9,4,15,50,248
2015,Amir Johnson,PF,27,TOR,75,72,1979,298,519,0.574,19,46,0.413,279,473,0.59,79,129,0.612,159,297,456,117,44,59,110,225,694
2015,Anderson Varejão,C,32,CLE,26,26,636,111,200,0.555,0,2,0,111,198,0.561,33,45,0.733,57,113,170,35,19,16,35,58,255
2015,Andre Dawkins,SG,23,MIA,4,0,22,1,6,0.167,1,6,0.167,0,0,,0,0,,0,2,2,1,0,0,1,3,3
2015,Andre Drummond,C,21,DET,82,82,2502,494,961,0.514,0,2,0,494,959,0.515,142,365,0.389,437,667,1104,55,73,153,120,285,1130
2015,Andre Iguodala,SF,31,GSW,77,0,2069,231,496,0.466,74,212,0.349,157,284,0.553,68,114,0.596,44,213,257,228,89,25,88,100,604
2015,Andre Miller,PG,38,TOT,81,0,1253,145,290,0.5,7,34,0.206,138,256,0.539,58,77,0.753,37,116,153,284,32,6,104,103,355
2015,Andre Miller,PG,38,WAS,51,0,631,77,142,0.542,1,8,0.125,76,134,0.567,28,39,0.718,21,56,77,143,14,2,46,56,183
2015,Andre Miller,PG,38,SAC,30,0,622,68,148,0.459,6,26,0.231,62,122,0.508,30,38,0.789,16,60,76,141,18,4,58,47,172
2015,Andre Roberson,SG,23,OKC,67,65,1286,92,201,0.458,21,85,0.247,71,116,0.612,23,48,0.479,60,195,255,70,53,29,46,141,228
2015,Andrea Bargnani,C,29,NYK,29,22,785,164,361,0.454,15,41,0.366,149,320,0.466,87,107,0.813,32,95,127,46,2,27,42,53,430
2015,Andrei Kirilenko,SF,33,BRK,7,0,36,0,5,0,0,0,,0,5,0,3,4,0.75,2,6,8,1,1,0,1,1,3
2015,Andrew Bogut,C,30,GSW,67,65,1583,200,355,0.563,0,0,,200,355,0.563,22,42,0.524,141,402,543,180,39,113,106,188,422
2015,Andrew Nicholson,PF,25,ORL,40,3,492,83,190,0.437,13,41,0.317,70,149,0.47,15,25,0.6,17,65,82,22,6,12,24,51,194
2015,Andrew Wiggins,SF,19,MIN,82,82,2969,497,1137,0.437,39,126,0.31,458,1011,0.453,354,466,0.76,134,240,374,170,86,50,177,190,1387
2015,Anthony Bennett,PF,21,MIN,57,3,894,125,297,0.421,7,23,0.304,118,274,0.431,41,64,0.641,52,164,216,48,27,16,36,87,298
2015,Anthony Davis,PF,21,NOP,68,68,2455,642,1199,0.535,1,12,0.083,641,1187,0.54,371,461,0.805,173,523,696,149,100,200,95,141,1656
2015,Anthony Morrow,SG,29,OKC,74,0,1806,285,615,0.463,141,325,0.434,144,290,0.497,79,89,0.888,40,155,195,60,54,11,38,135,790
2015,Anthony Tolliver,PF,29,TOT,76,11,1432,161,393,0.41,106,290,0.366,55,103,0.534,54,69,0.783,51,185,236,59,24,16,51,137,482
2015,Anthony Tolliver,PF,29,PHO,24,0,272,26,74,0.351,24,62,0.387,2,12,0.167,4,6,0.667,6,38,44,10,4,1,11,20,80
2015,Anthony Tolliver,PF,29,DET,52,11,1160,135,319,0.423,82,228,0.36,53,91,0.582,50,63,0.794,45,147,192,49,20,15,40,117,402
2015,Archie Goodwin,SG,20,PHO,41,2,535,79,201,0.393,12,41,0.293,67,160,0.419,61,83,0.735,27,47,74,44,18,9,48,55,231
2015,Arinze Onuaku,C,27,MIN,6,1,68,12,14,0.857,0,0,,12,14,0.857,3,8,0.375,7,14,21,4,1,3,2,6,27
2015,Aron Baynes,C,28,SAS,70,17,1122,185,327,0.566,1,4,0.25,184,323,0.57,90,104,0.865,109,209,318,35,16,22,65,162,461
2015,Arron Afflalo,SG,29,TOT,78,72,2502,375,884,0.424,118,333,0.354,257,551,0.466,167,198,0.843,27,220,247,129,41,7,116,167,1035
2015,Arron Afflalo,SG,29,DEN,53,53,1750,281,657,0.428,82,243,0.337,199,414,0.481,127,151,0.841,21,159,180,101,32,5,83,108,771
2015,Arron Afflalo,SG,29,POR,25,19,752,94,227,0.414,36,90,0.4,58,137,0.423,40,47,0.851,6,61,67,28,9,2,33,59,264
2015,Austin Daye,SF,26,TOT,34,4,344,50,141,0.355,24,71,0.338,26,70,0.371,5,6,0.833,10,65,75,17,12,5,23,39,129
2015,Austin Daye,SF,26,SAS,26,4,268,40,115,0.348,19,57,0.333,21,58,0.362,4,4,1,6,55,61,9,8,3,18,30,103
2015,Austin Daye,SF,26,ATL,8,0,76,10,26,0.385,5,14,0.357,5,12,0.417,1,2,0.5,4,10,14,8,4,2,5,9,26
2015,Austin Rivers,PG-SG,22,TOT,76,5,1563,203,496,0.409,39,131,0.298,164,365,0.449,85,126,0.675,27,125,152,155,48,14,65,146,530
2015,Austin Rivers,SG,22,NOP,35,3,772,86,222,0.387,14,50,0.28,72,172,0.419,53,71,0.746,12,56,68,87,18,7,30,65,239
2015,Austin Rivers,PG,22,LAC,41,2,791,117,274,0.427,25,81,0.309,92,193,0.477,32,55,0.582,15,69,84,68,30,7,35,81,291
2015,Avery Bradley,SG,24,BOS,77,77,2428,434,1012,0.429,124,352,0.352,310,660,0.47,79,100,0.79,46,195,241,135,82,15,109,177,1071
2015,Ben Gordon,SG,31,ORL,56,0,790,129,295,0.437,35,97,0.361,94,198,0.475,56,67,0.836,6,57,63,50,14,1,55,60,349
2015,Ben McLemore,SG,21,SAC,82,82,2670,363,831,0.437,140,391,0.358,223,440,0.507,130,160,0.813,31,210,241,140,77,19,138,219,996
2015,Beno Udrih,PG,32,MEM,79,12,1494,246,505,0.487,26,97,0.268,220,408,0.539,87,102,0.853,20,123,143,220,46,8,89,88,605
2015,Bernard James,C,29,DAL,16,2,158,12,27,0.444,0,0,,12,27,0.444,20,23,0.87,18,21,39,4,2,15,6,17,44
2015,Bismack Biyombo,C,22,CHO,64,21,1243,101,186,0.543,0,0,,101,186,0.543,102,175,0.583,159,248,407,16,18,99,52,140,304
2015,Blake Griffin,PF,25,LAC,67,67,2356,574,1144,0.502,10,25,0.4,564,1119,0.504,311,427,0.728,126,382,508,354,63,35,152,196,1469
2015,Bojan Bogdanović,SF,25,BRK,78,28,1854,261,576,0.453,91,256,0.355,170,320,0.531,87,106,0.821,50,163,213,68,34,9,78,104,700
2015,Boris Diaw,PF,32,SAS,81,15,1984,291,632,0.46,54,169,0.32,237,463,0.512,72,93,0.774,78,270,348,233,36,23,126,148,708
2015,Bradley Beal,SG,21,WAS,63,59,2107,363,851,0.427,106,259,0.409,257,592,0.434,130,166,0.783,57,184,241,194,76,18,123,136,962
2015,Brandan Wright,PF,27,TOT,75,7,1449,233,363,0.642,0,3,0,233,360,0.647,78,112,0.696,128,193,321,41,50,94,34,102,544
2015,Brandan Wright,PF,27,DAL,27,0,505,101,135,0.748,0,0,,101,135,0.748,36,48,0.75,51,59,110,10,17,42,13,44,238
2015,Brandan Wright,PF,27,BOS,8,0,86,12,21,0.571,0,0,,12,21,0.571,2,4,0.5,7,10,17,8,1,5,5,4,26
2015,Brandan Wright,PF,27,PHO,40,7,858,120,207,0.58,0,3,0,120,204,0.588,40,60,0.667,70,124,194,23,32,47,16,54,280
2015,Brandon Bass,PF,29,BOS,82,43,1929,344,683,0.504,9,32,0.281,335,651,0.515,169,214,0.79,139,259,398,104,41,32,83,140,866
2015,Brandon Davies,PF,23,TOT,27,6,423,55,137,0.401,8,34,0.235,47,103,0.456,24,37,0.649,38,45,83,30,18,7,29,59,142
2015,Brandon Davies,PF,23,PHI,20,6,379,49,119,0.412,7,30,0.233,42,89,0.472,21,33,0.636,35,38,73,28,17,4,25,54,126
2015,Brandon Davies,PF,23,BRK,7,0,44,6,18,0.333,1,4,0.25,5,14,0.357,3,4,0.75,3,7,10,2,1,3,4,5,16
2015,Brandon Jennings,PG,25,DET,41,41,1173,218,543,0.401,76,211,0.36,142,332,0.428,120,143,0.839,21,83,104,272,44,4,90,64,632
2015,Brandon Knight,PG-SG,23,TOT,63,61,2035,375,888,0.422,125,321,0.389,250,567,0.441,195,223,0.874,28,216,244,330,90,10,189,114,1070
2015,Brandon Knight,PG,23,MIL,52,52,1688,324,745,0.435,104,254,0.409,220,491,0.448,171,194,0.881,26,195,221,281,84,9,166,93,923
2015,Brandon Knight,SG,23,PHO,11,9,347,51,143,0.357,21,67,0.313,30,76,0.395,24,29,0.828,2,21,23,49,6,1,23,21,147
2015,Brandon Rush,SG,29,GSW,33,0,271,11,54,0.204,3,27,0.111,8,27,0.296,5,11,0.455,4,37,41,12,5,12,11,27,30
2015,Brendan Haywood,C,35,CLE,22,1,119,14,30,0.467,0,0,,14,30,0.467,7,13,0.538,6,23,29,2,2,10,10,17,35
2015,Brian Roberts,PG,29,CHO,72,10,1330,176,452,0.389,62,193,0.321,114,259,0.44,66,74,0.892,13,96,109,162,33,6,57,75,480
2015,Brook Lopez,C,26,BRK,72,44,2100,506,987,0.513,1,10,0.1,505,977,0.517,223,274,0.814,214,321,535,50,43,126,104,206,1236
2015,Bruno Caboclo,SF,19,TOR,8,0,23,4,12,0.333,2,3,0.667,2,9,0.222,0,0,,1,1,2,0,0,1,4,3,10
2015,Bryce Cotton,PG,22,UTA,15,0,159,29,69,0.42,7,20,0.35,22,49,0.449,15,18,0.833,3,15,18,15,4,0,12,6,80
2015,C.J. Miles,SG,27,IND,70,40,1841,329,827,0.398,154,446,0.345,175,381,0.459,130,161,0.807,18,196,214,75,60,26,73,132,942
2015,C.J. Watson,PG,30,IND,57,21,1422,181,417,0.434,70,175,0.4,111,242,0.459,138,167,0.826,18,145,163,208,57,9,100,107,570
2015,C.J. Wilcox,SG,24,LAC,21,0,101,16,38,0.421,7,19,0.368,9,19,0.474,2,2,1,1,6,7,8,3,1,10,7,41
2015,Cameron Bairstow,PF,24,CHI,18,1,64,3,14,0.214,0,0,,3,14,0.214,4,5,0.8,6,2,8,1,2,1,3,8,10
2015,Carl Landry,PF,31,SAC,70,15,1192,190,369,0.515,0,0,,190,369,0.515,123,150,0.82,99,169,268,26,15,17,54,132,503
2015,Carlos Boozer,PF,33,LAL,71,26,1692,371,743,0.499,0,0,,371,743,0.499,94,150,0.627,111,371,482,95,41,12,92,184,836
2015,Carmelo Anthony,SF,30,NYK,40,40,1428,358,806,0.444,61,179,0.341,297,627,0.474,189,237,0.797,72,192,264,122,40,17,89,87,966
2015,Caron Butler,SF,34,DET,78,21,1623,161,396,0.407,83,219,0.379,78,177,0.441,55,61,0.902,21,175,196,79,43,4,49,120,460
2015,Cartier Martin,SF,30,DET,23,0,198,15,53,0.283,6,33,0.182,9,20,0.45,0,0,,0,20,20,11,3,1,5,20,36
2015,Chandler Parsons,SF,26,DAL,66,66,2186,383,829,0.462,132,347,0.38,251,482,0.521,139,193,0.72,64,259,323,161,69,19,96,140,1037
2015,Channing Frye,PF,31,ORL,75,51,1870,191,487,0.392,136,346,0.393,55,141,0.39,31,35,0.886,27,266,293,94,47,39,78,191,549
2015,Charlie Villanueva,PF,30,DAL,64,1,678,150,362,0.414,83,221,0.376,67,141,0.475,20,35,0.571,30,119,149,19,15,22,28,64,403
2015,Chase Budinger,SF,26,MIN,67,4,1286,169,390,0.433,52,143,0.364,117,247,0.474,67,81,0.827,33,165,198,64,44,10,49,72,457
2015,Chris Andersen,C,36,MIA,60,20,1132,120,207,0.58,4,13,0.308,116,194,0.598,76,114,0.667,76,223,299,43,26,61,40,88,320
2015,Chris Bosh*,C,30,MIA,44,44,1556,343,745,0.46,63,168,0.375,280,577,0.485,179,232,0.772,46,264,310,95,41,25,95,69,928
2015,Chris Copeland,SF,30,IND,50,12,828,112,310,0.361,52,167,0.311,60,143,0.42,33,45,0.733,23,88,111,51,11,11,59,78,309
2015,Chris Douglas-Roberts,SG,28,LAC,12,0,103,5,21,0.238,1,7,0.143,4,14,0.286,8,8,1,1,11,12,4,1,0,0,14,19
2015,Chris Johnson,SF,24,TOT,29,2,526,62,154,0.403,28,95,0.295,34,59,0.576,14,16,0.875,8,47,55,15,26,7,15,44,166
2015,Chris Johnson,SF,24,PHI,9,2,187,19,60,0.317,10,39,0.256,9,21,0.429,6,8,0.75,3,23,26,3,9,5,9,19,54
2015,Chris Johnson,SF,24,UTA,12,0,211,31,64,0.484,13,38,0.342,18,26,0.692,6,6,1,3,15,18,7,12,0,6,18,81
2015,Chris Johnson,SF,24,MIL,8,0,128,12,30,0.4,5,18,0.278,7,12,0.583,2,2,1,2,9,11,5,5,2,0,7,31
2015,Chris Kaman,C,32,POR,74,13,1398,283,549,0.515,0,0,,283,549,0.515,72,102,0.706,149,335,484,65,18,54,108,140,638
2015,Chris Paul,PG,29,LAC,82,82,2857,568,1170,0.485,139,349,0.398,429,821,0.523,289,321,0.9,52,324,376,838,156,15,190,203,1564
2015,Chuck Hayes,C,31,TOR,29,0,255,22,46,0.478,0,0,,22,46,0.478,6,11,0.545,18,33,51,20,10,4,8,37,50
2015,CJ McCollum,SG,23,POR,62,3,973,159,365,0.436,55,139,0.396,104,226,0.46,51,73,0.699,14,77,91,64,43,8,48,81,424
2015,Cleanthony Early,SF,23,NYK,39,7,647,76,214,0.355,22,84,0.262,54,130,0.415,36,48,0.75,22,75,97,36,24,12,40,57,210
2015,Clint Capela,C,20,HOU,12,0,90,14,29,0.483,0,0,,14,29,0.483,4,23,0.174,10,26,36,2,1,9,5,14,32
2015,Cody Zeller,C,22,CHO,62,45,1487,172,373,0.461,1,1,1,171,372,0.46,127,164,0.774,97,265,362,100,34,49,62,156,472
2015,Cole Aldrich,C,26,NYK,61,16,976,144,301,0.478,0,0,,144,301,0.478,50,64,0.781,101,237,338,75,37,65,59,122,338
2015,Corey Brewer,SF,28,TOT,80,17,2087,343,805,0.426,63,235,0.268,280,570,0.491,168,226,0.743,80,217,297,173,114,19,131,173,917
2015,Corey Brewer,SF,28,MIN,24,16,680,94,225,0.418,8,41,0.195,86,184,0.467,55,78,0.705,32,62,94,78,54,4,50,62,251
2015,Corey Brewer,SF,28,HOU,56,1,1407,249,580,0.429,55,194,0.284,194,386,0.503,113,148,0.764,48,155,203,95,60,15,81,111,666
2015,Cory Jefferson,PF,24,BRK,50,1,531,75,167,0.449,2,15,0.133,73,152,0.48,31,54,0.574,47,98,145,16,10,21,20,61,183
2015,Cory Joseph,PG,23,SAS,79,14,1444,207,411,0.504,16,44,0.364,191,367,0.52,105,143,0.734,44,148,192,188,46,17,67,105,535
2015,Courtney Lee,SG,29,MEM,77,74,2354,288,643,0.448,90,224,0.402,198,419,0.473,111,129,0.86,21,157,178,151,75,12,78,129,777
2015,D.J. Augustin,PG,27,TOT,82,14,1964,258,647,0.399,83,246,0.337,175,401,0.436,178,205,0.868,20,141,161,353,49,3,145,93,777
2015,D.J. Augustin,PG,27,DET,54,13,1287,189,461,0.41,49,150,0.327,140,311,0.45,147,169,0.87,13,87,100,265,33,2,110,61,574
2015,D.J. Augustin,PG,27,OKC,28,1,677,69,186,0.371,34,96,0.354,35,90,0.389,31,36,0.861,7,54,61,88,16,1,35,32,203
2015,Dahntay Jones,SF,34,LAC,33,0,123,6,21,0.286,0,4,0,6,17,0.353,9,11,0.818,1,10,11,2,3,0,1,23,21
2015,Damian Lillard,PG,24,POR,82,82,2925,590,1360,0.434,196,572,0.343,394,788,0.5,344,398,0.864,49,329,378,507,97,21,222,164,1720
2015,Damjan Rudež,SF,28,IND,68,2,1047,119,263,0.452,69,170,0.406,50,93,0.538,16,23,0.696,8,39,47,53,16,5,47,79,323
2015,Danilo Gallinari,SF,26,DEN,59,27,1426,228,568,0.401,107,301,0.355,121,267,0.453,171,191,0.895,31,187,218,83,47,20,57,94,734
2015,Danny Granger,SF,31,MIA,30,6,613,65,162,0.401,30,84,0.357,35,78,0.449,28,37,0.757,20,60,80,17,13,6,24,67,188
2015,Danny Green,SG,27,SAS,81,80,2312,322,738,0.436,191,457,0.418,131,281,0.466,111,127,0.874,54,289,343,158,101,87,93,163,946
2015,Dante Cunningham,PF,27,NOP,66,27,1652,155,339,0.457,1,10,0.1,154,329,0.468,29,47,0.617,70,186,256,50,46,37,35,101,340
2015,Dante Exum,PG,19,UTA,82,41,1817,145,416,0.349,83,264,0.314,62,152,0.408,20,32,0.625,27,104,131,198,41,14,118,147,393
2015,Darius Miller,SF,24,NOP,5,1,43,1,7,0.143,0,1,0,1,6,0.167,0,0,,0,1,1,2,1,0,1,8,2
2015,Darius Morris,PG,24,BRK,38,0,299,36,106,0.34,7,33,0.212,29,73,0.397,4,9,0.444,7,20,27,48,9,0,21,20,83
2015,Darrell Arthur,PF,26,DEN,58,4,988,155,384,0.404,26,110,0.236,129,274,0.471,46,59,0.78,53,118,171,57,48,26,47,146,382
2015,Darren Collison,PG,27,SAC,45,45,1565,260,550,0.473,60,161,0.373,200,389,0.514,145,184,0.788,19,124,143,252,67,14,112,95,725
2015,David Lee,PF,31,GSW,49,4,904,160,313,0.511,0,2,0,160,311,0.514,68,104,0.654,81,176,257,85,31,26,49,83,388
2015,David Stockton,PG,23,SAC,3,0,33,2,6,0.333,1,2,0.5,1,4,0.25,3,6,0.5,0,2,2,9,2,0,4,1,8
2015,David Wear,PF,24,SAC,2,0,7,0,2,0,0,1,0,0,1,0,0,0,,2,0,2,1,0,0,0,1,0
2015,David West,PF,34,IND,66,66,1895,323,686,0.471,4,20,0.2,319,666,0.479,119,161,0.739,108,341,449,223,48,48,120,160,769
2015,DeAndre Jordan,C,26,LAC,82,82,2820,379,534,0.71,1,4,0.25,378,530,0.713,187,471,0.397,397,829,1226,61,81,183,109,245,946
2015,DeJuan Blair,PF,25,WAS,29,0,180,26,57,0.456,0,0,,26,57,0.456,4,6,0.667,16,40,56,3,7,1,13,41,56
2015,DeMar DeRozan,SG,25,TOR,60,60,2100,409,990,0.413,25,88,0.284,384,902,0.426,361,434,0.832,41,236,277,210,73,11,137,122,1204
2015,DeMarcus Cousins,C,24,SAC,59,59,2013,498,1066,0.467,2,8,0.25,496,1058,0.469,423,541,0.782,185,562,747,210,90,103,254,241,1421
2015,DeMarre Carroll,SF,28,ATL,70,69,2189,318,653,0.487,120,304,0.395,198,349,0.567,127,181,0.702,99,273,372,118,94,17,75,154,883
2015,Dennis Schröder,PG,21,ATL,77,10,1516,284,665,0.427,52,148,0.351,232,517,0.449,148,179,0.827,29,135,164,317,49,4,150,127,768
2015,Deron Williams,PG,30,BRK,68,55,2114,298,771,0.387,87,237,0.367,211,534,0.395,201,241,0.834,29,208,237,448,64,17,154,157,884
2015,Derrick Favors,PF,23,UTA,74,74,2280,482,918,0.525,1,6,0.167,481,912,0.527,222,332,0.669,196,411,607,112,60,123,121,210,1187
2015,Derrick Rose,PG,26,CHI,51,51,1530,338,835,0.405,76,271,0.28,262,564,0.465,152,187,0.813,35,126,161,251,36,16,161,63,904
2015,Derrick Williams,PF,23,SAC,74,6,1462,217,485,0.447,49,156,0.314,168,329,0.511,134,196,0.684,41,161,202,50,34,4,56,67,617
2015,Devin Harris,PG,31,DAL,76,3,1685,219,524,0.418,95,266,0.357,124,258,0.481,132,162,0.815,13,122,135,237,78,14,85,147,665
2015,Devyn Marble,SG,22,ORL,16,7,208,14,44,0.318,4,22,0.182,10,22,0.455,5,16,0.313,5,26,31,17,9,2,9,14,37
2015,Dewayne Dedmon,C,25,ORL,59,15,845,91,162,0.562,0,1,0,91,161,0.565,34,64,0.531,118,177,295,9,16,50,51,141,216
2015,Dion Waiters,SG,23,TOT,80,23,2208,375,946,0.396,73,246,0.297,302,700,0.431,117,172,0.68,41,151,192,163,90,21,113,155,940
2015,Dion Waiters,SG,23,CLE,33,3,786,138,342,0.404,22,86,0.256,116,256,0.453,47,60,0.783,12,45,57,74,44,10,50,59,345
2015,Dion Waiters,SG,23,OKC,47,20,1422,237,604,0.392,51,160,0.319,186,444,0.419,70,112,0.625,29,106,135,89,46,11,63,96,595
2015,Dirk Nowitzki,PF,36,DAL,77,77,2282,487,1062,0.459,104,274,0.38,383,788,0.486,255,289,0.882,44,413,457,143,39,33,82,160,1333
2015,Donald Sloan,PG,27,IND,53,21,1107,145,355,0.408,41,131,0.313,104,224,0.464,60,77,0.779,12,131,143,190,23,0,65,47,391
2015,Donatas Motiejūnas,PF,24,HOU,71,62,2037,353,700,0.504,49,133,0.368,304,567,0.536,100,166,0.602,137,284,421,130,56,34,123,203,855
2015,Dorell Wright,SF,29,POR,48,2,592,72,190,0.379,41,108,0.38,31,82,0.378,34,42,0.81,14,97,111,41,20,11,18,55,219
2015,Doug McDermott,SF,23,CHI,36,0,321,43,107,0.402,13,41,0.317,30,66,0.455,10,15,0.667,6,37,43,6,4,1,17,29,109
2015,Draymond Green,PF,24,GSW,79,79,2490,339,765,0.443,111,329,0.337,228,436,0.523,132,200,0.66,114,533,647,291,123,99,133,253,921
2015,Drew Gooden,PF,33,WAS,51,7,864,110,276,0.399,23,59,0.39,87,217,0.401,34,44,0.773,72,151,223,49,21,9,28,91,277
2015,Drew Gordon,PF,24,PHI,9,0,71,8,19,0.421,0,3,0,8,16,0.5,1,2,0.5,7,11,18,2,1,0,8,7,17
2015,Dwight Buycks,PG,25,LAL,6,0,123,18,40,0.45,7,11,0.636,11,29,0.379,9,10,0.9,2,10,12,14,3,0,12,3,52
2015,Dwight Howard,C,29,HOU,41,41,1223,251,423,0.593,1,2,0.5,250,421,0.594,143,271,0.528,110,321,431,50,28,53,115,137,646
2015,Dwight Powell,PF,23,TOT,29,0,236,31,67,0.463,3,11,0.273,28,56,0.5,25,33,0.758,18,32,50,9,9,6,11,40,90
2015,Dwight Powell,PF,23,BOS,5,0,9,4,5,0.8,0,0,,4,5,0.8,1,2,0.5,0,1,1,0,2,0,2,1,9
2015,Dwight Powell,PF,23,DAL,24,0,227,27,62,0.435,3,11,0.273,24,51,0.471,24,31,0.774,18,31,49,9,7,6,9,39,81
2015,Dwyane Wade,SG,33,MIA,62,62,1971,509,1084,0.47,29,102,0.284,480,982,0.489,284,370,0.768,58,161,219,299,73,21,209,105,1331
2015,E'Twaun Moore,SG,25,CHI,56,0,504,62,139,0.446,13,38,0.342,49,101,0.485,12,20,0.6,12,34,46,33,20,6,14,45,149
2015,Earl Barron,C,33,PHO,16,1,143,12,39,0.308,2,4,0.5,10,35,0.286,6,12,0.5,14,14,28,5,4,2,5,26,32
2015,Earl Clark,PF,27,BRK,10,0,93,11,30,0.367,4,14,0.286,7,16,0.438,1,4,0.25,1,22,23,3,3,4,6,12,27
2015,Ed Davis,PF,25,LAL,79,24,1840,282,469,0.601,0,0,,282,469,0.601,92,189,0.487,230,370,600,94,49,98,58,202,656
2015,Ekpe Udoh,PF,27,LAC,33,0,128,11,24,0.458,0,0,,11,24,0.458,7,9,0.778,7,19,26,8,8,7,7,20,29
2015,Elfrid Payton,PG,20,ORL,82,63,2489,301,708,0.425,11,42,0.262,290,666,0.435,118,214,0.551,107,242,349,533,142,20,203,193,731
2015,Elijah Millsap,SG,27,UTA,47,5,924,81,238,0.34,28,90,0.311,53,148,0.358,58,86,0.674,28,122,150,58,56,16,67,124,248
2015,Elliot Williams,SG,25,TOT,13,0,119,14,37,0.378,8,18,0.444,6,19,0.316,1,4,0.25,0,8,8,12,4,0,4,12,37
2015,Elliot Williams,SG,25,UTA,5,0,42,6,13,0.462,5,7,0.714,1,6,0.167,1,2,0.5,0,3,3,4,2,0,4,1,18
2015,Elliot Williams,SG,25,NOP,8,0,77,8,24,0.333,3,11,0.273,5,13,0.385,0,2,0,0,5,5,8,2,0,0,11,19
2015,Elton Brand,C,35,ATL,36,4,486,42,95,0.442,0,1,0,42,94,0.447,12,23,0.522,28,72,100,22,17,25,18,54,96
2015,Enes Freedom,C,22,TOT,75,74,2135,482,928,0.519,16,45,0.356,466,883,0.528,183,234,0.782,277,394,671,55,36,29,145,189,1163
2015,Enes Freedom,C,22,UTA,49,48,1326,286,582,0.491,13,41,0.317,273,541,0.505,93,118,0.788,147,237,384,26,23,16,93,114,678
2015,Enes Freedom,C,22,OKC,26,26,809,196,346,0.566,3,4,0.75,193,342,0.564,90,116,0.776,130,157,287,29,13,13,52,75,485
2015,Eric Bledsoe,PG,25,PHO,81,81,2800,468,1046,0.447,88,272,0.324,380,774,0.491,353,441,0.8,72,351,423,493,127,45,274,189,1377
2015,Eric Gordon,SG,26,NOP,61,60,2018,285,694,0.411,141,315,0.448,144,379,0.38,107,133,0.805,28,131,159,229,50,14,122,145,818
2015,Eric Moreland,PF,23,SAC,3,0,2,1,1,1,0,0,,1,1,1,0,0,,0,1,1,0,0,0,0,1,2
2015,Erick Green,PG,23,DEN,43,1,410,61,162,0.377,14,47,0.298,47,115,0.409,10,12,0.833,7,24,31,39,12,0,14,26,146
2015,Ersan İlyasova,PF,27,MIL,58,36,1319,263,557,0.472,74,190,0.389,189,367,0.515,69,107,0.645,80,197,277,56,36,19,45,149,669
2015,Evan Fournier,SG,22,ORL,58,32,1661,253,575,0.44,85,225,0.378,168,350,0.48,107,147,0.728,28,125,153,120,40,2,82,116,698
2015,Evan Turner,SG,26,BOS,82,57,2260,320,746,0.429,33,119,0.277,287,627,0.458,106,141,0.752,40,377,417,449,83,19,198,180,779
2015,Festus Ezeli,C,25,GSW,46,7,504,76,139,0.547,0,0,,76,139,0.547,49,78,0.628,60,95,155,9,7,42,32,77,201
2015,Francisco García,SF,33,HOU,14,0,200,17,63,0.27,10,45,0.222,7,18,0.389,1,4,0.25,3,14,17,15,9,5,10,20,45
2015,Furkan Aldemir,PF,23,PHI,41,9,540,40,78,0.513,0,5,0,40,73,0.548,13,27,0.481,78,98,176,28,17,16,17,96,93
2015,Gal Mekel,PG,26,NOP,4,0,43,3,20,0.15,0,3,0,3,17,0.176,0,0,,0,1,1,13,2,0,2,1,6
2015,Garrett Temple,SG,28,WAS,52,18,735,68,170,0.4,33,88,0.375,35,82,0.427,35,48,0.729,24,66,90,56,42,9,34,76,204
2015,Gary Harris,SG,20,DEN,55,6,719,66,217,0.304,21,103,0.204,45,114,0.395,35,47,0.745,21,43,64,29,39,7,38,71,188
2015,Gary Neal,SG,30,TOT,54,1,1193,188,503,0.374,50,164,0.305,138,339,0.407,117,135,0.867,14,115,129,100,23,1,65,88,543
2015,Gary Neal,SG,30,CHO,43,0,931,143,398,0.359,39,133,0.293,104,265,0.392,88,102,0.863,14,80,94,80,16,1,55,70,413
2015,Gary Neal,SG,30,MIN,11,1,262,45,105,0.429,11,31,0.355,34,74,0.459,29,33,0.879,0,35,35,20,7,0,10,18,130
2015,George Hill,PG,28,IND,43,36,1267,255,535,0.477,69,193,0.358,186,342,0.544,113,143,0.79,25,154,179,220,44,14,69,111,692
2015,Gerald Green,SG,29,PHO,74,4,1446,324,778,0.416,137,387,0.354,187,391,0.478,99,120,0.825,33,153,186,91,42,12,104,145,884
2015,Gerald Henderson,SG,27,CHO,80,72,2315,370,847,0.437,45,136,0.331,325,711,0.457,184,217,0.848,36,237,273,206,51,22,110,135,969
2015,Gerald Wallace,SF,32,BOS,32,0,286,14,34,0.412,1,3,0.333,13,31,0.419,6,15,0.4,17,40,57,11,15,4,18,19,35
2015,Giannis Antetokounmpo,SG,20,MIL,81,71,2541,383,780,0.491,7,44,0.159,376,736,0.511,257,347,0.741,100,442,542,207,73,85,173,254,1030
2015,Gigi Datome,SF,27,TOT,21,1,209,43,89,0.483,18,40,0.45,25,49,0.51,1,1,1,3,26,29,9,2,7,9,15,105
2015,Gigi Datome,SF,27,DET,3,0,17,5,12,0.417,1,4,0.25,4,8,0.5,0,0,,1,3,4,2,1,0,2,1,11
2015,Gigi Datome,SF,27,BOS,18,1,192,38,77,0.494,17,36,0.472,21,41,0.512,1,1,1,2,23,25,7,1,7,7,14,94
2015,Glen Davis,PF,29,LAC,74,0,904,117,255,0.459,0,4,0,117,251,0.466,60,95,0.632,43,126,169,39,41,21,39,132,294
2015,Glen Rice Jr.,SG,24,WAS,5,0,43,3,15,0.2,1,7,0.143,2,8,0.25,4,6,0.667,2,2,4,2,0,0,2,11,11
2015,Glenn Robinson III,SG-SF,21,TOT,35,1,261,26,67,0.388,5,19,0.263,21,48,0.438,16,24,0.667,15,24,39,11,6,1,11,15,73
2015,Glenn Robinson III,SG,21,MIN,25,0,108,8,24,0.333,1,6,0.167,7,18,0.389,12,16,0.75,4,10,14,3,3,0,3,5,29
2015,Glenn Robinson III,SF,21,PHI,10,1,153,18,43,0.419,4,13,0.308,14,30,0.467,4,8,0.5,11,14,25,8,3,1,8,10,44
2015,Goran Dragić,SG-PG,28,TOT,78,78,2640,502,1002,0.501,90,259,0.347,412,743,0.555,181,234,0.774,81,193,274,350,78,15,173,195,1275
2015,Goran Dragić,SG,28,PHO,52,52,1735,340,679,0.501,66,186,0.355,274,493,0.556,97,130,0.746,51,134,185,211,50,9,114,120,843
2015,Goran Dragić,PG,28,MIA,26,26,905,162,323,0.502,24,73,0.329,138,250,0.552,84,104,0.808,30,59,89,139,28,6,59,75,432
2015,Gordon Hayward,SF,24,UTA,76,76,2618,484,1087,0.445,120,330,0.364,364,757,0.481,375,462,0.812,54,319,373,313,108,30,206,131,1463
2015,Gorgui Dieng,C,25,MIN,73,49,2193,259,512,0.506,1,6,0.167,258,506,0.51,191,244,0.783,223,386,609,146,71,126,126,188,710
2015,Grant Jerrett,PF,21,TOT,8,0,51,7,26,0.269,1,15,0.067,6,11,0.545,1,1,1,2,7,9,3,2,2,3,11,16
2015,Grant Jerrett,PF,21,OKC,5,0,25,3,17,0.176,1,13,0.077,2,4,0.5,0,0,,1,3,4,1,0,2,2,7,7
2015,Grant Jerrett,PF,21,UTA,3,0,26,4,9,0.444,0,2,0,4,7,0.571,1,1,1,1,4,5,2,2,0,1,4,9
2015,Greg Monroe,PF,24,DET,69,57,2137,423,853,0.496,0,0,,423,853,0.496,252,336,0.75,229,475,704,142,78,34,149,148,1098
2015,Greg Smith,PF,24,DAL,42,2,363,30,49,0.612,0,0,,30,49,0.612,20,39,0.513,26,53,79,9,7,11,11,53,80
2015,Greg Stiemsma,C,29,TOR,17,0,66,6,8,0.75,0,0,,6,8,0.75,2,4,0.5,9,6,15,3,2,0,7,15,14
2015,Greivis Vásquez,PG,28,TOR,82,29,1991,296,725,0.408,133,351,0.379,163,374,0.436,50,66,0.758,22,194,216,302,46,10,119,177,775
2015,Harrison Barnes,SF,22,GSW,82,82,2318,316,656,0.482,87,215,0.405,229,441,0.519,108,150,0.72,117,336,453,116,61,19,71,146,827
2015,Hassan Whiteside,C,25,MIA,48,32,1142,243,387,0.628,0,0,,243,387,0.628,78,156,0.5,145,337,482,6,27,123,58,129,564
2015,Hedo Türkoğlu,SF,35,LAC,62,2,705,83,188,0.441,60,139,0.432,23,49,0.469,6,11,0.545,5,94,99,37,19,7,29,66,232
2015,Henry Sims,C,24,PHI,73,32,1399,238,502,0.474,4,22,0.182,234,480,0.488,106,137,0.774,121,238,359,79,39,30,99,135,586
2015,Henry Walker,SF,27,MIA,24,13,628,58,168,0.345,45,132,0.341,13,36,0.361,14,18,0.778,7,75,82,29,24,9,24,76,175
2015,Hollis Thompson,SG,23,PHI,71,23,1776,224,543,0.413,115,287,0.401,109,256,0.426,63,89,0.708,53,145,198,85,57,26,66,141,626
2015,Ian Clark,SG,23,TOT,30,0,192,19,55,0.345,10,30,0.333,9,25,0.36,9,9,1,4,12,16,12,9,3,9,20,57
2015,Ian Clark,SG,23,UTA,23,0,161,15,44,0.341,9,25,0.36,6,19,0.316,5,5,1,4,9,13,10,6,2,7,12,44
2015,Ian Clark,SG,23,DEN,7,0,31,4,11,0.364,1,5,0.2,3,6,0.5,4,4,1,0,3,3,2,3,1,2,8,13
2015,Ian Mahinmi,C,28,IND,61,6,1146,117,212,0.552,0,0,,117,212,0.552,31,102,0.304,105,251,356,33,30,46,59,172,265
2015,Iman Shumpert,SG,24,TOT,62,25,1545,193,471,0.41,67,196,0.342,126,275,0.458,43,64,0.672,55,169,224,135,81,16,91,138,496
2015,Iman Shumpert,SG,24,NYK,24,24,625,88,215,0.409,23,66,0.348,65,149,0.436,25,37,0.676,22,59,81,78,30,3,42,67,224
2015,Iman Shumpert,SG,24,CLE,38,1,920,105,256,0.41,44,130,0.338,61,126,0.484,18,27,0.667,33,110,143,57,51,13,49,71,272
2015,Isaiah Canaan,PG,23,TOT,47,21,938,146,378,0.386,91,246,0.37,55,132,0.417,49,60,0.817,18,69,87,98,29,3,62,83,432
2015,Isaiah Canaan,PG,23,HOU,25,9,369,53,131,0.405,32,84,0.381,21,47,0.447,16,21,0.762,11,22,33,29,14,0,23,28,154
2015,Isaiah Canaan,PG,23,PHI,22,12,569,93,247,0.377,59,162,0.364,34,85,0.4,33,39,0.846,7,47,54,69,15,3,39,55,278
2015,Isaiah Thomas,PG,25,TOT,67,1,1726,335,797,0.42,129,346,0.373,206,451,0.457,302,348,0.868,33,120,153,284,57,5,143,150,1101
2015,Isaiah Thomas,PG,25,PHO,46,1,1181,218,512,0.426,81,207,0.391,137,305,0.449,184,211,0.872,26,83,109,171,45,5,89,105,701
2015,Isaiah Thomas,PG,25,BOS,21,0,545,117,285,0.411,48,139,0.345,69,146,0.473,118,137,0.861,7,37,44,113,12,0,54,45,400
2015,Ish Smith,PG,26,TOT,55,14,832,143,367,0.39,18,60,0.3,125,307,0.407,34,57,0.596,15,85,100,180,36,6,78,50,338
2015,Ish Smith,PG,26,OKC,30,0,155,15,45,0.333,1,5,0.2,14,40,0.35,6,9,0.667,5,22,27,28,4,1,9,12,37
2015,Ish Smith,PG,26,PHI,25,14,677,128,322,0.398,17,55,0.309,111,267,0.416,28,48,0.583,10,63,73,152,32,5,69,38,301
2015,J.J. Barea,PG,30,DAL,77,10,1362,225,536,0.42,54,167,0.323,171,369,0.463,76,94,0.809,23,111,134,263,33,1,70,104,580
2015,J.J. Hickson,C,26,DEN,73,8,1411,218,459,0.475,0,2,0,218,457,0.477,116,201,0.577,150,302,452,57,36,35,96,136,552
2015,J.J. Redick,SG,30,LAC,78,78,2409,447,938,0.477,200,458,0.437,247,480,0.515,183,203,0.901,22,145,167,137,39,8,95,134,1277
2015,J.R. Smith,SG,29,TOT,70,51,2080,315,755,0.417,163,426,0.383,152,329,0.462,54,72,0.75,30,188,218,195,82,22,97,163,847
2015,J.R. Smith,SG,29,NYK,24,6,619,101,251,0.402,32,90,0.356,69,161,0.429,27,39,0.692,4,54,58,81,18,4,45,44,261
2015,J.R. Smith,SG,29,CLE,46,45,1461,214,504,0.425,131,336,0.39,83,168,0.494,27,33,0.818,26,134,160,114,64,18,52,119,586
2015,Jabari Brown,SG,22,LAL,19,5,568,70,170,0.412,23,62,0.371,47,108,0.435,64,85,0.753,3,33,36,40,12,2,32,33,227
2015,Jabari Parker,PF,19,MIL,25,25,738,129,263,0.49,4,16,0.25,125,247,0.506,46,66,0.697,50,88,138,42,31,5,47,42,308
2015,Jack Cooley,C,23,UTA,16,0,87,9,22,0.409,0,0,,9,22,0.409,9,21,0.429,10,15,25,1,6,3,3,23,27
2015,Jae Crowder,SF,24,TOT,82,17,1647,229,545,0.42,61,208,0.293,168,337,0.499,109,141,0.773,72,221,293,94,72,25,49,137,628
2015,Jae Crowder,SF,24,DAL,25,0,265,33,76,0.434,13,38,0.342,20,38,0.526,10,11,0.909,12,17,29,12,15,5,10,26,89
2015,Jae Crowder,SF,24,BOS,57,17,1382,196,469,0.418,48,170,0.282,148,299,0.495,99,130,0.762,60,204,264,82,57,20,39,111,539
2015,JaKarr Sampson,SF,21,PHI,74,32,1131,146,346,0.422,31,127,0.244,115,219,0.525,63,94,0.67,35,128,163,77,38,26,76,135,386
2015,Jamaal Franklin,SG,23,DEN,3,0,13,1,2,0.5,1,2,0.5,0,0,,0,0,,1,1,2,3,0,1,3,4,3
2015,Jamal Crawford,SG,34,LAC,64,4,1703,332,839,0.396,119,364,0.327,213,475,0.448,227,252,0.901,18,106,124,158,59,14,92,108,1010
2015,Jameer Nelson,PG,32,TOT,63,29,1407,205,504,0.407,89,258,0.345,116,246,0.472,24,36,0.667,33,113,146,253,47,6,109,136,523
2015,Jameer Nelson,PG,32,DAL,23,23,584,61,163,0.374,38,103,0.369,23,60,0.383,7,8,0.875,14,49,63,95,15,2,39,53,167
2015,Jameer Nelson,PG,32,BOS,6,1,121,9,41,0.22,5,25,0.2,4,16,0.25,6,9,0.667,3,14,17,33,7,0,9,13,29
2015,Jameer Nelson,PG,32,DEN,34,5,702,135,300,0.45,46,130,0.354,89,170,0.524,11,19,0.579,16,50,66,125,25,4,61,70,327
2015,James Ennis III,SF,24,MIA,62,3,1051,101,247,0.409,31,95,0.326,70,152,0.461,79,94,0.84,51,125,176,48,25,17,39,89,312
2015,James Harden,SG,25,HOU,81,81,2981,647,1470,0.44,208,555,0.375,439,915,0.48,715,824,0.868,75,384,459,565,154,60,321,208,2217
2015,James Johnson,PF,27,TOR,70,17,1370,238,404,0.589,11,51,0.216,227,353,0.643,67,102,0.657,61,196,257,95,54,70,79,155,554
2015,James Jones,SF,34,CLE,57,2,669,74,201,0.368,63,175,0.36,11,26,0.423,39,46,0.848,9,53,62,24,13,8,13,67,250
2015,James Michael McAdoo,PF,22,GSW,15,0,137,24,44,0.545,0,0,,24,44,0.545,14,25,0.56,15,22,37,2,5,9,6,21,62
2015,James Young,SG,19,BOS,31,0,332,36,102,0.353,17,66,0.258,19,36,0.528,16,29,0.552,9,33,42,13,8,2,5,22,105
2015,JaMychal Green,PF,24,TOT,24,1,164,27,47,0.574,0,6,0,27,41,0.659,8,10,0.8,19,26,45,4,5,5,14,25,62
2015,JaMychal Green,PF,24,SAS,4,0,25,4,7,0.571,0,2,0,4,5,0.8,0,0,,3,3,6,0,0,2,2,6,8
2015,JaMychal Green,PF,24,MEM,20,1,139,23,40,0.575,0,4,0,23,36,0.639,8,10,0.8,16,23,39,4,5,3,12,19,54
2015,Jannero Pargo,PG,35,CHO,9,0,73,15,35,0.429,9,22,0.409,6,13,0.462,2,2,1,0,3,3,8,0,0,3,8,41
2015,Jared Cunningham,SG,23,LAC,19,0,89,12,33,0.364,4,13,0.308,8,20,0.4,7,13,0.538,1,8,9,10,3,0,7,12,35
2015,Jared Dudley,SG,29,MIL,72,22,1717,198,423,0.468,74,192,0.385,124,231,0.537,48,67,0.716,45,175,220,130,72,11,62,113,518
2015,Jared Sullinger,PF,22,BOS,58,49,1566,311,708,0.439,52,184,0.283,259,524,0.494,96,129,0.744,147,294,441,134,44,42,78,153,770
2015,Jarnell Stokes,PF,21,MEM,19,2,126,21,37,0.568,0,0,,21,37,0.568,15,28,0.536,16,18,34,4,5,5,7,25,57
2015,Jarrett Jack,PG,31,BRK,80,27,2241,359,817,0.439,39,146,0.267,320,671,0.477,200,227,0.881,19,226,245,373,75,13,191,143,957
2015,Jason Maxiell,PF,31,CHO,61,0,878,81,192,0.422,0,0,,81,192,0.422,41,71,0.577,86,117,203,19,18,44,29,96,203
2015,Jason Richardson,SG,34,PHI,19,15,416,62,178,0.348,31,96,0.323,31,82,0.378,17,22,0.773,13,53,66,38,13,3,16,28,172
2015,Jason Smith,C,28,NYK,82,31,1785,257,592,0.434,15,42,0.357,242,550,0.44,127,153,0.83,98,226,324,140,32,44,104,205,656
2015,Jason Terry,SG,37,HOU,77,18,1641,188,446,0.422,126,323,0.39,62,123,0.504,39,48,0.813,15,106,121,147,66,19,74,116,541
2015,Jason Thompson,PF,28,SAC,81,63,1991,201,428,0.47,0,1,0,201,427,0.471,89,143,0.622,139,391,530,85,33,57,84,239,491
2015,JaVale McGee,C,27,TOT,23,0,256,42,79,0.532,0,0,,42,79,0.532,22,33,0.667,18,43,61,3,2,20,18,30,106
2015,JaVale McGee,C,27,DEN,17,0,195,34,61,0.557,0,0,,34,61,0.557,20,29,0.69,14,34,48,1,2,19,13,28,88
2015,JaVale McGee,C,27,PHI,6,0,61,8,18,0.444,0,0,,8,18,0.444,2,4,0.5,4,9,13,2,0,1,5,2,18
2015,Jeff Adrien,PF,28,MIN,17,0,215,19,44,0.432,0,0,,19,44,0.432,22,38,0.579,23,54,77,15,4,9,9,30,60
2015,Jeff Ayres,PF,27,SAS,51,0,383,55,95,0.579,0,0,,55,95,0.579,27,36,0.75,37,80,117,14,8,8,26,60,137
2015,Jeff Green,SF,28,TOT,78,70,2454,416,967,0.43,97,292,0.332,319,675,0.473,239,287,0.833,64,264,328,134,53,34,108,147,1168
2015,Jeff Green,SF,28,BOS,33,33,1093,206,475,0.434,47,154,0.305,159,321,0.495,121,144,0.84,21,120,141,53,27,13,56,66,580
2015,Jeff Green,SF,28,MEM,45,37,1361,210,492,0.427,50,138,0.362,160,354,0.452,118,143,0.825,43,144,187,81,26,21,52,81,588
2015,Jeff Taylor,SF,25,CHO,29,13,430,45,114,0.395,11,36,0.306,34,78,0.436,26,41,0.634,14,39,53,22,12,1,19,36,127
2015,Jeff Teague,PG,26,ATL,73,72,2228,408,887,0.46,71,207,0.343,337,680,0.496,275,319,0.862,30,154,184,513,125,31,205,139,1162
2015,Jeff Withey,C,24,NOP,37,0,259,32,64,0.5,0,0,,32,64,0.5,34,50,0.68,23,41,64,11,4,18,12,26,98
2015,Jerami Grant,SF,20,PHI,65,11,1377,124,352,0.352,49,156,0.314,75,196,0.383,114,193,0.591,49,149,198,79,40,68,85,144,411
2015,Jerel McNeal,PG,27,PHO,6,0,36,3,11,0.273,1,2,0.5,2,9,0.222,2,2,1,0,3,3,2,3,1,5,5,9
2015,Jeremy Evans,SF,27,UTA,38,0,266,32,58,0.552,2,5,0.4,30,53,0.566,24,29,0.828,26,45,71,13,11,12,5,29,90
2015,Jeremy Lamb,SG,22,OKC,47,8,633,104,250,0.416,38,111,0.342,66,139,0.475,49,55,0.891,8,99,107,44,21,6,27,52,295
2015,Jeremy Lin,PG,26,LAL,74,30,1907,277,654,0.424,65,176,0.369,212,478,0.444,213,268,0.795,26,170,196,339,82,32,166,189,832
2015,Jerome Jordan,C,28,BRK,44,0,383,50,94,0.532,0,0,,50,94,0.532,38,44,0.864,52,53,105,13,8,15,22,58,138
2015,Jerrelle Benimon,PF,23,UTA,2,0,3,0,0,,0,0,,0,0,,0,0,,1,2,3,0,0,0,1,0,0
2015,Jerryd Bayless,PG,26,MIL,77,4,1717,220,516,0.426,37,120,0.308,183,396,0.462,121,137,0.883,22,189,211,233,59,12,133,163,598
2015,Jimmer Fredette,PG,25,NOP,50,0,509,63,166,0.38,9,48,0.188,54,118,0.458,43,45,0.956,8,32,40,58,15,2,33,43,178
2015,Jimmy Butler,SG,25,CHI,65,65,2513,421,912,0.462,73,193,0.378,348,719,0.484,386,463,0.834,114,265,379,212,114,36,93,108,1301
2015,Joakim Noah,C,29,CHI,67,67,2049,190,427,0.445,0,2,0,190,425,0.447,105,174,0.603,219,427,646,312,48,74,123,203,485
2015,Jodie Meeks,SG,27,DET,60,0,1462,222,534,0.416,74,212,0.349,148,322,0.46,145,160,0.906,12,92,104,79,59,6,57,76,663
2015,Joe Harris,SG,23,CLE,51,1,493,48,120,0.4,31,84,0.369,17,36,0.472,9,15,0.6,7,34,41,26,7,2,27,62,136
2015,Joe Ingles,SF,27,UTA,79,32,1673,147,354,0.415,72,202,0.356,75,152,0.493,30,40,0.75,22,153,175,182,72,10,98,124,396
2015,Joe Johnson,SG,33,BRK,80,80,2791,446,1025,0.435,121,337,0.359,325,688,0.472,141,176,0.801,53,331,384,292,59,14,137,120,1154
2015,Joel Anthony,C,32,DET,49,0,406,36,62,0.581,0,0,,36,62,0.581,15,22,0.682,32,61,93,5,12,49,12,55,87
2015,Joel Freeland,C,27,POR,48,8,617,74,151,0.49,0,0,,74,151,0.49,21,25,0.84,62,129,191,16,9,23,23,93,169
2015,Joey Dorsey,PF,31,HOU,69,17,854,80,145,0.552,0,1,0,80,144,0.556,24,83,0.289,103,176,279,25,40,25,41,157,184
2015,Joffrey Lauvergne,C,23,DEN,24,1,268,36,89,0.404,3,16,0.188,33,73,0.452,18,28,0.643,27,50,77,13,8,10,22,43,93
2015,John Henson,C,24,MIL,67,11,1228,196,346,0.566,0,0,,196,346,0.566,78,137,0.569,124,188,312,59,28,135,87,152,470
2015,John Jenkins,SG,23,ATL,24,3,297,49,99,0.495,21,52,0.404,28,47,0.596,16,19,0.842,2,37,39,13,10,0,8,15,135
2015,John Lucas III,PG,32,DET,21,0,272,42,104,0.404,9,29,0.31,33,75,0.44,5,5,1,4,12,16,60,8,0,16,18,98
2015,John Salmons,SF,35,NOP,21,0,270,16,48,0.333,8,26,0.308,8,22,0.364,2,4,0.5,4,17,21,13,9,4,5,25,42
2015,John Wall,PG,24,WAS,79,79,2837,519,1166,0.445,65,217,0.3,454,949,0.478,284,362,0.785,36,330,366,792,138,45,304,180,1387
2015,Johnny O'Bryant,PF,21,MIL,34,15,368,44,120,0.367,0,0,,44,120,0.367,12,27,0.444,26,38,64,17,5,4,25,44,100
2015,Jon Leuer,PF,25,MEM,63,6,824,121,273,0.443,7,29,0.241,114,244,0.467,37,59,0.627,50,157,207,46,17,9,35,86,286
2015,Jonas Jerebko,PF,27,TOT,75,0,1230,169,379,0.446,54,140,0.386,115,239,0.481,56,66,0.848,93,189,282,71,46,18,44,135,448
2015,Jonas Jerebko,PF,27,DET,46,0,703,91,198,0.46,28,76,0.368,63,122,0.516,31,36,0.861,47,95,142,41,27,11,26,77,241
2015,Jonas Jerebko,PF,27,BOS,29,0,527,78,181,0.431,26,64,0.406,52,117,0.444,25,30,0.833,46,94,140,30,19,7,18,58,207
2015,Jonas Valančiūnas,C,22,TOR,80,80,2096,373,652,0.572,0,1,0,373,651,0.573,217,276,0.786,215,478,693,39,33,95,109,222,963
2015,Jordan Adams,SG,20,MEM,30,0,248,35,86,0.407,10,25,0.4,25,61,0.41,14,23,0.609,9,19,28,16,16,7,14,24,94
2015,Jordan Clarkson,PG,22,LAL,59,38,1476,267,596,0.448,38,121,0.314,229,475,0.482,131,158,0.829,56,135,191,206,51,12,96,109,703
2015,Jordan Farmar,PG,28,LAC,36,0,529,61,158,0.386,35,97,0.361,26,61,0.426,10,11,0.909,8,34,42,67,20,5,32,52,167
2015,Jordan Hamilton,SF,24,LAC,14,2,122,14,35,0.4,10,21,0.476,4,14,0.286,0,0,,2,14,16,7,2,0,4,14,38
2015,Jordan Hill,C,27,LAL,70,57,1874,357,777,0.459,3,11,0.273,354,766,0.462,124,168,0.738,174,382,556,103,34,52,106,164,841
2015,Jorge Gutiérrez,PG,26,TOT,20,1,175,22,41,0.537,0,3,0,22,38,0.579,9,13,0.692,5,20,25,22,6,0,12,25,53
2015,Jorge Gutiérrez,PG,26,BRK,10,0,44,7,14,0.5,0,1,0,7,13,0.538,2,3,0.667,0,7,7,7,1,0,3,9,16
2015,Jorge Gutiérrez,PG,26,MIL,10,1,131,15,27,0.556,0,2,0,15,25,0.6,7,10,0.7,5,13,18,15,5,0,9,16,37
2015,José Calderón,PG,33,NYK,42,42,1270,147,354,0.415,59,142,0.415,88,212,0.415,29,32,0.906,19,105,124,198,31,0,75,76,382
2015,Josh McRoberts,PF,27,MIA,17,4,296,28,53,0.528,8,19,0.421,20,34,0.588,8,13,0.615,7,38,45,33,12,3,22,41,72
2015,Josh Smith,PF,29,TOT,83,35,2300,414,987,0.419,72,228,0.316,342,759,0.451,127,255,0.498,152,378,530,277,87,116,206,228,1027
2015,Josh Smith,PF,29,DET,28,28,896,153,391,0.391,9,37,0.243,144,354,0.407,52,111,0.468,52,150,202,132,37,48,72,82,367
2015,Josh Smith,PF,29,HOU,55,7,1404,261,596,0.438,63,191,0.33,198,405,0.489,75,144,0.521,100,228,328,145,50,68,134,146,660
2015,Jrue Holiday,PG,24,NOP,40,37,1303,238,534,0.446,51,135,0.378,187,399,0.469,65,76,0.855,32,103,135,274,63,23,91,110,592
2015,Julius Randle,PF,20,LAL,1,0,14,1,3,0.333,0,0,,1,3,0.333,0,2,0,0,0,0,0,0,0,1,1,2
2015,Justin Hamilton,C,24,TOT,41,14,712,85,178,0.478,10,31,0.323,75,147,0.51,39,47,0.83,57,77,134,36,27,30,26,70,219
2015,Justin Hamilton,C,24,MIA,24,5,289,27,65,0.415,6,19,0.316,21,46,0.457,6,7,0.857,24,24,48,12,8,5,8,33,66
2015,Justin Hamilton,C,24,MIN,17,9,423,58,113,0.513,4,12,0.333,54,101,0.535,33,40,0.825,33,53,86,24,19,25,18,37,153
2015,Justin Holiday,SG,25,GSW,59,4,657,91,235,0.387,35,109,0.321,56,126,0.444,37,45,0.822,12,61,73,48,40,12,29,54,254
2015,Jusuf Nurkić,C,20,DEN,62,27,1103,171,383,0.446,0,2,0,171,381,0.449,84,132,0.636,125,257,382,50,52,68,86,207,426
2015,K.J. McDaniels,SG,21,TOT,62,15,1352,172,434,0.396,43,150,0.287,129,284,0.454,100,133,0.752,65,135,200,72,44,70,105,126,487
2015,K.J. McDaniels,SG,21,PHI,52,15,1319,167,419,0.399,43,147,0.293,124,272,0.456,99,131,0.756,64,131,195,70,44,68,104,121,476
2015,K.J. McDaniels,SG,21,HOU,10,0,33,5,15,0.333,0,3,0,5,12,0.417,1,2,0.5,1,4,5,2,0,2,1,5,11
2015,Kalin Lucas,PG,25,MEM,1,0,6,0,1,0,0,0,,0,1,0,0,0,,0,0,0,0,1,0,0,1,0
2015,Kawhi Leonard,SF,23,SAS,64,64,2033,394,822,0.479,67,192,0.349,327,630,0.519,202,252,0.802,85,376,461,161,148,48,97,128,1057
2015,Kelly Olynyk,C,23,BOS,64,13,1423,251,528,0.475,61,175,0.349,190,353,0.538,93,136,0.684,92,211,303,109,64,39,98,213,656
2015,Kemba Walker,PG,24,CHO,62,58,2119,378,981,0.385,85,280,0.304,293,701,0.418,234,283,0.827,35,185,220,318,89,31,100,92,1075
2015,Kendall Marshall,PG,23,MIL,28,3,417,46,101,0.455,18,46,0.391,28,55,0.509,8,9,0.889,2,26,28,86,21,0,35,26,118
2015,Kendrick Perkins,C,30,TOT,68,3,1148,102,227,0.449,0,1,0,102,226,0.451,42,83,0.506,91,229,320,51,16,42,95,162,246
2015,Kendrick Perkins,C,30,OKC,51,3,981,82,186,0.441,0,1,0,82,185,0.443,38,75,0.507,80,199,279,43,14,38,74,135,202
2015,Kendrick Perkins,C,30,CLE,17,0,167,20,41,0.488,0,0,,20,41,0.488,4,8,0.5,11,30,41,8,2,4,21,27,44
2015,Kenneth Faried,PF,25,DEN,75,71,2086,373,736,0.507,1,8,0.125,372,728,0.511,199,288,0.691,242,426,668,89,62,57,118,211,946
2015,Kent Bazemore,SG,25,ATL,75,10,1324,141,331,0.426,48,132,0.364,93,199,0.467,60,100,0.6,21,201,222,78,52,33,73,127,390
2015,Kentavious Caldwell-Pope,SG,21,DET,82,82,2587,390,972,0.401,153,444,0.345,237,528,0.449,110,158,0.696,46,209,255,109,93,18,94,161,1043
2015,Kenyon Martin,PF,37,MIL,11,0,104,9,22,0.409,0,0,,9,22,0.409,2,2,1,6,13,19,5,5,6,3,13,20
2015,Kevin Durant,SF,26,OKC,27,27,913,238,467,0.51,64,159,0.403,174,308,0.565,146,171,0.854,16,162,178,110,24,25,74,40,686
2015,Kevin Garnett*,PF,38,TOT,47,47,952,143,306,0.467,1,7,0.143,142,299,0.475,36,45,0.8,48,263,311,77,46,17,46,109,323
2015,Kevin Garnett*,PF,38,BRK,42,42,854,125,275,0.455,1,6,0.167,124,269,0.461,34,41,0.829,46,239,285,69,41,13,45,96,285
2015,Kevin Garnett*,PF,38,MIN,5,5,98,18,31,0.581,0,1,0,18,30,0.6,2,4,0.5,2,24,26,8,5,4,1,13,38
2015,Kevin Love,PF,26,CLE,75,75,2532,413,952,0.434,144,392,0.367,269,560,0.48,258,321,0.804,142,589,731,168,51,39,122,140,1228
2015,Kevin Martin,SG,31,MIN,39,36,1302,267,625,0.427,75,191,0.393,192,434,0.442,170,193,0.881,19,123,142,89,33,1,76,76,779
2015,Kevin Séraphin,C,25,WAS,79,0,1235,231,450,0.513,0,2,0,231,448,0.516,58,82,0.707,87,201,288,59,10,59,98,197,520
2015,Khris Middleton,SF,23,MIL,79,58,2378,406,869,0.467,109,268,0.407,297,601,0.494,134,156,0.859,48,299,347,182,122,11,113,183,1055
2015,Kirk Hinrich,SG,34,CHI,66,22,1610,142,381,0.373,58,168,0.345,84,213,0.394,35,50,0.7,20,101,121,148,46,14,73,144,377
2015,Klay Thompson,SG,24,GSW,77,77,2455,602,1299,0.463,239,545,0.439,363,754,0.481,225,256,0.879,27,220,247,222,87,60,149,122,1668
2015,Kobe Bryant*,SG,36,LAL,35,35,1207,266,713,0.373,54,184,0.293,212,529,0.401,196,241,0.813,26,173,199,197,47,7,128,65,782
2015,Kosta Koufos,C,25,MEM,81,3,1348,182,358,0.508,0,0,,182,358,0.508,55,85,0.647,121,305,426,37,29,63,69,148,419
2015,Kostas Papanikolaou,SF,24,HOU,43,1,795,69,197,0.35,31,106,0.292,38,91,0.418,13,18,0.722,39,79,118,85,29,13,55,71,182
2015,Kris Humphries,PF,29,WAS,64,17,1345,211,446,0.473,0,7,0,211,439,0.481,87,117,0.744,118,298,416,57,34,25,46,130,509
2015,Kyle Anderson,SF,21,SAS,33,8,358,31,89,0.348,3,11,0.273,28,78,0.359,9,14,0.643,5,67,72,28,15,7,10,28,74
2015,Kyle Korver,SG,33,ATL,75,75,2418,292,600,0.487,221,449,0.492,71,151,0.47,106,118,0.898,15,289,304,196,52,42,107,140,911
2015,Kyle Lowry,PG,28,TOR,70,70,2414,430,1043,0.412,132,391,0.338,298,652,0.457,252,312,0.808,54,274,328,473,109,13,173,212,1244
2015,Kyle O'Quinn,PF,24,ORL,51,17,824,119,242,0.492,12,43,0.279,107,199,0.538,44,57,0.772,46,153,199,59,31,39,55,110,294
2015,Kyle Singler,SF,26,TOT,80,58,1743,172,446,0.386,96,241,0.398,76,205,0.371,40,52,0.769,33,161,194,85,47,21,55,153,480
2015,Kyle Singler,SF,26,DET,54,40,1287,140,350,0.4,76,187,0.406,64,163,0.393,29,36,0.806,23,116,139,67,33,14,42,98,385
2015,Kyle Singler,SF,26,OKC,26,18,456,32,96,0.333,20,54,0.37,12,42,0.286,11,16,0.688,10,45,55,18,14,7,13,55,95
2015,Kyrie Irving,PG,22,CLE,75,75,2730,578,1235,0.468,157,378,0.415,421,857,0.491,315,365,0.863,55,182,237,389,114,20,186,146,1628
2015,LaMarcus Aldridge,PF,29,POR,71,71,2512,659,1415,0.466,37,105,0.352,622,1310,0.475,306,362,0.845,177,549,726,124,48,68,122,125,1661
2015,Lance Stephenson,SG,24,CHO,61,25,1573,207,550,0.376,18,105,0.171,189,445,0.425,69,110,0.627,39,238,277,240,38,8,128,134,501
2015,Lance Thomas,PF-SF,26,TOT,62,37,1490,182,442,0.412,7,22,0.318,175,420,0.417,72,99,0.727,65,130,195,69,37,8,74,101,443
2015,Lance Thomas,SF,26,OKC,22,13,450,45,126,0.357,0,1,0,45,125,0.36,23,33,0.697,28,47,75,20,11,0,17,38,113
2015,Lance Thomas,PF,26,NYK,40,24,1040,137,316,0.434,7,21,0.333,130,295,0.441,49,66,0.742,37,83,120,49,26,8,57,63,330
2015,Landry Fields,SF,26,TOR,26,9,216,20,41,0.488,1,2,0.5,19,39,0.487,5,6,0.833,10,16,26,15,11,0,8,9,46
2015,Langston Galloway,PG,23,NYK,45,41,1457,204,511,0.399,62,176,0.352,142,335,0.424,63,78,0.808,37,153,190,150,52,12,61,129,533
2015,Larry Drew II,PG,24,PHI,12,1,219,20,58,0.345,4,26,0.154,16,32,0.5,2,3,0.667,1,14,15,45,6,0,25,13,46
2015,Larry Sanders,C,26,MIL,27,26,586,86,172,0.5,0,0,,86,172,0.5,24,48,0.5,67,99,166,23,26,39,28,104,196
2015,Lavoy Allen,C,25,IND,63,0,1070,141,299,0.472,0,0,,141,299,0.472,33,47,0.702,123,200,323,73,15,42,40,102,315
2015,Leandro Barbosa,SG,32,GSW,66,1,982,183,386,0.474,43,112,0.384,140,274,0.511,58,74,0.784,23,68,91,99,41,8,44,87,467
2015,LeBron James,SF,30,CLE,69,69,2493,624,1279,0.488,120,339,0.354,504,940,0.536,375,528,0.71,51,365,416,511,109,49,272,135,1743
2015,Lester Hudson,SG,30,LAC,5,0,56,6,14,0.429,3,6,0.5,3,8,0.375,3,4,0.75,1,7,8,5,6,1,3,4,18
2015,Lorenzo Brown,PG,24,MIN,29,7,549,52,122,0.426,6,28,0.214,46,94,0.489,12,19,0.632,14,56,70,90,28,6,30,49,122
2015,Lou Amundson,PF,32,TOT,53,35,937,109,255,0.427,0,1,0,109,254,0.429,41,87,0.471,94,174,268,70,22,52,62,126,259
2015,Lou Amundson,PF,32,CLE,12,0,79,4,12,0.333,0,0,,4,12,0.333,3,5,0.6,5,15,20,5,1,0,5,11,11
2015,Lou Amundson,PF,32,NYK,41,35,858,105,243,0.432,0,1,0,105,242,0.434,38,82,0.463,89,159,248,65,21,52,57,115,248
2015,Lou Williams,SG,28,TOR,80,0,2016,375,928,0.404,152,447,0.34,223,481,0.464,340,395,0.861,24,127,151,164,88,10,101,103,1242
2015,Luc Mbah a Moute,PF,28,PHI,67,61,1916,251,636,0.395,62,202,0.307,189,434,0.435,96,163,0.589,82,246,328,106,81,21,99,104,660
2015,Lucas Nogueira,C,22,TOR,6,0,23,2,8,0.25,0,0,,2,8,0.25,2,4,0.5,2,9,11,1,2,0,2,6,6
2015,Luis Scola,PF,34,IND,81,16,1659,300,642,0.467,5,20,0.25,295,622,0.474,158,226,0.699,138,388,526,105,47,18,94,192,763
2015,Luke Babbitt,SF,25,NOP,63,19,830,92,192,0.479,59,115,0.513,33,77,0.429,13,19,0.684,12,99,111,24,17,11,26,63,256
2015,Luke Ridnour,PG,33,ORL,47,0,683,75,176,0.426,20,63,0.317,55,113,0.487,18,21,0.857,8,60,68,96,20,4,38,67,188
2015,Luol Deng,SF,29,MIA,72,72,2421,369,787,0.469,78,220,0.355,291,567,0.513,191,251,0.761,103,273,376,139,65,22,108,109,1007
2015,Malcolm Lee,SG,24,PHI,1,0,2,0,1,0,0,0,,0,1,0,0,0,,0,0,0,0,0,0,0,0,0
2015,Malcolm Thomas,PF,26,PHI,17,0,194,18,40,0.45,0,7,0,18,33,0.545,9,13,0.692,16,40,56,7,3,1,13,17,45
2015,Manu Ginóbili*,SG,37,SAS,70,0,1587,251,589,0.426,89,258,0.345,162,331,0.489,147,204,0.721,28,183,211,293,67,20,154,138,738
2015,Marc Gasol,C,30,MEM,81,81,2687,530,1072,0.494,3,17,0.176,527,1055,0.5,350,440,0.795,115,515,630,307,70,131,176,208,1413
2015,Marcin Gortat,C,30,WAS,82,82,2453,439,775,0.566,0,3,0,439,772,0.569,123,175,0.703,180,537,717,97,49,110,100,191,1001
2015,Marco Belinelli,SG,28,SAS,62,9,1388,199,470,0.423,86,230,0.374,113,240,0.471,84,99,0.848,26,131,157,94,31,3,61,85,568
2015,Marcus Morris,PF,25,PHO,81,35,2045,331,763,0.434,112,313,0.358,219,450,0.487,71,113,0.628,73,312,385,133,63,16,73,188,845
2015,Marcus Smart,PG,20,BOS,67,38,1808,175,477,0.367,91,272,0.335,84,205,0.41,82,127,0.646,61,161,222,208,99,18,90,176,523
2015,Marcus Thornton,SG,27,TOT,48,0,721,140,345,0.406,54,143,0.378,86,202,0.426,46,56,0.821,23,63,86,36,27,7,27,38,380
2015,Marcus Thornton,SG,27,BOS,39,0,640,127,305,0.416,52,124,0.419,75,181,0.414,42,51,0.824,19,54,73,34,21,7,22,35,348
2015,Marcus Thornton,SG,27,PHO,9,0,81,13,40,0.325,2,19,0.105,11,21,0.524,4,5,0.8,4,9,13,2,6,0,5,3,32
2015,Mario Chalmers,PG,28,MIA,80,37,2368,267,663,0.403,73,248,0.294,194,415,0.467,206,266,0.774,24,182,206,307,122,10,173,251,813
2015,Markel Brown,SG,23,BRK,47,29,781,76,210,0.362,17,64,0.266,59,146,0.404,47,57,0.825,16,91,107,39,31,12,27,57,216
2015,Markieff Morris,PF,25,PHO,82,82,2581,512,1100,0.465,57,179,0.318,455,921,0.494,177,232,0.763,110,396,506,192,101,39,170,245,1258
2015,Marreese Speights,C,27,GSW,76,9,1207,318,646,0.492,5,18,0.278,313,628,0.498,150,178,0.843,109,216,325,72,20,34,82,189,791
2015,Martell Webster,SF,28,WAS,32,0,352,24,91,0.264,10,43,0.233,14,48,0.292,48,64,0.75,10,36,46,17,7,1,22,24,106
2015,Marvin Williams,PF,28,CHO,78,37,2035,210,495,0.424,95,265,0.358,115,230,0.5,62,87,0.713,58,328,386,100,69,36,60,146,577
2015,Mason Plumlee,C,24,BRK,82,45,1743,280,489,0.573,0,3,0,280,486,0.576,157,317,0.495,175,337,512,74,65,63,106,207,717
2015,Matt Barnes,SF,34,LAC,76,74,2271,277,624,0.444,136,376,0.362,141,248,0.569,74,95,0.779,51,251,302,114,67,50,87,240,764
2015,Matt Bonner,PF,34,SAS,72,19,935,94,230,0.409,46,126,0.365,48,104,0.462,30,37,0.811,29,86,115,47,10,12,11,65,264
2015,Matthew Dellavedova,SG,24,CLE,67,13,1380,111,307,0.362,68,167,0.407,43,140,0.307,29,38,0.763,37,89,126,204,24,2,61,152,319
2015,Maurice Harkless,SF,21,ORL,45,4,674,63,158,0.399,10,56,0.179,53,102,0.52,22,41,0.537,38,68,106,25,32,9,27,66,158
2015,Meyers Leonard,C,22,POR,55,7,847,125,245,0.51,47,112,0.42,78,133,0.586,30,32,0.938,46,204,250,32,10,14,39,113,327
2015,Michael Beasley,PF,26,MIA,24,1,505,92,212,0.434,8,34,0.235,84,178,0.472,20,26,0.769,12,77,89,32,15,13,37,66,212
2015,Michael Carter-Williams,PG,23,TOT,66,63,2149,364,919,0.396,36,153,0.235,328,766,0.428,202,291,0.694,64,289,353,442,111,30,253,167,966
2015,Michael Carter-Williams,PG,23,PHI,41,38,1391,232,611,0.38,32,125,0.256,200,486,0.412,117,182,0.643,43,211,254,302,60,18,174,103,613
2015,Michael Carter-Williams,PG,23,MIL,25,25,758,132,308,0.429,4,28,0.143,128,280,0.457,85,109,0.78,21,78,99,140,51,12,79,64,353
2015,Michael Kidd-Gilchrist,SF,21,CHO,55,52,1587,224,482,0.465,0,0,,224,482,0.465,150,214,0.701,109,307,416,77,30,38,63,115,598
2015,Mike Conley,PG,27,MEM,70,70,2225,393,882,0.446,107,277,0.386,286,605,0.473,214,249,0.859,29,180,209,375,89,14,156,139,1107
2015,Mike Dunleavy,SF,34,CHI,63,63,1838,209,481,0.435,107,263,0.407,102,218,0.468,70,87,0.805,28,220,248,114,39,21,60,123,595
2015,Mike Miller,SF,34,CLE,52,15,701,37,114,0.325,32,98,0.327,5,16,0.313,3,4,0.75,4,87,91,46,14,4,23,74,109
2015,Mike Muscala,PF,23,ATL,40,8,502,83,151,0.55,9,22,0.409,74,129,0.574,22,25,0.88,52,67,119,25,16,19,21,52,197
2015,Mike Scott,PF,26,ATL,68,0,1123,201,453,0.444,66,192,0.344,135,261,0.517,61,77,0.792,45,154,199,75,25,3,39,83,529
2015,Miles Plumlee,C,26,TOT,73,28,1194,136,254,0.535,0,0,,136,254,0.535,22,46,0.478,112,208,320,34,41,66,51,111,294
2015,Miles Plumlee,C,26,PHO,54,28,1005,107,195,0.549,0,0,,107,195,0.549,19,38,0.5,95,179,274,27,35,55,45,99,233
2015,Miles Plumlee,C,26,MIL,19,0,189,29,59,0.492,0,0,,29,59,0.492,3,8,0.375,17,29,46,7,6,11,6,12,61
2015,Miroslav Raduljica,C,27,MIN,5,0,23,3,8,0.375,0,0,,3,8,0.375,2,2,1,2,3,5,0,1,0,2,8,8
2015,Mirza Teletović,PF,29,BRK,40,4,892,122,319,0.382,62,193,0.321,60,126,0.476,33,46,0.717,27,167,194,46,14,16,53,74,339
2015,Mitch McGary,PF,22,OKC,32,2,485,88,165,0.533,0,2,0,88,163,0.54,25,40,0.625,53,112,165,14,16,16,31,72,201
2015,Mo Williams,PG,32,TOT,68,33,1980,341,860,0.397,119,348,0.342,222,512,0.434,163,187,0.872,22,152,174,424,46,14,172,162,964
2015,Mo Williams,PG,32,MIN,41,19,1149,180,447,0.403,59,170,0.347,121,277,0.437,80,94,0.851,13,85,98,261,30,8,102,103,499
2015,Mo Williams,PG,32,CHO,27,14,831,161,413,0.39,60,178,0.337,101,235,0.43,83,93,0.892,9,67,76,163,16,6,70,59,465
2015,Monta Ellis,SG,29,DAL,80,80,2699,602,1354,0.445,81,284,0.285,521,1070,0.487,228,303,0.752,34,156,190,329,148,25,198,197,1513
2015,Nate Robinson,PG,30,TOT,42,1,591,88,255,0.345,31,112,0.277,57,143,0.399,31,46,0.674,17,33,50,97,20,3,30,76,238
2015,Nate Robinson,PG,30,DEN,33,1,465,71,204,0.348,24,92,0.261,47,112,0.42,26,40,0.65,14,25,39,77,14,3,22,68,192
2015,Nate Robinson,PG,30,LAC,9,0,126,17,51,0.333,7,20,0.35,10,31,0.323,5,6,0.833,3,8,11,20,6,0,8,8,46
2015,Nate Wolters,PG,23,TOT,21,0,247,20,57,0.351,0,7,0,20,50,0.4,2,6,0.333,8,26,34,21,8,2,13,18,42
2015,Nate Wolters,PG,23,MIL,11,0,142,12,31,0.387,0,5,0,12,26,0.462,1,4,0.25,2,14,16,10,5,0,3,11,25
2015,Nate Wolters,PG,23,NOP,10,0,105,8,26,0.308,0,2,0,8,24,0.333,1,2,0.5,6,12,18,11,3,2,10,7,17
2015,Nazr Mohammed,C,37,CHI,23,0,128,13,30,0.433,0,0,,13,30,0.433,1,3,0.333,11,27,38,3,4,5,7,16,27
2015,Nenê,PF,32,WAS,67,58,1693,307,601,0.511,1,5,0.2,306,596,0.513,122,202,0.604,84,261,345,123,66,22,124,180,737
2015,Nerlens Noel,C,20,PHI,75,71,2311,302,653,0.462,0,0,,302,653,0.462,140,230,0.609,185,426,611,128,133,142,146,208,744
2015,Nick Calathes,SG,25,MEM,58,0,838,104,247,0.421,11,43,0.256,93,204,0.456,24,45,0.533,19,87,106,146,63,5,61,100,243
2015,Nick Collison,PF,34,OKC,66,2,1101,106,253,0.419,16,60,0.267,90,193,0.466,45,65,0.692,90,160,250,90,35,25,45,156,273
2015,Nick Johnson,SG,22,HOU,28,0,262,26,75,0.347,5,21,0.238,21,54,0.389,17,25,0.68,13,26,39,11,7,3,19,34,74
2015,Nick Young,SG,29,LAL,42,0,1000,174,476,0.366,83,225,0.369,91,251,0.363,132,148,0.892,17,79,96,41,23,11,44,83,563
2015,Nicolas Batum,SF,26,POR,71,71,2380,240,600,0.4,100,309,0.324,140,291,0.481,84,98,0.857,62,354,416,341,78,40,132,106,664
2015,Nik Stauskas,SG,21,SAC,73,1,1127,108,296,0.365,48,149,0.322,60,147,0.408,55,64,0.859,11,77,88,67,20,17,40,92,319
2015,Nikola Mirotić,PF,23,CHI,82,3,1654,253,624,0.405,99,313,0.316,154,311,0.495,228,284,0.803,63,341,404,97,54,54,89,172,833
2015,Nikola Peković,C,29,MIN,31,29,815,139,328,0.424,0,0,,139,328,0.424,108,129,0.837,89,145,234,27,19,12,42,59,386
2015,Nikola Vučević,C,24,ORL,74,74,2529,631,1206,0.523,2,6,0.333,629,1200,0.524,164,218,0.752,238,572,810,147,54,54,148,220,1428
2015,Noah Vonleh,PF,19,CHO,25,0,259,30,76,0.395,5,13,0.385,25,63,0.397,18,26,0.692,28,58,86,4,4,9,11,20,83
2015,Norris Cole,PG,26,TOT,75,25,1831,230,558,0.412,55,176,0.313,175,382,0.458,58,81,0.716,13,146,159,255,57,15,99,124,573
2015,Norris Cole,PG,26,MIA,47,23,1148,118,306,0.386,27,102,0.265,91,204,0.446,32,46,0.696,12,96,108,165,42,8,58,75,295
2015,Norris Cole,PG,26,NOP,28,2,683,112,252,0.444,28,74,0.378,84,178,0.472,26,35,0.743,1,50,51,90,15,7,41,49,278
2015,O.J. Mayo,SG,27,MIL,71,15,1697,296,701,0.422,99,277,0.357,197,424,0.465,115,139,0.827,30,157,187,197,57,18,128,165,806
2015,Ognjen Kuzmić,C,24,GSW,16,0,72,8,12,0.667,0,0,,8,12,0.667,4,4,1,7,10,17,6,2,1,5,13,20
2015,Ömer Aşık,C,28,NOP,76,76,1982,213,412,0.517,0,0,,213,412,0.517,131,225,0.582,244,504,748,72,29,54,95,144,557
2015,Omri Casspi,SF,26,SAC,67,19,1416,209,427,0.489,35,87,0.402,174,340,0.512,140,191,0.733,54,206,260,102,31,9,88,107,593
2015,Otto Porter Jr.,SF,21,WAS,74,13,1432,176,391,0.45,35,104,0.337,141,287,0.491,58,79,0.734,70,151,221,65,44,30,52,97,445
2015,P.J. Hairston,SG,22,CHO,45,2,687,87,269,0.323,49,163,0.301,38,106,0.358,31,36,0.861,22,70,92,21,21,13,22,61,254
2015,P.J. Tucker,SF,29,PHO,78,63,2383,261,596,0.438,87,252,0.345,174,344,0.506,104,143,0.727,114,388,502,122,107,23,96,179,713
2015,Pablo Prigioni,PG,37,TOT,67,3,1197,91,228,0.399,57,166,0.343,34,62,0.548,35,41,0.854,30,89,119,171,79,1,62,88,274
2015,Pablo Prigioni,PG,37,NYK,43,3,795,68,161,0.422,43,115,0.374,25,46,0.543,22,26,0.846,18,62,80,104,52,1,47,53,201
2015,Pablo Prigioni,PG,37,HOU,24,0,402,23,67,0.343,14,51,0.275,9,16,0.563,13,15,0.867,12,27,39,67,27,0,15,35,73
2015,Patrick Beverley,PG,26,HOU,56,55,1727,204,532,0.383,115,323,0.356,89,209,0.426,45,60,0.75,67,170,237,192,59,23,83,182,568
2015,Patrick Christopher,SG,26,UTA,4,1,29,3,12,0.25,0,4,0,3,8,0.375,0,0,,2,4,6,0,1,0,1,6,6
2015,Patrick Patterson,PF,25,TOR,81,4,2156,240,535,0.449,105,283,0.371,135,252,0.536,63,80,0.788,127,306,433,155,60,44,54,149,648
2015,Patty Mills,PG,26,SAS,51,0,801,128,336,0.381,62,182,0.341,66,154,0.429,33,40,0.825,21,54,75,87,28,2,35,58,351
2015,Pau Gasol,PF,34,CHI,78,78,2681,570,1153,0.494,12,26,0.462,558,1127,0.495,294,366,0.803,220,699,919,210,25,147,158,147,1446
2015,Paul George,SF,24,IND,6,0,91,18,49,0.367,9,22,0.409,9,27,0.333,8,11,0.727,4,18,22,6,5,1,12,11,53
2015,Paul Millsap,PF,29,ATL,73,73,2390,443,930,0.476,77,216,0.356,366,714,0.513,255,337,0.757,139,431,570,223,130,69,166,201,1218
2015,Paul Pierce*,SF,37,WAS,73,73,1914,293,656,0.447,118,303,0.389,175,353,0.496,164,210,0.781,45,249,294,144,46,24,92,160,868
2015,Pero Antić,C,32,ATL,63,3,1037,108,296,0.365,52,173,0.301,56,123,0.455,88,123,0.715,58,131,189,49,18,14,49,132,356
2015,Perry Jones,SF,23,OKC,43,13,631,73,184,0.397,14,60,0.233,59,124,0.476,24,37,0.649,6,70,76,18,17,8,24,50,184
2015,Phil Pressey,PG,23,BOS,50,0,600,64,174,0.368,16,65,0.246,48,109,0.44,33,49,0.673,13,67,80,117,30,6,41,54,177
2015,Quincy Acy,PF,24,NYK,68,22,1287,152,331,0.459,18,60,0.3,134,271,0.494,76,97,0.784,79,222,301,68,27,22,60,147,398
2015,Quincy Miller,PF,22,TOT,10,0,119,9,38,0.237,3,18,0.167,6,20,0.3,8,11,0.727,4,16,20,8,7,5,5,9,29
2015,Quincy Miller,PF,22,SAC,6,0,61,4,18,0.222,1,7,0.143,3,11,0.273,8,11,0.727,2,10,12,3,6,3,3,4,17
2015,Quincy Miller,PF,22,DET,4,0,58,5,20,0.25,2,11,0.182,3,9,0.333,0,0,,2,6,8,5,1,2,2,5,12
2015,Quincy Pondexter,SF-SG,26,TOT,75,30,1793,188,447,0.421,91,244,0.373,97,203,0.478,71,96,0.74,53,142,195,94,19,24,51,150,538
2015,Quincy Pondexter,SG,26,MEM,30,2,540,48,135,0.356,17,73,0.233,31,62,0.5,21,30,0.7,20,37,57,28,5,5,10,47,134
2015,Quincy Pondexter,SF,26,NOP,45,28,1253,140,312,0.449,74,171,0.433,66,141,0.468,50,66,0.758,33,105,138,66,14,19,41,103,404
2015,Rajon Rondo,PG,28,TOT,68,68,2018,275,645,0.426,27,86,0.314,248,559,0.444,31,78,0.397,73,300,373,538,91,7,210,153,608
2015,Rajon Rondo,PG,28,BOS,22,22,699,81,200,0.405,8,32,0.25,73,168,0.435,12,36,0.333,25,140,165,237,37,3,75,42,182
2015,Rajon Rondo,PG,28,DAL,46,46,1319,194,445,0.436,19,54,0.352,175,391,0.448,19,42,0.452,48,160,208,301,54,4,135,111,426
2015,Ramon Sessions,PG,28,TOT,64,10,1188,125,334,0.374,19,60,0.317,106,274,0.387,133,173,0.769,23,121,144,182,29,0,86,73,402
2015,Ramon Sessions,PG,28,SAC,36,7,642,63,183,0.344,6,28,0.214,57,155,0.368,64,88,0.727,13,56,69,96,13,0,51,45,196
2015,Ramon Sessions,PG,28,WAS,28,3,546,62,151,0.411,13,32,0.406,49,119,0.412,69,85,0.812,10,65,75,86,16,0,35,28,206
2015,Randy Foye,SG,31,DEN,50,21,1087,148,402,0.368,94,263,0.357,54,139,0.388,45,55,0.818,9,76,85,119,34,11,60,97,435
2015,Rasual Butler,SF,35,WAS,75,1,1505,218,517,0.422,91,235,0.387,127,282,0.45,53,67,0.791,27,170,197,63,29,22,48,98,580
2015,Ray McCallum,PG,23,SAC,68,30,1436,206,470,0.438,34,111,0.306,172,359,0.479,57,84,0.679,52,128,180,188,45,11,85,92,503
2015,Raymond Felton,PG,30,DAL,29,3,281,43,106,0.406,10,34,0.294,33,72,0.458,12,15,0.8,2,24,26,41,11,4,18,17,108
2015,Reggie Bullock,SF,23,TOT,36,2,338,24,70,0.343,15,46,0.326,9,24,0.375,6,9,0.667,1,49,50,8,10,4,8,19,69
2015,Reggie Bullock,SF,23,LAC,25,2,263,23,54,0.426,15,39,0.385,8,15,0.533,4,5,0.8,0,40,40,6,9,2,6,17,65
2015,Reggie Bullock,SF,23,PHO,11,0,75,1,16,0.063,0,7,0,1,9,0.111,2,4,0.5,1,9,10,2,1,2,2,2,4
2015,Reggie Evans,PF,34,SAC,47,7,764,58,137,0.423,0,2,0,58,135,0.43,60,97,0.619,97,202,299,32,22,5,45,91,176
2015,Reggie Jackson,PG,24,TOT,77,40,2268,432,996,0.434,72,241,0.299,360,755,0.477,181,218,0.83,56,271,327,462,62,9,186,167,1117
2015,Reggie Jackson,PG,24,OKC,50,13,1398,249,576,0.432,44,158,0.278,205,418,0.49,99,115,0.861,28,173,201,214,42,5,91,94,641
2015,Reggie Jackson,PG,24,DET,27,27,870,183,420,0.436,28,83,0.337,155,337,0.46,82,103,0.796,28,98,126,248,20,4,95,73,476
2015,Reggie Williams,SF,28,SAS,20,0,105,15,39,0.385,3,19,0.158,12,20,0.6,4,4,1,5,12,17,10,1,0,2,12,37
2015,Richard Jefferson,SF,34,DAL,74,18,1244,144,324,0.444,66,155,0.426,78,169,0.462,78,114,0.684,25,158,183,61,32,11,52,115,432
2015,Ricky Ledo,SG,22,TOT,17,0,244,32,96,0.333,10,27,0.37,22,69,0.319,16,22,0.727,16,20,36,19,6,1,26,21,90
2015,Ricky Ledo,SG,22,DAL,5,0,11,0,6,0,0,3,0,0,3,0,1,2,0.5,1,1,2,1,0,0,2,1,1
2015,Ricky Ledo,SG,22,NYK,12,0,233,32,90,0.356,10,24,0.417,22,66,0.333,15,20,0.75,15,19,34,18,6,1,24,20,89
2015,Ricky Rubio,PG,24,MIN,22,22,692,78,219,0.356,13,51,0.255,65,168,0.387,57,71,0.803,19,106,125,193,38,1,64,59,226
2015,Robbie Hummel,SF,25,MIN,45,4,742,79,172,0.459,16,51,0.314,63,121,0.521,24,29,0.828,31,103,134,27,16,9,18,86,198
2015,Robert Covington,SF,24,PHI,70,49,1956,299,756,0.396,167,446,0.374,132,310,0.426,178,217,0.82,65,251,316,105,97,31,128,189,943
2015,Robert Sacre,C,25,LAL,67,18,1133,126,306,0.412,0,1,0,126,305,0.413,55,82,0.671,89,144,233,55,28,43,36,121,307
2015,Robin Lopez,C,26,POR,59,59,1638,234,437,0.535,0,1,0,234,436,0.537,98,127,0.772,190,204,394,55,16,84,73,122,566
2015,Rodney Hood,SG,22,UTA,50,21,1064,155,374,0.414,62,170,0.365,93,204,0.456,61,80,0.763,9,108,117,83,30,12,45,119,433
2015,Rodney Stuckey,PG,28,IND,71,36,1874,332,754,0.44,55,141,0.39,277,613,0.452,177,216,0.819,36,212,248,219,56,10,118,131,896
2015,Ronnie Price,PG,31,LAL,43,20,982,77,223,0.345,31,109,0.284,46,114,0.404,36,45,0.8,19,50,69,165,67,4,52,118,221
2015,Ronny Turiaf,C,32,MIN,2,0,19,0,0,,0,0,,0,0,,0,0,,0,1,1,2,0,0,0,0,0
2015,Roy Hibbert,C,28,IND,76,76,1926,317,710,0.446,0,2,0,317,708,0.448,168,204,0.824,156,384,540,84,18,125,107,216,802
2015,Rudy Gay,SF,28,SAC,68,67,2408,508,1116,0.455,79,220,0.359,429,896,0.479,337,393,0.858,98,301,399,250,71,41,183,157,1432
2015,Rudy Gobert,C,22,UTA,82,37,2158,258,427,0.604,0,2,0,258,425,0.607,170,273,0.623,265,510,775,109,64,189,111,175,686
2015,Russ Smith,PG,23,TOT,12,0,65,8,25,0.32,2,11,0.182,6,14,0.429,12,13,0.923,1,5,6,8,3,0,12,13,30
2015,Russ Smith,PG,23,NOP,6,0,29,2,10,0.2,1,6,0.167,1,4,0.25,0,0,,0,3,3,2,0,0,7,6,5
2015,Russ Smith,PG,23,MEM,6,0,36,6,15,0.4,1,5,0.2,5,10,0.5,12,13,0.923,1,2,3,6,3,0,5,7,25
2015,Russell Westbrook,PG,26,OKC,67,67,2302,627,1471,0.426,86,288,0.299,541,1183,0.457,546,654,0.835,124,364,488,574,140,14,293,184,1886
2015,Ryan Anderson,PF,26,NOP,61,5,1675,291,729,0.399,122,359,0.34,169,370,0.457,129,151,0.854,108,187,295,55,33,20,62,113,833
2015,Ryan Hollins,C,30,SAC,46,9,441,53,82,0.646,0,0,,53,82,0.646,31,54,0.574,36,67,103,14,6,19,25,65,137
2015,Ryan Kelly,PF,23,LAL,52,34,1233,104,309,0.337,45,134,0.336,59,175,0.337,79,95,0.832,13,133,146,92,30,24,37,118,332
2015,Samuel Dalembert,C,33,NYK,32,21,544,57,130,0.438,0,0,,57,130,0.438,14,20,0.7,53,115,168,29,14,41,39,70,128
2015,Sean Kilpatrick,SG,25,MIN,4,0,72,7,20,0.35,4,13,0.308,3,7,0.429,4,4,1,1,5,6,4,3,0,2,3,22
2015,Sebastian Telfair,PG,29,OKC,16,1,327,46,125,0.368,18,60,0.3,28,65,0.431,24,34,0.706,2,28,30,45,10,0,18,29,134
2015,Serge Ibaka,PF,25,OKC,64,64,2116,374,786,0.476,77,205,0.376,297,581,0.511,92,110,0.836,135,364,499,55,30,155,97,194,917
2015,Sergey Karasev,SG,21,BRK,33,16,555,54,134,0.403,16,54,0.296,38,80,0.475,29,38,0.763,22,44,66,46,23,1,24,45,153
2015,Seth Curry,PG,24,PHO,2,0,8,0,3,0,0,1,0,0,2,0,0,0,,0,2,2,1,0,0,0,2,0
2015,Shabazz Muhammad,SG,22,MIN,38,13,866,194,397,0.489,20,51,0.392,174,346,0.503,104,145,0.717,63,91,154,44,18,7,35,49,512
2015,Shabazz Napier,PG,23,MIA,51,10,1012,87,228,0.382,43,118,0.364,44,110,0.4,44,56,0.786,17,96,113,130,40,4,81,76,261
2015,Shane Larkin,PG,22,NYK,76,22,1865,187,432,0.433,35,116,0.302,152,316,0.481,61,78,0.782,29,147,176,226,93,9,83,150,470
2015,Shannon Brown,SG,29,MIA,5,2,89,7,19,0.368,3,7,0.429,4,12,0.333,3,4,0.75,0,1,1,3,4,0,4,8,20
2015,Shaun Livingston,PG,29,GSW,78,2,1468,198,396,0.5,0,2,0,198,394,0.503,65,91,0.714,43,140,183,259,49,20,102,110,461
2015,Shavlik Randolph,PF,31,TOT,21,0,126,9,35,0.257,0,5,0,9,30,0.3,6,12,0.5,16,22,38,4,5,3,3,16,24
2015,Shavlik Randolph,PF,31,PHO,16,0,101,6,25,0.24,0,4,0,6,21,0.286,5,10,0.5,12,14,26,3,4,2,2,13,17
2015,Shavlik Randolph,PF,31,BOS,5,0,25,3,10,0.3,0,1,0,3,9,0.333,1,2,0.5,4,8,12,1,1,1,1,3,7
2015,Shawn Marion,SF,36,CLE,57,24,1101,119,267,0.446,12,46,0.261,107,221,0.484,26,34,0.765,64,138,202,51,27,27,33,58,276
2015,Shawne Williams,SF,28,TOT,63,22,1087,121,300,0.403,64,178,0.36,57,122,0.467,35,40,0.875,36,130,166,44,25,21,30,135,341
2015,Shawne Williams,SF,28,MIA,44,22,924,102,240,0.425,60,152,0.395,42,88,0.477,28,33,0.848,27,112,139,36,21,17,23,116,292
2015,Shawne Williams,SF,28,DET,19,0,163,19,60,0.317,4,26,0.154,15,34,0.441,7,7,1,9,18,27,8,4,4,7,19,49
2015,Shayne Whittington,PF,23,IND,20,0,108,19,42,0.452,1,6,0.167,18,36,0.5,18,23,0.783,10,19,29,6,5,2,5,18,57
2015,Shelvin Mack,PG,24,ATL,55,0,833,117,292,0.401,40,127,0.315,77,165,0.467,25,31,0.806,8,71,79,155,30,2,49,32,299
2015,Sim Bhullar,C,22,SAC,3,0,3,1,2,0.5,0,0,,1,2,0.5,0,0,,0,1,1,1,0,1,0,0,2
2015,Solomon Hill,SF,23,IND,82,78,2381,251,634,0.396,68,208,0.327,183,426,0.43,159,193,0.824,70,244,314,184,66,18,115,177,729
2015,Spencer Dinwiddie,PG,21,DET,34,1,455,51,169,0.302,12,65,0.185,39,104,0.375,31,34,0.912,4,44,48,104,19,6,33,53,145
2015,Spencer Hawes,PF,26,LAC,73,15,1274,163,415,0.393,55,176,0.313,108,239,0.452,44,68,0.647,30,228,258,88,24,53,61,173,425
2015,Stephen Curry,PG,26,GSW,80,80,2613,653,1341,0.487,286,646,0.443,367,695,0.528,308,337,0.914,56,285,341,619,163,16,249,158,1900
2015,Steve Blake,PG,34,POR,81,0,1529,122,327,0.373,77,219,0.352,45,108,0.417,29,41,0.707,16,121,137,288,41,5,104,118,350
2015,Steve Novak,SF-PF,31,TOT,35,0,197,22,56,0.393,19,48,0.396,3,8,0.375,0,2,0,2,20,22,11,0,2,5,23,63
2015,Steve Novak,SF,31,UTA,22,0,109,16,35,0.457,16,33,0.485,0,2,0,0,2,0,1,15,16,6,0,1,3,13,48
2015,Steve Novak,PF,31,OKC,13,0,88,6,21,0.286,3,15,0.2,3,6,0.5,0,0,,1,5,6,5,0,1,2,10,15
2015,Steven Adams,C,21,OKC,70,67,1771,217,399,0.544,0,2,0,217,397,0.547,103,205,0.502,199,324,523,66,38,86,99,222,537
2015,T.J. Warren,SF,21,PHO,40,1,614,113,214,0.528,5,21,0.238,108,193,0.56,14,19,0.737,41,44,85,25,18,9,27,51,245
2015,Taj Gibson,PF,29,CHI,62,17,1692,254,506,0.502,0,0,,254,506,0.502,132,184,0.717,162,234,396,71,36,75,77,162,640
2015,Tarik Black,C,23,TOT,63,39,1196,157,273,0.575,0,1,0,157,272,0.577,65,118,0.551,142,226,368,42,19,24,48,158,379
2015,Tarik Black,C,23,HOU,25,12,393,45,83,0.542,0,1,0,45,82,0.549,15,29,0.517,58,69,127,8,6,2,19,56,105
2015,Tarik Black,C,23,LAL,38,27,803,112,190,0.589,0,0,,112,190,0.589,50,89,0.562,84,157,241,34,13,22,29,102,274
2015,Tayshaun Prince,SF,34,TOT,58,16,1397,177,402,0.44,31,67,0.463,146,335,0.436,49,65,0.754,52,158,210,93,29,16,35,55,434
2015,Tayshaun Prince,SF,34,MEM,26,9,628,75,183,0.41,15,33,0.455,60,150,0.4,25,30,0.833,21,62,83,37,9,6,15,22,190
2015,Tayshaun Prince,SF,34,BOS,9,0,198,33,59,0.559,5,8,0.625,28,51,0.549,5,6,0.833,6,24,30,18,5,2,4,7,76
2015,Tayshaun Prince,SF,34,DET,23,7,571,69,160,0.431,11,26,0.423,58,134,0.433,19,29,0.655,25,72,97,38,15,8,16,26,168
2015,Terrence Jones,PF,23,HOU,33,24,889,158,299,0.528,13,37,0.351,145,262,0.553,57,94,0.606,78,142,220,36,18,59,37,78,386
2015,Terrence Ross,SF,23,TOR,82,61,2092,309,753,0.41,145,390,0.372,164,363,0.452,44,56,0.786,32,194,226,86,53,25,69,136,807
2015,Thabo Sefolosha,SF,30,ATL,52,7,976,104,249,0.418,25,78,0.321,79,171,0.462,45,58,0.776,53,170,223,75,53,21,38,67,278
2015,Thaddeus Young,PF,26,TOT,76,68,2434,451,968,0.466,38,115,0.33,413,853,0.484,131,200,0.655,127,284,411,173,124,25,117,171,1071
2015,Thaddeus Young,PF,26,MIN,48,48,1605,289,641,0.451,19,65,0.292,270,576,0.469,88,129,0.682,75,170,245,135,86,17,75,115,685
2015,Thaddeus Young,PF,26,BRK,28,20,829,162,327,0.495,19,50,0.38,143,277,0.516,43,71,0.606,52,114,166,38,38,8,42,56,386
2015,Thomas Robinson,PF,23,TOT,54,4,798,126,260,0.485,0,2,0,126,258,0.488,56,106,0.528,95,208,303,33,32,20,59,104,308
2015,Thomas Robinson,PF,23,POR,32,4,391,47,91,0.516,0,0,,47,91,0.516,21,48,0.438,33,100,133,9,16,11,33,54,115
2015,Thomas Robinson,PF,23,PHI,22,0,407,79,169,0.467,0,2,0,79,167,0.473,35,58,0.603,62,108,170,24,16,9,26,50,193
2015,Tiago Splitter,C,30,SAS,52,35,1030,169,303,0.558,0,0,,169,303,0.558,90,120,0.75,91,161,252,78,35,37,60,103,428
2015,Tim Duncan*,C,38,SAS,77,77,2227,419,819,0.512,2,7,0.286,417,812,0.514,230,311,0.74,170,534,704,230,63,151,131,165,1070
2015,Tim Frazier,PG,24,TOT,11,3,239,21,61,0.344,5,17,0.294,16,44,0.364,10,21,0.476,6,22,28,60,8,0,25,26,57
2015,Tim Frazier,PG,24,PHI,6,3,171,13,43,0.302,3,11,0.273,10,32,0.313,5,15,0.333,4,15,19,43,6,0,18,16,34
2015,Tim Frazier,PG,24,POR,5,0,68,8,18,0.444,2,6,0.333,6,12,0.5,5,6,0.833,2,7,9,17,2,0,7,10,23
2015,Tim Hardaway Jr.,SG,22,NYK,70,30,1681,279,717,0.389,121,354,0.342,158,363,0.435,125,156,0.801,12,144,156,127,20,14,82,119,804
2015,Timofey Mozgov,C,28,TOT,81,80,2045,314,566,0.555,2,6,0.333,312,560,0.557,155,216,0.718,203,388,591,55,33,97,116,227,785
2015,Timofey Mozgov,C,28,DEN,35,35,897,117,232,0.504,2,6,0.333,115,226,0.509,63,86,0.733,91,181,272,16,15,41,47,114,299
2015,Timofey Mozgov,C,28,CLE,46,45,1148,197,334,0.59,0,0,,197,334,0.59,92,130,0.708,112,207,319,39,18,56,69,113,486
2015,Tobias Harris,SF,22,ORL,68,63,2369,442,949,0.466,87,239,0.364,355,710,0.5,193,245,0.788,73,357,430,124,69,36,115,134,1164
2015,Toney Douglas,SG,28,NOP,12,0,177,19,51,0.373,5,18,0.278,14,33,0.424,8,13,0.615,2,20,22,24,11,4,10,20,51
2015,Tony Allen,SG,33,MEM,63,41,1648,225,455,0.495,10,29,0.345,215,426,0.505,79,126,0.627,103,177,280,86,129,30,86,166,539
2015,Tony Parker,PG,32,SAS,68,68,1953,404,832,0.486,38,89,0.427,366,743,0.493,130,166,0.783,15,114,129,335,44,2,146,108,976
2015,Tony Snell,SF,23,CHI,72,22,1412,159,371,0.429,73,197,0.371,86,174,0.494,44,55,0.8,31,145,176,62,32,11,48,86,435
2015,Tony Wroten,PG,21,PHI,30,15,895,175,434,0.403,37,142,0.261,138,292,0.473,120,180,0.667,22,64,86,157,48,8,113,72,507
2015,Toure' Murry,SG-PG,25,TOT,5,0,18,2,5,0.4,0,0,,2,5,0.4,2,2,1,1,0,1,1,1,0,4,2,6
2015,Toure' Murry,PG,25,UTA,1,0,1,0,1,0,0,0,,0,1,0,0,0,,0,0,0,0,0,0,0,0,0
2015,Toure' Murry,SG,25,WAS,4,0,17,2,4,0.5,0,0,,2,4,0.5,2,2,1,1,0,1,1,1,0,4,2,6
2015,Travis Wear,SF,24,NYK,51,1,672,84,209,0.402,11,30,0.367,73,179,0.408,20,26,0.769,31,75,106,40,15,11,35,55,199
2015,Trevor Ariza,SF,29,HOU,82,82,2930,366,910,0.402,194,555,0.35,172,355,0.485,122,143,0.853,77,382,459,209,152,17,141,186,1048
2015,Trevor Booker,PF,27,UTA,79,5,1564,226,464,0.487,29,84,0.345,197,380,0.518,86,148,0.581,139,258,397,83,43,41,88,144,567
2015,Trey Burke,PG,22,UTA,76,43,2288,370,1005,0.368,124,390,0.318,246,615,0.4,109,145,0.752,31,173,204,328,65,15,124,119,973
2015,Tristan Thompson,PF,23,CLE,82,15,2194,267,488,0.547,0,0,,267,488,0.547,159,248,0.641,274,383,657,39,34,61,83,189,693
2015,Troy Daniels,SG,23,TOT,47,0,397,61,165,0.37,43,118,0.364,18,47,0.383,11,13,0.846,8,25,33,22,6,1,20,40,176
2015,Troy Daniels,SG,23,HOU,17,0,108,15,47,0.319,13,43,0.302,2,4,0.5,3,4,0.75,0,6,6,4,0,0,5,14,46
2015,Troy Daniels,SG,23,MIN,19,0,154,19,59,0.322,13,39,0.333,6,20,0.3,2,2,1,6,13,19,13,3,0,8,14,53
2015,Troy Daniels,SG,23,CHO,11,0,135,27,59,0.458,17,36,0.472,10,23,0.435,6,7,0.857,2,6,8,5,3,1,7,12,77
2015,Ty Lawson,PG,27,DEN,75,75,2665,404,926,0.436,70,205,0.341,334,721,0.463,265,363,0.73,42,192,234,720,92,9,185,128,1143
2015,Tyler Ennis,PG,20,TOT,33,1,411,52,144,0.361,12,43,0.279,40,101,0.396,5,7,0.714,7,28,35,73,18,5,42,36,121
2015,Tyler Ennis,PG,20,PHO,8,0,58,9,21,0.429,2,6,0.333,7,15,0.467,2,2,1,1,6,7,14,0,2,8,3,22
2015,Tyler Ennis,PG,20,MIL,25,1,353,43,123,0.35,10,37,0.27,33,86,0.384,3,5,0.6,6,22,28,59,18,3,34,33,99
2015,Tyler Hansbrough,PF,29,TOR,74,8,1058,86,165,0.521,1,7,0.143,85,158,0.538,97,139,0.698,106,159,265,21,30,15,20,141,270
2015,Tyler Johnson,SG,22,MIA,32,2,603,70,167,0.419,18,48,0.375,52,119,0.437,32,47,0.681,14,67,81,42,33,9,30,42,190
2015,Tyler Zeller,C,25,BOS,82,59,1731,340,619,0.549,0,0,,340,619,0.549,153,186,0.823,146,319,465,113,18,52,76,205,833
2015,Tyreke Evans,SG,25,NOP,79,76,2690,521,1165,0.447,69,227,0.304,452,938,0.482,202,291,0.694,82,334,416,521,100,37,246,198,1313
2015,Tyrus Thomas,PF,28,MEM,2,0,7,1,1,1,0,0,,1,1,1,2,2,1,0,0,0,1,0,0,0,0,4
2015,Tyson Chandler,C,32,DAL,75,75,2286,293,440,0.666,0,0,,293,440,0.666,185,257,0.72,294,570,864,84,42,91,105,169,771
2015,Udonis Haslem,PF,34,MIA,62,25,995,107,239,0.448,2,10,0.2,105,229,0.459,45,64,0.703,71,187,258,46,21,13,41,113,261
2015,Vander Blue,SG,22,LAL,2,1,74,9,30,0.3,2,10,0.2,7,20,0.35,2,5,0.4,2,7,9,8,3,0,6,4,22
2015,Victor Claver,SF,26,POR,10,0,76,9,20,0.45,6,11,0.545,3,9,0.333,0,0,,3,17,20,1,1,1,4,12,24
2015,Victor Oladipo,SG,22,ORL,72,71,2573,473,1086,0.436,84,248,0.339,389,838,0.464,262,320,0.819,51,251,302,295,120,19,204,187,1292
2015,Vince Carter,SG,38,MEM,66,1,1091,135,406,0.333,69,232,0.297,66,174,0.379,45,57,0.789,27,106,133,79,43,14,43,102,384
2015,Wayne Ellington,SG,27,LAL,65,36,1675,254,617,0.412,90,243,0.37,164,374,0.439,52,64,0.813,31,179,210,105,33,2,50,77,650
2015,Wesley Johnson,SF,27,LAL,76,59,2245,286,691,0.414,91,259,0.351,195,432,0.451,90,112,0.804,67,252,319,124,59,45,87,162,753
2015,Wesley Matthews,SG,28,POR,60,60,2024,337,752,0.448,173,445,0.389,164,307,0.534,109,145,0.752,38,184,222,139,77,10,81,132,956
2015,Will Barton,SG,24,TOT,58,0,983,150,353,0.425,23,85,0.271,127,268,0.474,74,94,0.787,26,136,162,81,48,19,61,70,397
2015,Will Barton,SG,24,POR,30,0,300,38,100,0.38,4,18,0.222,34,82,0.415,10,15,0.667,3,31,34,27,14,4,17,20,90
2015,Will Barton,SG,24,DEN,28,0,683,112,253,0.443,19,67,0.284,93,186,0.5,64,79,0.81,23,105,128,54,34,15,44,50,307
2015,Will Bynum,SG,32,WAS,7,0,67,10,31,0.323,0,9,0,10,22,0.455,2,4,0.5,2,4,6,18,1,1,8,9,22
2015,Will Cherry,PG,23,CLE,8,0,69,5,19,0.263,2,9,0.222,3,10,0.3,3,6,0.5,1,4,5,8,6,1,4,10,15
2015,Willie Green,SG,33,ORL,52,2,951,118,306,0.386,42,121,0.347,76,185,0.411,28,34,0.824,14,65,79,68,26,5,48,81,306
2015,Wilson Chandler,SF,27,DEN,78,75,2471,418,975,0.429,139,406,0.342,279,569,0.49,110,142,0.775,96,379,475,134,58,29,110,231,1085
2015,Xavier Henry,SF,23,LAL,9,0,86,3,13,0.231,0,0,,3,13,0.231,14,24,0.583,2,2,4,3,3,0,3,6,20
2015,Zach LaVine,PG,19,MIN,77,40,1902,286,677,0.422,57,167,0.341,229,510,0.449,149,177,0.842,27,187,214,276,54,10,193,158,778
2015,Zach Randolph,PF,33,MEM,71,71,2304,454,932,0.487,7,20,0.35,447,912,0.49,228,298,0.765,225,522,747,153,69,14,156,175,1143
2015,Zaza Pachulia,C,30,MIL,73,45,1730,240,529,0.454,0,3,0,240,526,0.456,126,160,0.788,197,303,500,178,80,21,133,170,606
2015,Zoran Dragić,SG,25,TOT,16,1,75,11,30,0.367,3,14,0.214,8,16,0.5,3,5,0.6,5,3,8,5,2,0,5,6,28
2015,Zoran Dragić,SG,25,PHO,6,0,13,2,8,0.25,0,5,0,2,3,0.667,2,3,0.667,2,1,3,1,0,0,0,1,6
2015,Zoran Dragić,SG,25,MIA,10,1,62,9,22,0.409,3,9,0.333,6,13,0.462,1,2,0.5,3,2,5,4,2,0,5,5,22
2016,Aaron Brooks,PG,31,CHI,69,0,1108,188,469,0.401,66,185,0.357,122,284,0.43,49,64,0.766,21,80,101,180,30,10,82,132,491
2016,Aaron Gordon,PF,20,ORL,78,37,1863,274,579,0.473,42,142,0.296,232,437,0.531,129,193,0.668,154,353,507,128,59,55,66,153,719
2016,Aaron Harrison,SG,21,CHO,21,0,93,5,19,0.263,3,10,0.3,2,9,0.222,5,12,0.417,4,11,15,2,6,0,4,10,18
2016,Adreian Payne,PF,24,MIN,52,2,486,53,145,0.366,9,32,0.281,44,113,0.389,17,26,0.654,20,91,111,29,16,11,36,77,132
2016,Al Horford,C,29,ATL,82,82,2631,529,1048,0.505,88,256,0.344,441,792,0.557,103,129,0.798,148,448,596,263,68,121,107,163,1249
2016,Al Jefferson,C,31,CHO,47,18,1096,245,505,0.485,0,0,,245,505,0.485,72,111,0.649,57,244,301,70,30,41,34,117,562
2016,Al-Farouq Aminu,SF,25,POR,82,82,2341,299,719,0.416,126,349,0.361,173,370,0.468,115,156,0.737,98,401,499,138,72,53,120,171,839
2016,Alan Anderson,SG,33,WAS,13,0,192,21,59,0.356,12,37,0.324,9,22,0.409,11,15,0.733,1,26,27,14,4,1,2,25,65
2016,Alan Williams,PF,23,PHO,10,0,68,10,24,0.417,0,0,,10,24,0.417,9,14,0.643,14,24,38,5,4,5,6,15,29
2016,Alec Burks,SG,24,UTA,31,3,797,137,334,0.41,32,79,0.405,105,255,0.412,106,141,0.752,16,93,109,63,18,4,51,71,412
2016,Alex Len,C,22,PHO,78,46,1821,264,624,0.423,1,7,0.143,263,617,0.426,174,239,0.728,178,416,594,97,38,62,145,230,703
2016,Alex Stepheson,PF,28,TOT,8,0,73,9,27,0.333,0,0,,9,27,0.333,4,12,0.333,19,9,28,2,1,5,0,12,22
2016,Alex Stepheson,PF,28,LAC,4,0,12,1,1,1,0,0,,1,1,1,0,2,0,1,1,2,0,0,2,0,4,2
2016,Alex Stepheson,PF,28,MEM,4,0,61,8,26,0.308,0,0,,8,26,0.308,4,10,0.4,18,8,26,2,1,3,0,8,20
2016,Alexis Ajinça,C,27,NOP,59,17,861,150,315,0.476,0,1,0,150,314,0.478,52,62,0.839,75,194,269,31,19,36,54,134,352
2016,Allen Crabbe,SG,23,POR,81,8,2105,311,678,0.459,112,285,0.393,199,393,0.506,98,113,0.867,27,189,216,99,63,16,64,192,832
2016,Alonzo Gee,SF,28,NOP,73,38,1632,132,255,0.518,17,60,0.283,115,195,0.59,44,66,0.667,60,185,245,72,63,13,55,169,325
2016,Amar'e Stoudemire,C,33,MIA,52,36,762,125,221,0.566,0,0,,125,221,0.566,50,67,0.746,65,157,222,27,18,41,47,92,300
2016,Amir Johnson,PF,28,BOS,79,76,1800,249,426,0.585,10,43,0.233,239,383,0.624,69,121,0.57,178,327,505,138,52,83,94,214,577
2016,Anderson Varejão,C,33,TOT,53,0,496,53,124,0.427,0,1,0,53,123,0.431,32,50,0.64,37,104,141,35,16,10,22,70,138
2016,Anderson Varejão,C,33,CLE,31,0,310,32,76,0.421,0,1,0,32,75,0.427,16,21,0.762,24,67,91,20,11,5,16,35,80
2016,Anderson Varejão,C,33,GSW,22,0,186,21,48,0.438,0,0,,21,48,0.438,16,29,0.552,13,37,50,15,5,5,6,35,58
2016,Andre Drummond,C,22,DET,81,81,2666,552,1060,0.521,2,6,0.333,550,1054,0.522,208,586,0.355,395,803,1198,67,119,112,155,245,1314
2016,Andre Iguodala,SF,32,GSW,65,1,1732,176,368,0.478,54,154,0.351,122,214,0.57,51,83,0.614,52,211,263,219,73,19,79,102,457
2016,Andre Miller,PG,39,TOT,39,4,461,59,106,0.557,2,8,0.25,57,98,0.582,24,32,0.75,12,39,51,87,16,0,37,46,144
2016,Andre Miller,PG,39,MIN,26,0,280,36,58,0.621,1,4,0.25,35,54,0.648,15,19,0.789,6,18,24,58,9,0,25,32,88
2016,Andre Miller,PG,39,SAS,13,4,181,23,48,0.479,1,4,0.25,22,44,0.5,9,13,0.692,6,21,27,29,7,0,12,14,56
2016,Andre Roberson,SG,24,OKC,70,70,1553,136,274,0.496,32,103,0.311,104,171,0.608,33,54,0.611,79,172,251,47,53,42,35,133,337
2016,Andrea Bargnani,C,30,BRK,46,0,634,127,279,0.455,3,16,0.188,124,263,0.471,47,57,0.825,28,69,97,18,4,9,26,61,304
2016,Andrew Bogut,C,31,GSW,70,66,1451,175,279,0.627,1,1,1,174,278,0.626,24,50,0.48,121,371,492,162,33,114,83,221,375
2016,Andrew Goudelock,PG,27,HOU,8,0,50,9,20,0.45,1,9,0.111,8,11,0.727,3,4,0.75,1,1,2,4,6,2,7,4,22
2016,Andrew Nicholson,PF,26,ORL,56,0,823,146,310,0.471,41,114,0.36,105,196,0.536,51,65,0.785,34,167,201,25,10,22,41,69,384
2016,Andrew Wiggins,SF,20,MIN,81,81,2845,594,1294,0.459,57,190,0.3,537,1104,0.486,430,565,0.761,105,186,291,164,78,46,182,165,1675
2016,Anthony Bennett,PF,22,TOR,19,0,84,8,27,0.296,3,14,0.214,5,13,0.385,9,10,0.9,6,17,23,0,5,0,4,8,28
2016,Anthony Brown,SF,23,LAL,29,11,599,39,126,0.31,20,70,0.286,19,56,0.339,17,20,0.85,9,61,70,19,14,5,15,34,115
2016,Anthony Davis,C,22,NOP,61,61,2164,560,1136,0.493,35,108,0.324,525,1028,0.511,326,430,0.758,130,497,627,116,78,125,121,148,1481
2016,Anthony Morrow,SG,30,OKC,68,6,926,136,333,0.408,79,204,0.387,57,129,0.442,29,39,0.744,10,52,62,24,22,5,17,64,380
2016,Anthony Tolliver,PF,30,DET,72,5,1341,128,332,0.386,98,272,0.36,30,60,0.5,29,47,0.617,39,190,229,52,26,16,28,86,383
2016,Archie Goodwin,PG,21,PHO,57,13,1114,176,422,0.417,23,99,0.232,153,323,0.474,130,193,0.674,27,115,142,118,27,13,100,84,505
2016,Aron Baynes,C,29,DET,81,1,1233,194,384,0.505,0,2,0,194,382,0.508,126,165,0.764,140,244,384,51,21,52,67,151,514
2016,Arron Afflalo,SG,30,NYK,71,57,2371,354,799,0.443,91,238,0.382,263,561,0.469,110,131,0.84,23,243,266,144,25,10,82,142,909
2016,Austin Rivers,SG,23,LAC,67,7,1464,226,516,0.438,62,185,0.335,164,331,0.495,79,116,0.681,22,108,130,99,48,9,61,137,593
2016,Avery Bradley,SG,25,BOS,76,72,2536,456,1019,0.447,147,407,0.361,309,612,0.505,96,123,0.78,48,172,220,158,117,19,109,164,1155
2016,Axel Toupane,SF,23,DEN,21,0,305,25,70,0.357,13,40,0.325,12,30,0.4,13,17,0.765,8,23,31,15,7,6,6,40,76
2016,Ben McLemore,SG,22,SAC,68,53,1443,195,455,0.429,67,185,0.362,128,270,0.474,74,103,0.718,34,114,148,79,52,10,99,140,531
2016,Beno Udrih,PG,33,TOT,44,5,707,86,198,0.434,15,44,0.341,71,154,0.461,18,20,0.9,8,64,72,116,14,1,53,51,205
2016,Beno Udrih,PG,33,MEM,8,0,120,20,46,0.435,4,11,0.364,16,35,0.457,3,3,1,2,7,9,26,3,1,11,11,47
2016,Beno Udrih,PG,33,MIA,36,5,587,66,152,0.434,11,33,0.333,55,119,0.462,15,17,0.882,6,57,63,90,11,0,42,40,158
2016,Bismack Biyombo,C,23,TOR,82,22,1808,156,288,0.542,0,1,0,156,287,0.544,142,226,0.628,182,473,655,29,19,133,71,225,454
2016,Blake Griffin,PF,26,LAC,35,35,1170,301,603,0.499,6,18,0.333,295,585,0.504,141,194,0.727,51,243,294,170,28,17,83,95,749
2016,Boban Marjanović,C,27,SAS,54,4,508,105,174,0.603,0,0,,105,174,0.603,87,114,0.763,73,121,194,21,12,23,29,54,297
2016,Bobby Portis,PF,20,CHI,62,4,1102,186,436,0.427,16,52,0.308,170,384,0.443,48,66,0.727,123,214,337,52,25,22,54,100,436
2016,Bojan Bogdanović,SF,26,BRK,79,39,2115,324,749,0.433,129,338,0.382,195,411,0.474,110,132,0.833,36,219,255,99,29,5,115,119,887
2016,Boris Diaw,PF,33,SAS,76,4,1386,202,383,0.527,25,69,0.362,177,314,0.564,56,76,0.737,58,175,233,176,26,21,97,102,485
2016,Bradley Beal,SG,22,WAS,55,35,1708,359,799,0.449,105,271,0.387,254,528,0.481,135,176,0.767,41,147,188,162,54,11,112,117,958
2016,Brandan Wright,PF,28,MEM,12,2,212,35,52,0.673,0,0,,35,52,0.673,13,24,0.542,14,29,43,6,5,15,10,21,83
2016,Branden Dawson,PF,22,LAC,6,0,29,2,5,0.4,0,0,,2,5,0.4,1,1,1,2,2,4,0,0,1,0,2,5
2016,Brandon Bass,PF,30,LAL,66,0,1342,174,317,0.549,0,2,0,174,315,0.552,125,148,0.845,104,181,285,74,33,55,42,125,473
2016,Brandon Jennings,PG,26,TOT,48,7,868,112,304,0.368,51,155,0.329,61,149,0.409,57,78,0.731,16,80,96,170,29,7,57,57,332
2016,Brandon Jennings,PG,26,DET,23,1,416,53,143,0.371,24,77,0.312,29,66,0.439,27,38,0.711,5,41,46,70,11,2,22,24,157
2016,Brandon Jennings,PG,26,ORL,25,6,452,59,161,0.366,27,78,0.346,32,83,0.386,30,40,0.75,11,39,50,100,18,5,35,33,175
2016,Brandon Knight,SG,24,PHO,52,50,1870,371,895,0.415,120,351,0.342,251,544,0.461,156,183,0.852,36,166,202,263,61,20,177,124,1018
2016,Brandon Rush,SG,30,GSW,72,25,1055,111,260,0.427,65,157,0.414,46,103,0.447,18,28,0.643,21,160,181,57,20,23,33,57,305
2016,Brian Roberts,PG,30,TOT,51,0,470,74,165,0.448,15,42,0.357,59,123,0.48,42,47,0.894,6,35,41,54,10,2,23,35,205
2016,Brian Roberts,PG,30,CHO,30,0,333,51,115,0.443,9,27,0.333,42,88,0.477,34,37,0.919,4,25,29,38,7,1,16,23,145
2016,Brian Roberts,PG,30,POR,21,0,137,23,50,0.46,6,15,0.4,17,35,0.486,8,10,0.8,2,10,12,16,3,1,7,12,60
2016,Briante Weber,PG,23,TOT,7,4,169,14,39,0.359,0,5,0,14,34,0.412,3,4,0.75,8,17,25,21,9,3,9,12,31
2016,Briante Weber,PG,23,MEM,6,4,166,13,38,0.342,0,5,0,13,33,0.394,3,4,0.75,8,16,24,20,9,3,9,11,29
2016,Briante Weber,PG,23,MIA,1,0,3,1,1,1,0,0,,1,1,1,0,0,,0,1,1,1,0,0,0,1,2
2016,Brook Lopez,C,27,BRK,73,73,2457,591,1157,0.511,2,14,0.143,589,1143,0.515,317,403,0.787,204,369,573,147,58,124,175,215,1501
2016,Bruno Caboclo,SF,20,TOR,6,1,43,1,12,0.083,1,7,0.143,0,5,0,0,0,,1,1,2,1,2,1,4,2,3
2016,Bryce Cotton,PG,23,TOT,8,0,39,4,10,0.4,0,3,0,4,7,0.571,0,0,,0,0,0,3,3,0,5,2,8
2016,Bryce Cotton,PG,23,PHO,3,0,33,2,8,0.25,0,3,0,2,5,0.4,0,0,,0,0,0,3,3,0,5,2,4
2016,Bryce Cotton,PG,23,MEM,5,0,6,2,2,1,0,0,,2,2,1,0,0,,0,0,0,0,0,0,0,0,4
2016,Bryce Dejean-Jones,SG,23,NOP,14,11,279,28,69,0.406,12,32,0.375,16,37,0.432,11,21,0.524,8,40,48,15,10,2,11,17,79
2016,C.J. Miles,SF,28,IND,64,24,1464,259,634,0.409,142,387,0.367,117,247,0.474,93,124,0.75,25,150,175,63,53,29,70,142,753
2016,C.J. Watson,PG,31,ORL,33,2,656,47,137,0.343,14,48,0.292,33,89,0.371,34,39,0.872,10,56,66,88,19,5,25,49,142
2016,C.J. Wilcox,SG,25,LAC,23,0,167,26,66,0.394,9,23,0.391,17,43,0.395,9,12,0.75,1,11,12,10,10,2,2,15,70
2016,Cameron Bairstow,C,25,CHI,18,2,103,13,40,0.325,1,5,0.2,12,35,0.343,7,8,0.875,4,24,28,6,2,3,4,19,34
2016,Cameron Payne,PG,21,OKC,57,1,698,114,278,0.41,36,111,0.324,78,167,0.467,19,24,0.792,9,76,85,108,36,6,44,80,283
2016,Carl Landry,PF,32,PHI,36,12,569,139,250,0.556,6,13,0.462,133,237,0.561,67,91,0.736,49,97,146,32,12,9,22,69,351
2016,Carmelo Anthony,SF,31,NYK,72,72,2530,567,1307,0.434,105,310,0.339,462,997,0.463,334,403,0.829,98,458,556,299,62,38,176,180,1573
2016,Caron Butler,SF,35,SAC,17,1,176,25,59,0.424,3,18,0.167,22,41,0.537,10,12,0.833,5,17,22,10,9,1,3,19,63
2016,Chandler Parsons,SF,27,DAL,61,51,1799,320,651,0.492,104,251,0.414,216,400,0.54,93,136,0.684,29,256,285,169,46,21,95,114,837
2016,Channing Frye,PF-C,32,TOT,70,32,1200,152,347,0.438,91,235,0.387,61,112,0.545,30,35,0.857,35,199,234,71,29,28,43,127,425
2016,Channing Frye,PF,32,ORL,44,29,754,81,186,0.435,48,121,0.397,33,65,0.508,19,21,0.905,23,118,141,45,21,20,30,71,229
2016,Channing Frye,C,32,CLE,26,3,446,71,161,0.441,43,114,0.377,28,47,0.596,11,14,0.786,12,81,93,26,8,8,13,56,196
2016,Charlie Villanueva,PF,31,DAL,62,4,665,125,327,0.382,47,172,0.273,78,155,0.503,22,24,0.917,24,128,152,24,18,15,31,71,319
2016,Chase Budinger,SF,27,TOT,66,2,929,104,239,0.435,24,86,0.279,80,153,0.523,39,56,0.696,43,107,150,64,32,10,44,62,271
2016,Chase Budinger,SF,27,IND,49,2,729,81,194,0.418,20,69,0.29,61,125,0.488,34,48,0.708,31,90,121,49,29,9,31,46,216
2016,Chase Budinger,SF,27,PHO,17,0,200,23,45,0.511,4,17,0.235,19,28,0.679,5,8,0.625,12,17,29,15,3,1,13,16,55
2016,Chris Andersen,C,37,TOT,27,15,402,38,72,0.528,4,14,0.286,34,58,0.586,25,36,0.694,36,62,98,12,15,13,9,29,105
2016,Chris Andersen,C,37,MIA,7,1,36,4,10,0.4,2,5,0.4,2,5,0.4,3,4,0.75,3,6,9,3,1,3,2,4,13
2016,Chris Andersen,C,37,MEM,20,14,366,34,62,0.548,2,9,0.222,32,53,0.604,22,32,0.688,33,56,89,9,14,10,7,25,92
2016,Chris Bosh*,PF,31,MIA,53,53,1778,358,767,0.467,81,222,0.365,277,545,0.508,213,268,0.795,48,342,390,128,36,34,78,101,1010
2016,Chris Copeland,PF,31,MIL,24,1,156,17,51,0.333,10,36,0.278,7,15,0.467,6,7,0.857,1,9,10,11,2,0,6,17,50
2016,Chris Johnson,SF,25,UTA,70,2,857,72,194,0.371,27,99,0.273,45,95,0.474,34,42,0.81,27,105,132,45,32,20,40,100,205
2016,Chris Kaman,C,33,POR,16,2,112,20,43,0.465,1,4,0.25,19,39,0.487,3,3,1,7,17,24,11,1,1,8,15,44
2016,Chris McCullough,PF,20,BRK,24,4,362,44,109,0.404,13,34,0.382,31,75,0.413,11,23,0.478,25,43,68,9,28,12,15,39,112
2016,Chris Paul,PG,30,LAC,74,74,2420,515,1114,0.462,122,329,0.371,393,785,0.501,294,328,0.896,39,271,310,738,152,13,194,185,1446
2016,Christian Wood,PF,20,PHI,17,0,145,22,53,0.415,4,11,0.364,18,42,0.429,13,21,0.619,13,25,38,3,5,7,2,11,61
2016,Chuck Hayes,C,32,HOU,2,0,24,1,2,0.5,0,0,,1,2,0.5,2,2,1,0,8,8,2,0,0,3,6,4
2016,CJ McCollum,SG,24,POR,80,80,2780,641,1431,0.448,197,472,0.417,444,959,0.463,187,226,0.827,47,212,259,341,97,23,196,187,1666
2016,Cleanthony Early,SF,24,NYK,17,2,154,12,40,0.3,4,15,0.267,8,25,0.32,3,4,0.75,4,22,26,6,2,3,9,16,31
2016,Cliff Alexander,PF,20,POR,8,0,36,5,10,0.5,0,0,,5,10,0.5,0,0,,2,4,6,0,1,2,1,1,10
2016,Clint Capela,C,21,HOU,77,35,1471,231,397,0.582,0,1,0,231,396,0.583,80,211,0.379,194,300,494,47,59,92,60,190,542
2016,Cody Zeller,C,23,CHO,73,60,1774,231,437,0.529,1,10,0.1,230,427,0.539,175,232,0.754,138,317,455,71,57,63,68,204,638
2016,Cole Aldrich,C,27,LAC,60,5,800,134,225,0.596,0,0,,134,225,0.596,60,84,0.714,86,202,288,50,47,68,64,139,328
2016,Corey Brewer,SF,29,HOU,82,12,1669,212,552,0.384,61,224,0.272,151,328,0.46,105,140,0.75,42,157,199,109,84,19,78,168,590
2016,Cory Jefferson,PF,25,PHO,8,0,50,9,22,0.409,0,1,0,9,21,0.429,4,6,0.667,6,10,16,0,0,1,0,8,22
2016,Cory Joseph,SG,24,TOR,80,4,2046,257,585,0.439,30,110,0.273,227,475,0.478,133,174,0.764,39,171,210,250,63,20,102,131,677
2016,Coty Clarke,SF,23,BOS,3,0,6,2,4,0.5,2,2,1,0,2,0,0,0,,0,1,1,0,0,0,1,0,6
2016,Courtney Lee,SG,30,TOT,79,65,2334,290,639,0.454,82,217,0.378,208,422,0.493,99,118,0.839,29,176,205,136,85,28,72,134,761
2016,Courtney Lee,SG,30,MEM,51,37,1489,192,419,0.458,51,138,0.37,141,281,0.502,76,92,0.826,19,99,118,76,52,16,49,79,511
2016,Courtney Lee,SG,30,CHO,28,28,845,98,220,0.445,31,79,0.392,67,141,0.475,23,26,0.885,10,77,87,60,33,12,23,55,250
2016,Cristiano Felício,C,23,CHI,31,4,321,40,72,0.556,0,4,0,40,68,0.588,25,35,0.714,30,72,102,26,6,13,13,31,105
2016,D.J. Augustin,PG,28,TOT,62,0,1178,148,350,0.423,68,168,0.405,80,182,0.44,103,128,0.805,8,87,95,198,38,4,84,85,467
2016,D.J. Augustin,PG,28,OKC,34,0,519,46,121,0.38,24,61,0.393,22,60,0.367,26,34,0.765,5,38,43,66,13,2,30,41,142
2016,D.J. Augustin,PG,28,DEN,28,0,659,102,229,0.445,44,107,0.411,58,122,0.475,77,94,0.819,3,49,52,132,25,2,54,44,325
2016,D'Angelo Russell,PG,19,LAL,80,48,2259,392,956,0.41,130,370,0.351,262,586,0.447,140,190,0.737,47,227,274,266,93,13,196,142,1054
2016,Dahntay Jones,SF,35,CLE,1,0,42,6,14,0.429,1,2,0.5,5,12,0.417,0,0,,1,4,5,2,1,2,0,6,13
2016,Damian Lillard,PG,25,POR,75,75,2676,618,1474,0.419,229,610,0.375,389,864,0.45,414,464,0.892,45,257,302,512,65,28,242,165,1879
2016,Damien Inglis,SF,20,MIL,20,1,156,13,37,0.351,3,13,0.231,10,24,0.417,7,8,0.875,2,29,31,10,6,3,11,11,36
2016,Damjan Rudež,SF,29,MIN,33,0,277,25,62,0.403,17,50,0.34,8,12,0.667,8,8,1,5,15,20,11,3,1,13,33,75
2016,Danilo Gallinari,SF,27,DEN,53,53,1839,287,700,0.41,87,239,0.364,200,461,0.434,375,432,0.868,52,229,281,135,42,19,77,87,1036
2016,Danny Green,SG,28,SAS,79,79,2062,211,561,0.376,116,349,0.332,95,212,0.448,34,46,0.739,48,255,303,141,79,64,75,141,572
2016,Dante Cunningham,SF,28,NOP,80,46,1971,186,412,0.451,55,174,0.316,131,238,0.55,57,82,0.695,57,179,236,77,42,33,41,173,484
2016,Darrell Arthur,PF,27,DEN,70,16,1516,221,489,0.452,45,117,0.385,176,372,0.473,40,53,0.755,86,207,293,96,53,48,66,185,527
2016,Darren Collison,PG,28,SAC,74,15,2219,377,776,0.486,87,217,0.401,290,559,0.519,194,226,0.858,28,141,169,318,76,4,130,142,1035
2016,Darrun Hilliard,SG,22,DET,38,2,383,52,131,0.397,19,50,0.38,33,81,0.407,29,40,0.725,5,40,45,27,9,1,19,28,152
2016,David Lee,PF,32,TOT,55,5,903,178,335,0.531,0,1,0,178,334,0.533,71,93,0.763,101,204,305,84,22,28,66,114,427
2016,David Lee,PF,32,BOS,30,4,470,87,192,0.453,0,1,0,87,191,0.455,40,51,0.784,41,89,130,54,12,13,38,51,214
2016,David Lee,PF,32,DAL,25,1,433,91,143,0.636,0,0,,91,143,0.636,31,42,0.738,60,115,175,30,10,15,28,63,213
2016,David West,PF,35,SAS,78,19,1404,244,448,0.545,3,7,0.429,241,441,0.546,63,80,0.788,72,237,309,143,44,55,68,142,554
2016,DeAndre Jordan,C,27,LAC,77,77,2598,357,508,0.703,0,1,0,357,507,0.704,266,619,0.43,267,792,1059,90,51,177,107,207,980
2016,DeJuan Blair,C,26,WAS,29,0,218,28,68,0.412,0,1,0,28,67,0.418,5,13,0.385,20,37,57,11,8,2,15,53,61
2016,Delon Wright,PG,23,TOR,27,1,229,36,80,0.45,5,13,0.385,31,67,0.463,26,35,0.743,8,29,37,31,8,3,16,7,103
2016,DeMar DeRozan,SG,26,TOR,78,78,2804,614,1377,0.446,47,139,0.338,567,1238,0.458,555,653,0.85,64,285,349,315,81,21,175,167,1830
2016,DeMarcus Cousins,C,25,SAC,65,65,2246,601,1332,0.451,70,210,0.333,531,1122,0.473,476,663,0.718,158,589,747,214,101,92,249,236,1748
2016,DeMarre Carroll,SF,29,TOR,26,22,786,105,270,0.389,46,118,0.39,59,152,0.388,30,50,0.6,31,91,122,27,44,6,28,63,286
2016,Dennis Schröder,PG,22,ATL,80,6,1621,329,781,0.421,77,239,0.322,252,542,0.465,144,182,0.791,25,179,204,349,70,9,183,138,879
2016,Deron Williams,PG,31,DAL,65,63,2106,321,775,0.414,97,282,0.344,224,493,0.454,179,206,0.869,19,171,190,378,61,14,150,155,918
2016,Derrick Favors,PF,24,UTA,62,59,1983,418,811,0.515,0,4,0,418,807,0.518,180,254,0.709,169,334,503,94,74,91,104,150,1016
2016,Derrick Rose,PG,27,CHI,66,66,2097,447,1048,0.427,44,150,0.293,403,898,0.449,142,179,0.793,46,179,225,311,44,14,175,84,1080
2016,Derrick Williams,SF,24,NYK,80,9,1435,254,565,0.45,44,150,0.293,210,415,0.506,194,256,0.758,47,249,296,75,29,9,61,69,746
2016,Devin Booker,SG,19,PHO,76,51,2108,367,867,0.423,99,289,0.343,268,578,0.464,215,256,0.84,27,160,187,200,44,20,160,225,1048
2016,Devin Harris,PG,32,DAL,64,0,1280,167,374,0.447,52,158,0.329,115,216,0.532,101,140,0.721,18,120,138,118,60,13,66,124,487
2016,Devyn Marble,SG,23,ORL,28,0,249,21,71,0.296,8,32,0.25,13,39,0.333,10,24,0.417,6,32,38,12,13,1,7,25,60
2016,Dewayne Dedmon,C,26,ORL,58,20,705,99,177,0.559,0,0,,99,177,0.559,57,76,0.75,67,161,228,13,22,46,32,109,255
2016,Dion Waiters,SG,24,OKC,78,15,2152,282,706,0.399,86,240,0.358,196,466,0.421,112,157,0.713,36,166,202,154,81,15,120,143,762
2016,Dirk Nowitzki,PF,37,DAL,75,75,2364,498,1112,0.448,126,342,0.368,372,770,0.483,250,280,0.893,52,437,489,132,52,52,84,161,1372
2016,Donald Sloan,PG,28,BRK,61,33,1318,154,350,0.44,38,99,0.384,116,251,0.462,78,104,0.75,17,156,173,268,32,4,80,73,424
2016,Donatas Motiejūnas,PF,25,HOU,37,22,547,90,205,0.439,16,57,0.281,74,148,0.5,34,53,0.642,37,72,109,41,17,5,44,69,230
2016,Doug McDermott,SF,24,CHI,81,4,1861,291,644,0.452,110,259,0.425,181,385,0.47,72,84,0.857,37,158,195,59,14,6,53,127,764
2016,Draymond Green,PF,25,GSW,81,81,2808,401,819,0.49,100,258,0.388,301,561,0.537,229,329,0.696,134,635,769,598,119,113,259,240,1131
2016,Drew Gooden,PF,34,WAS,30,0,305,33,103,0.32,7,41,0.171,26,62,0.419,9,14,0.643,28,57,85,13,8,11,13,40,82
2016,Duje Dukan,SF,24,SAC,1,0,24,2,10,0.2,2,5,0.4,0,5,0,0,0,,2,2,4,1,1,0,0,2,6
2016,Dwight Howard,C,30,HOU,71,71,2280,372,600,0.62,0,6,0,372,594,0.626,232,474,0.489,238,597,835,98,69,113,166,219,976
2016,Dwight Powell,PF,24,DAL,69,2,992,146,296,0.493,2,16,0.125,144,280,0.514,105,142,0.739,84,189,273,44,36,24,40,118,399
2016,Dwyane Wade,SG,34,MIA,74,73,2258,540,1183,0.456,7,44,0.159,533,1139,0.468,322,406,0.793,82,220,302,344,79,42,203,116,1409
2016,E'Twaun Moore,SG,26,CHI,59,22,1263,187,389,0.481,47,104,0.452,140,285,0.491,22,35,0.629,19,114,133,99,37,18,53,103,443
2016,Ed Davis,PF,26,POR,81,0,1684,206,337,0.611,0,0,,206,337,0.611,114,204,0.559,224,375,599,88,57,72,64,202,526
2016,Edy Tavares,C,23,ATL,11,0,73,11,19,0.579,0,0,,11,19,0.579,3,8,0.375,7,14,21,3,1,6,5,8,25
2016,Elfrid Payton,PG,21,ORL,73,69,2145,318,730,0.436,30,92,0.326,288,638,0.451,112,190,0.589,77,184,261,468,89,20,177,159,778
2016,Elijah Millsap,SG,28,UTA,20,0,173,11,39,0.282,1,12,0.083,10,27,0.37,13,18,0.722,6,29,35,19,7,3,9,33,36
2016,Elliot Williams,PG,26,MEM,5,0,45,2,10,0.2,1,4,0.25,1,6,0.167,3,4,0.75,1,3,4,4,0,0,1,2,8
2016,Elton Brand,C,36,PHI,17,1,225,31,72,0.431,0,1,0,31,71,0.437,8,9,0.889,9,54,63,18,9,8,11,32,70
2016,Emmanuel Mudiay,PG,19,DEN,68,66,2068,329,905,0.364,74,232,0.319,255,673,0.379,140,209,0.67,32,200,232,372,65,35,217,141,872
2016,Enes Freedom,C,23,OKC,82,1,1721,414,719,0.576,10,21,0.476,404,698,0.579,200,251,0.797,249,415,664,33,26,33,115,166,1038
2016,Eric Bledsoe,PG,26,PHO,31,31,1059,223,492,0.453,48,129,0.372,175,363,0.482,138,172,0.802,18,107,125,190,63,19,110,75,632
2016,Eric Gordon,SG,27,NOP,45,44,1481,231,552,0.418,113,294,0.384,118,258,0.457,111,125,0.888,10,89,99,121,43,14,73,98,686
2016,Eric Moreland,PF,24,SAC,8,0,48,3,6,0.5,0,0,,3,6,0.5,2,4,0.5,3,8,11,1,0,4,3,4,8
2016,Erick Green,PG,24,TOT,9,0,42,5,13,0.385,1,5,0.2,4,8,0.5,2,2,1,3,3,6,3,1,0,0,4,13
2016,Erick Green,PG,24,DEN,3,0,7,0,1,0,0,1,0,0,0,,0,0,,0,1,1,1,0,0,0,0,0
2016,Erick Green,PG,24,UTA,6,0,35,5,12,0.417,1,4,0.25,4,8,0.5,2,2,1,3,2,5,2,1,0,0,4,13
2016,Ersan İlyasova,PF,28,TOT,74,56,1881,280,661,0.424,96,259,0.371,184,402,0.458,111,154,0.721,144,259,403,67,52,33,71,171,767
2016,Ersan İlyasova,PF,28,DET,52,52,1434,216,508,0.425,78,215,0.363,138,293,0.471,79,109,0.725,99,183,282,55,38,27,59,120,589
2016,Ersan İlyasova,PF,28,ORL,22,4,447,64,153,0.418,18,44,0.409,46,109,0.422,32,45,0.711,45,76,121,12,14,6,12,51,178
2016,Evan Fournier,SF,23,ORL,79,71,2566,429,929,0.462,156,390,0.4,273,539,0.506,199,238,0.836,33,192,225,213,96,2,133,214,1213
2016,Evan Turner,SG,27,BOS,81,12,2271,343,753,0.456,20,83,0.241,323,670,0.482,148,179,0.827,50,347,397,359,80,28,169,139,854
2016,Festus Ezeli,C,26,GSW,46,13,770,125,228,0.548,0,0,,125,228,0.548,70,132,0.53,91,166,257,32,18,50,38,94,320
2016,Frank Kaminsky,C,22,CHO,81,3,1708,215,525,0.41,68,202,0.337,147,323,0.455,108,148,0.73,69,266,335,98,38,43,58,126,606
2016,Garrett Temple,SF,29,WAS,80,43,1951,201,505,0.398,89,258,0.345,112,247,0.453,91,125,0.728,36,176,212,140,69,18,64,195,582
2016,Gary Harris,SG,21,DEN,76,76,2439,359,765,0.469,105,297,0.354,254,468,0.543,109,133,0.82,54,166,220,147,97,18,98,143,932
2016,Gary Neal,SG,31,WAS,40,2,807,151,325,0.465,41,100,0.41,110,225,0.489,47,55,0.855,11,72,83,47,20,1,29,55,390
2016,George Hill,PG,29,IND,74,73,2524,326,739,0.441,128,314,0.408,198,425,0.466,114,150,0.76,58,240,298,259,83,17,101,149,894
2016,Gerald Green,SG,30,MIA,69,14,1557,230,587,0.392,84,260,0.323,146,327,0.446,72,92,0.783,25,138,163,56,38,19,46,123,616
2016,Gerald Henderson,SG,28,POR,72,0,1431,232,529,0.439,48,136,0.353,184,393,0.468,112,146,0.767,30,181,211,75,39,19,68,87,624
2016,Giannis Antetokounmpo,PG,21,MIL,80,79,2823,513,1013,0.506,28,109,0.257,485,904,0.537,296,409,0.724,113,499,612,345,94,113,208,258,1350
2016,Glenn Robinson III,SF,22,IND,45,4,508,65,151,0.43,14,37,0.378,51,114,0.447,27,39,0.692,12,56,68,26,17,9,18,21,171
2016,Goran Dragić,PG,29,MIA,72,72,2363,417,875,0.477,64,205,0.312,353,670,0.527,120,165,0.727,54,223,277,419,71,17,185,188,1018
2016,Gordon Hayward,SF,25,UTA,80,80,2893,521,1202,0.433,143,410,0.349,378,792,0.477,393,477,0.824,61,336,397,296,95,27,202,183,1578
2016,Gorgui Dieng,C,26,MIN,82,39,2220,308,579,0.532,6,20,0.3,302,559,0.54,205,248,0.827,157,428,585,143,94,96,140,219,827
2016,Greg Monroe,C,25,MIL,79,67,2314,491,941,0.522,0,1,0,491,940,0.522,228,308,0.74,218,478,696,178,72,67,129,163,1210
2016,Greg Smith,PF,25,MIN,18,0,192,18,32,0.563,0,0,,18,32,0.563,7,17,0.412,12,30,42,6,4,1,7,28,43
2016,Greivis Vásquez,PG,29,MIL,23,0,460,45,138,0.326,18,73,0.247,27,65,0.415,22,26,0.846,5,42,47,91,10,0,40,42,130
2016,Harrison Barnes,SF,23,GSW,66,59,2042,295,633,0.466,82,214,0.383,213,419,0.508,102,134,0.761,77,248,325,117,41,10,57,136,774
2016,Hassan Whiteside,C,26,MIA,73,43,2125,413,682,0.606,0,0,,413,682,0.606,214,329,0.65,238,627,865,30,44,269,137,201,1040
2016,Henry Sims,C,25,BRK,14,4,263,33,77,0.429,0,0,,33,77,0.429,25,30,0.833,21,51,72,9,9,14,12,37,91
2016,Hollis Thompson,SG,24,PHI,77,17,2154,270,680,0.397,149,392,0.38,121,288,0.42,69,96,0.719,54,218,272,99,36,24,76,187,758
2016,Ian Clark,SG,24,GSW,66,1,578,89,202,0.441,30,84,0.357,59,118,0.5,28,34,0.824,13,55,68,64,17,13,43,58,236
2016,Ian Mahinmi,C,29,IND,71,71,1816,264,448,0.589,0,0,,264,448,0.589,132,225,0.587,138,369,507,104,65,75,100,220,660
2016,Iman Shumpert,SG,25,CLE,54,5,1316,114,305,0.374,43,146,0.295,71,159,0.447,40,51,0.784,32,171,203,92,54,19,57,119,311
2016,Isaiah Canaan,SG,24,PHI,77,39,1966,260,722,0.36,176,485,0.363,84,237,0.354,150,180,0.833,20,154,174,137,56,12,91,133,846
2016,Isaiah Thomas,PG,26,BOS,82,79,2644,591,1382,0.428,167,465,0.359,424,917,0.462,474,544,0.871,46,197,243,509,91,9,220,167,1823
2016,Ish Smith,PG,27,TOT,77,53,2239,397,967,0.411,56,170,0.329,341,797,0.428,122,176,0.693,43,262,305,502,88,24,175,133,972
2016,Ish Smith,PG,27,NOP,27,3,617,98,228,0.43,10,33,0.303,88,195,0.451,33,43,0.767,14,78,92,154,24,6,45,38,239
2016,Ish Smith,PG,27,PHI,50,50,1622,299,739,0.405,46,137,0.336,253,602,0.42,89,133,0.669,29,184,213,348,64,18,130,95,733
2016,J.J. Barea,PG,31,DAL,74,16,1667,317,711,0.446,100,260,0.385,217,451,0.481,74,96,0.771,26,126,152,302,26,2,113,110,808
2016,J.J. Hickson,C,27,TOT,35,9,436,80,155,0.516,0,1,0,80,154,0.519,46,103,0.447,39,93,132,23,15,14,25,47,206
2016,J.J. Hickson,C,27,DEN,20,9,305,55,109,0.505,0,0,,55,109,0.505,27,59,0.458,22,65,87,16,10,12,16,35,137
2016,J.J. Hickson,C,27,WAS,15,0,131,25,46,0.543,0,1,0,25,45,0.556,19,44,0.432,17,28,45,7,5,2,9,12,69
2016,J.J. O'Brien,SF,23,UTA,2,0,6,0,1,0,0,0,,0,1,0,0,0,,0,1,1,0,1,0,0,1,0
2016,J.J. Redick,SG,31,LAC,75,75,2097,422,880,0.48,200,421,0.475,222,459,0.484,182,205,0.888,10,129,139,106,42,5,78,135,1226
2016,J.R. Smith,SG,30,CLE,77,77,2362,353,850,0.415,204,510,0.4,149,340,0.438,45,71,0.634,43,174,217,130,81,21,59,204,955
2016,Jabari Parker,PF,20,MIL,76,72,2408,443,899,0.493,9,35,0.257,434,864,0.502,175,228,0.768,123,272,395,130,69,29,116,154,1070
2016,Jae Crowder,SF,25,BOS,73,73,2308,360,813,0.443,122,363,0.336,238,450,0.529,196,239,0.82,70,303,373,135,126,35,83,198,1038
2016,Jahlil Okafor,C,20,PHI,53,48,1591,397,781,0.508,1,6,0.167,396,775,0.511,133,194,0.686,122,251,373,65,22,61,124,140,928
2016,JaKarr Sampson,SF,22,TOT,73,40,1160,140,317,0.442,14,63,0.222,126,254,0.496,80,122,0.656,46,144,190,46,23,33,70,142,374
2016,JaKarr Sampson,SF,22,PHI,47,18,691,86,202,0.426,6,34,0.176,80,168,0.476,62,97,0.639,30,99,129,30,11,16,51,91,240
2016,JaKarr Sampson,SF,22,DEN,26,22,469,54,115,0.47,8,29,0.276,46,86,0.535,18,25,0.72,16,45,61,16,12,17,19,51,134
2016,Jamal Crawford,SG,35,LAC,79,5,2126,379,939,0.404,117,344,0.34,262,595,0.44,245,271,0.904,20,125,145,183,52,12,113,122,1120
2016,Jameer Nelson,PG,33,DEN,39,15,1036,113,307,0.368,43,144,0.299,70,163,0.429,30,35,0.857,19,96,115,190,25,5,66,100,299
2016,James Anderson,SG,26,SAC,51,15,721,67,178,0.376,23,86,0.267,44,92,0.478,22,29,0.759,13,73,86,41,21,14,42,54,179
2016,James Ennis III,SF,25,TOT,22,5,329,54,113,0.478,26,58,0.448,28,55,0.509,25,34,0.735,21,21,42,21,16,5,19,28,159
2016,James Ennis III,SF,25,MIA,3,0,7,0,0,,0,0,,0,0,,0,0,,0,0,0,1,0,0,0,1,0
2016,James Ennis III,SF,25,MEM,10,0,40,4,13,0.308,2,8,0.25,2,5,0.4,6,10,0.6,4,3,7,2,4,2,2,1,16
2016,James Ennis III,SF,25,NOP,9,5,282,50,100,0.5,24,50,0.48,26,50,0.52,19,24,0.792,17,18,35,18,12,3,17,26,143
2016,James Harden,SG,26,HOU,82,82,3125,710,1617,0.439,236,657,0.359,474,960,0.494,720,837,0.86,63,438,501,612,139,51,374,229,2376
2016,James Johnson,PF,28,TOR,57,32,926,114,240,0.475,20,66,0.303,94,174,0.54,39,68,0.574,28,98,126,67,29,33,54,84,287
2016,James Jones,SF,35,CLE,48,0,463,58,142,0.408,41,104,0.394,17,38,0.447,21,26,0.808,8,42,50,14,11,10,13,50,178
2016,James Michael McAdoo,PF,23,GSW,41,1,262,45,84,0.536,1,2,0.5,44,82,0.537,26,49,0.531,30,28,58,17,10,8,16,39,117
2016,James Young,SG,20,BOS,29,0,199,11,36,0.306,6,26,0.231,5,10,0.5,1,4,0.25,4,22,26,9,6,1,5,17,29
2016,JaMychal Green,PF,25,MEM,78,15,1446,230,495,0.465,15,45,0.333,215,450,0.478,103,137,0.752,139,234,373,67,46,33,83,189,578
2016,Jared Cunningham,SG,24,TOT,44,3,410,36,105,0.343,12,39,0.308,24,66,0.364,36,55,0.655,3,35,38,20,14,2,21,41,120
2016,Jared Cunningham,SG,24,CLE,40,3,355,32,91,0.352,10,32,0.313,22,59,0.373,30,48,0.625,3,26,29,19,12,2,18,37,104
2016,Jared Cunningham,SG,24,MIL,4,0,55,4,14,0.286,2,7,0.286,2,7,0.286,6,7,0.857,0,9,9,1,2,0,3,4,16
2016,Jared Dudley,PF,30,WAS,81,41,2098,233,487,0.478,100,238,0.42,133,249,0.534,72,98,0.735,54,232,286,170,75,18,80,190,638
2016,Jared Sullinger,PF,23,BOS,81,73,1915,351,806,0.435,29,103,0.282,322,703,0.458,103,161,0.64,194,479,673,187,75,47,102,209,834
2016,Jarell Eddie,SF,24,WAS,26,0,147,20,65,0.308,15,47,0.319,5,18,0.278,8,8,1,2,21,23,5,5,1,1,5,63
2016,Jarell Martin,PF,21,MEM,27,0,380,54,116,0.466,0,2,0,54,114,0.474,45,62,0.726,39,47,86,15,8,7,19,58,153
2016,Jarnell Stokes,C,22,TOT,7,0,18,3,5,0.6,0,0,,3,5,0.6,1,2,0.5,1,3,4,1,1,0,0,1,7
2016,Jarnell Stokes,C,22,MEM,2,0,4,0,0,,0,0,,0,0,,0,0,,1,1,2,0,0,0,0,0,0
2016,Jarnell Stokes,C,22,MIA,5,0,14,3,5,0.6,0,0,,3,5,0.6,1,2,0.5,0,2,2,1,1,0,0,1,7
2016,Jarrett Jack,PG,32,BRK,32,32,1027,140,358,0.391,31,102,0.304,109,256,0.426,100,112,0.893,9,127,136,236,34,7,94,77,411
2016,Jason Smith,C,29,ORL,76,2,1181,244,503,0.485,4,16,0.25,240,487,0.493,54,67,0.806,53,166,219,62,33,65,57,163,546
2016,Jason Terry,SG,38,HOU,72,7,1258,151,376,0.402,93,261,0.356,58,115,0.504,27,33,0.818,14,65,79,103,47,9,49,91,422
2016,Jason Thompson,C,29,TOT,47,7,471,52,108,0.481,5,15,0.333,47,93,0.505,38,54,0.704,32,102,134,29,12,20,15,80,147
2016,Jason Thompson,C,29,GSW,28,1,179,20,42,0.476,0,0,,20,42,0.476,20,32,0.625,10,44,54,19,4,8,7,40,60
2016,Jason Thompson,C,29,TOR,19,6,292,32,66,0.485,5,15,0.333,27,51,0.529,18,22,0.818,22,58,80,10,8,12,8,40,87
2016,JaVale McGee,C,28,DAL,34,2,370,77,134,0.575,0,1,0,77,133,0.579,18,36,0.5,53,80,133,3,5,26,21,49,172
2016,Jeff Ayres,C,28,LAC,17,0,107,12,23,0.522,0,1,0,12,22,0.545,6,6,1,4,18,22,5,0,3,6,18,30
2016,Jeff Green,SF,29,TOT,80,41,2253,354,824,0.43,67,213,0.315,287,611,0.47,164,220,0.745,74,258,332,138,58,40,93,164,939
2016,Jeff Green,SF,29,MEM,53,31,1544,240,557,0.431,42,136,0.309,198,421,0.47,124,155,0.8,55,186,241,98,40,19,69,102,646
2016,Jeff Green,SF,29,LAC,27,10,709,114,267,0.427,25,77,0.325,89,190,0.468,40,65,0.615,19,72,91,40,18,21,24,62,293
2016,Jeff Teague,PG,27,ATL,79,78,2255,434,988,0.439,110,275,0.4,324,713,0.454,261,312,0.837,33,181,214,470,97,24,218,167,1239
2016,Jeff Withey,C,25,UTA,51,10,658,87,162,0.537,0,2,0,87,160,0.544,43,59,0.729,56,117,173,20,21,53,28,75,217
2016,Jerami Grant,PF,21,PHI,77,52,2066,251,599,0.419,35,146,0.24,216,453,0.477,212,322,0.658,99,262,361,135,54,127,110,215,749
2016,Jeremy Evans,SF,28,DAL,30,2,251,26,48,0.542,4,16,0.25,22,32,0.688,15,21,0.714,11,43,54,2,6,9,7,19,71
2016,Jeremy Lamb,SG,23,CHO,66,0,1227,230,510,0.451,56,181,0.309,174,329,0.529,64,88,0.727,44,208,252,77,42,30,50,105,580
2016,Jeremy Lin,SG,27,CHO,78,13,2048,300,728,0.412,76,226,0.336,224,502,0.446,238,292,0.815,42,211,253,235,58,42,150,165,914
2016,Jerian Grant,PG,23,NYK,76,6,1265,154,391,0.394,22,100,0.22,132,291,0.454,96,123,0.78,23,120,143,177,50,10,87,97,426
2016,Jerryd Bayless,SG,27,MIL,52,18,1505,185,437,0.423,101,231,0.437,84,206,0.408,70,90,0.778,21,120,141,163,47,11,73,111,541
2016,Jimmer Fredette,SG,26,TOT,6,0,18,2,5,0.4,1,2,0.5,1,3,0.333,4,5,0.8,0,0,0,1,1,0,2,2,9
2016,Jimmer Fredette,SG,26,NOP,4,0,13,1,4,0.25,0,1,0,1,3,0.333,0,0,,0,0,0,1,1,0,1,1,2
2016,Jimmer Fredette,SG,26,NYK,2,0,5,1,1,1,1,1,1,0,0,,4,5,0.8,0,0,0,0,0,0,1,1,7
2016,Jimmy Butler,SG,26,CHI,67,67,2474,470,1035,0.454,64,205,0.312,406,830,0.489,395,475,0.832,79,279,358,321,110,43,132,124,1399
2016,Joakim Noah,C,30,CHI,29,2,635,51,133,0.383,0,1,0,51,132,0.386,22,45,0.489,87,168,255,110,18,29,52,77,124
2016,Jodie Meeks,SG,28,DET,3,0,43,7,20,0.35,4,9,0.444,3,11,0.273,4,4,1,1,4,5,3,0,0,1,2,22
2016,Joe Harris,SG,24,CLE,5,0,15,1,4,0.25,1,4,0.25,0,0,,0,0,,0,3,3,2,0,0,1,1,3
2016,Joe Ingles,SF,28,UTA,81,2,1241,124,291,0.426,81,210,0.386,43,81,0.531,13,18,0.722,19,132,151,96,55,4,65,98,342
2016,Joe Johnson,SF,34,TOT,81,81,2703,377,859,0.439,120,313,0.383,257,546,0.471,118,142,0.831,49,243,292,318,61,4,159,146,992
2016,Joe Johnson,SF,34,BRK,57,57,1934,247,608,0.406,85,229,0.371,162,379,0.427,92,108,0.852,34,190,224,232,40,2,116,100,671
2016,Joe Johnson,SF,34,MIA,24,24,769,130,251,0.518,35,84,0.417,95,167,0.569,26,34,0.765,15,53,68,86,21,2,43,46,321
2016,Joe Young,PG,23,IND,41,0,384,62,169,0.367,10,46,0.217,52,123,0.423,20,25,0.8,6,44,50,65,15,0,33,30,154
2016,Joel Anthony,C,33,DET,19,0,96,6,10,0.6,0,0,,6,10,0.6,6,8,0.75,8,13,21,1,2,12,2,15,18
2016,Joffrey Lauvergne,C,24,DEN,59,15,1041,195,380,0.513,13,53,0.245,182,327,0.557,62,69,0.899,77,213,290,56,13,15,54,115,465
2016,John Henson,C,25,MIL,57,1,960,164,291,0.564,0,1,0,164,290,0.566,69,117,0.59,87,134,221,54,18,109,64,131,397
2016,John Jenkins,SG,24,TOT,43,3,480,71,160,0.444,16,51,0.314,55,109,0.505,20,24,0.833,8,49,57,35,8,1,27,22,178
2016,John Jenkins,SG,24,DAL,21,1,193,29,70,0.414,3,19,0.158,26,51,0.51,8,9,0.889,4,18,22,9,3,0,11,11,69
2016,John Jenkins,SG,24,PHO,22,2,287,42,90,0.467,13,32,0.406,29,58,0.5,12,15,0.8,4,31,35,26,5,1,16,11,109
2016,John Wall,PG,25,WAS,77,77,2784,572,1349,0.424,115,328,0.351,457,1021,0.448,272,344,0.791,42,337,379,789,145,59,318,159,1531
2016,Johnny O'Bryant,PF,22,MIL,66,4,857,86,209,0.411,1,1,1,85,208,0.409,27,40,0.675,65,111,176,32,18,8,31,100,200
2016,Jon Leuer,PF,26,PHO,67,27,1255,224,466,0.481,42,110,0.382,182,356,0.511,77,101,0.762,76,297,373,72,38,30,75,125,567
2016,Jonas Jerebko,PF,28,BOS,78,0,1176,118,286,0.413,43,108,0.398,75,178,0.421,61,78,0.782,77,211,288,62,20,24,52,137,340
2016,Jonas Valančiūnas,C,23,TOR,60,59,1557,303,536,0.565,0,0,,303,536,0.565,162,213,0.761,184,363,547,42,25,80,85,158,768
2016,Jonathon Simmons,SG,26,SAS,55,2,813,122,242,0.504,18,47,0.383,104,195,0.533,69,92,0.75,16,80,96,58,24,5,53,103,331
2016,Jordan Adams,SG,21,MEM,2,0,15,2,6,0.333,0,1,0,2,5,0.4,3,5,0.6,0,2,2,3,3,0,2,2,7
2016,Jordan Clarkson,SG,23,LAL,79,79,2552,475,1098,0.433,111,320,0.347,364,778,0.468,164,204,0.804,93,220,313,192,88,7,135,168,1225
2016,Jordan Farmar,PG,29,MEM,12,10,291,42,100,0.42,16,45,0.356,26,55,0.473,10,10,1,4,21,25,37,15,2,18,22,110
2016,Jordan Hamilton,SF,25,NOP,11,4,304,49,116,0.422,13,45,0.289,36,71,0.507,14,21,0.667,12,50,62,25,8,3,17,24,125
2016,Jordan Hill,C,28,IND,73,11,1513,278,549,0.506,0,1,0,278,548,0.507,89,125,0.712,156,295,451,87,36,37,92,155,645
2016,Jordan McRae,PG,24,TOT,22,1,195,34,78,0.436,10,22,0.455,24,56,0.429,21,28,0.75,4,16,20,25,3,1,15,17,99
2016,Jordan McRae,PG,24,PHO,7,0,82,11,26,0.423,3,11,0.273,8,15,0.533,12,15,0.8,2,6,8,10,3,0,6,7,37
2016,Jordan McRae,PG,24,CLE,15,1,113,23,52,0.442,7,11,0.636,16,41,0.39,9,13,0.692,2,10,12,15,0,1,9,10,62
2016,Jordan Mickey,PF,21,BOS,16,0,57,8,22,0.364,0,0,,8,22,0.364,5,10,0.5,6,7,13,1,0,11,1,5,21
2016,Jorge Gutiérrez,PG,27,CHO,12,0,63,6,11,0.545,0,2,0,6,9,0.667,10,11,0.909,0,7,7,17,3,0,6,3,22
2016,José Calderón,PG,34,NYK,72,72,2024,209,455,0.459,84,203,0.414,125,252,0.496,42,48,0.875,22,207,229,298,63,7,87,135,544
2016,Josh Huestis,PF,24,OKC,5,0,55,5,12,0.417,4,6,0.667,1,6,0.167,0,4,0,2,8,10,0,1,2,3,3,14
2016,Josh McRoberts,PF,28,MIA,42,1,595,55,148,0.372,12,49,0.245,43,99,0.434,28,40,0.7,22,83,105,81,18,7,30,68,150
2016,Josh Richardson,SG,22,MIA,52,2,1107,123,272,0.452,53,115,0.461,70,157,0.446,42,63,0.667,21,86,107,73,36,25,35,107,341
2016,Josh Smith,PF,30,TOT,55,7,880,127,349,0.364,41,143,0.287,86,206,0.417,37,67,0.552,51,141,192,90,34,47,77,118,332
2016,Josh Smith,PF,30,LAC,32,1,459,69,180,0.383,18,58,0.31,51,122,0.418,25,42,0.595,33,92,125,42,18,34,41,62,181
2016,Josh Smith,PF,30,HOU,23,6,421,58,169,0.343,23,85,0.271,35,84,0.417,12,25,0.48,18,49,67,48,16,13,36,56,151
2016,Jrue Holiday,PG,25,NOP,65,23,1831,410,935,0.439,87,259,0.336,323,676,0.478,182,216,0.843,27,168,195,391,88,22,167,148,1089
2016,Julius Randle,PF,21,LAL,81,60,2286,358,835,0.429,10,36,0.278,348,799,0.436,193,270,0.715,172,657,829,144,53,29,149,242,919
2016,Justin Anderson,SF,22,DAL,55,9,647,71,175,0.406,22,83,0.265,49,92,0.533,44,55,0.8,18,114,132,29,19,25,24,45,208
2016,Justin Harper,PF,26,DET,5,0,35,4,10,0.4,4,9,0.444,0,1,0,1,2,0.5,0,1,1,0,1,0,2,3,13
2016,Justin Holiday,SG,26,TOT,53,5,773,88,228,0.386,36,105,0.343,52,123,0.423,27,37,0.73,12,78,90,56,32,19,39,61,239
2016,Justin Holiday,SG,26,ATL,26,1,263,24,73,0.329,10,45,0.222,14,28,0.5,5,10,0.5,4,23,27,11,13,4,13,21,63
2016,Justin Holiday,SG,26,CHI,27,4,510,64,155,0.413,26,60,0.433,38,95,0.4,22,27,0.815,8,55,63,45,19,15,26,40,176
2016,Justise Winslow,SF,19,MIA,78,8,2232,195,462,0.422,32,116,0.276,163,346,0.471,80,117,0.684,81,322,403,117,68,26,95,184,502
2016,Jusuf Nurkić,C,21,DEN,32,3,547,101,242,0.417,0,3,0,101,239,0.423,61,99,0.616,65,110,175,40,24,44,55,91,263
2016,K.J. McDaniels,SF,22,HOU,37,1,235,29,72,0.403,7,25,0.28,22,47,0.468,24,30,0.8,16,26,42,10,7,6,17,30,89
2016,Karl-Anthony Towns,C,20,MIN,82,82,2627,625,1153,0.542,30,88,0.341,595,1065,0.559,223,275,0.811,229,629,858,161,58,138,183,245,1503
2016,Kawhi Leonard,SF,24,SAS,72,72,2380,551,1090,0.506,129,291,0.443,422,799,0.528,292,334,0.874,95,398,493,186,128,71,105,133,1523
2016,Keith Appling,PG,23,ORL,5,0,27,2,8,0.25,0,3,0,2,5,0.4,2,2,1,0,1,1,1,1,0,3,5,6
2016,Kelly Olynyk,C,24,BOS,69,8,1395,253,556,0.455,85,210,0.405,168,346,0.486,96,128,0.75,72,209,281,105,52,33,74,163,687
2016,Kelly Oubre Jr.,SF,20,WAS,63,9,671,90,211,0.427,25,79,0.316,65,132,0.492,31,49,0.633,25,108,133,13,22,7,34,100,236
2016,Kemba Walker,PG,25,CHO,81,81,2885,568,1331,0.427,182,490,0.371,386,841,0.459,371,438,0.847,56,301,357,421,126,39,171,111,1689
2016,Kendall Marshall,PG,24,PHI,30,6,400,43,118,0.364,16,49,0.327,27,69,0.391,9,13,0.692,2,26,28,73,16,2,43,30,111
2016,Kendrick Perkins,C,31,NOP,37,5,542,40,75,0.533,0,0,,40,75,0.533,11,25,0.44,25,103,128,31,11,11,41,64,91
2016,Kenneth Faried,PF,26,DEN,67,64,1694,349,626,0.558,1,2,0.5,348,624,0.558,136,222,0.613,235,346,581,79,32,60,91,169,835
2016,Kent Bazemore,SF,26,ATL,75,68,2083,320,725,0.441,109,305,0.357,211,420,0.502,123,151,0.815,28,351,379,171,98,38,138,176,872
2016,Kentavious Caldwell-Pope,SG,22,DET,76,76,2789,403,960,0.42,114,369,0.309,289,591,0.489,185,228,0.811,70,212,282,138,110,17,105,167,1105
2016,Kevin Durant,SF,27,OKC,72,72,2578,698,1381,0.505,186,481,0.387,512,900,0.569,447,498,0.898,45,544,589,361,69,85,250,137,2029
2016,Kevin Garnett*,PF,39,MIN,38,38,556,54,115,0.47,0,1,0,54,114,0.474,14,21,0.667,15,135,150,62,28,10,16,70,122
2016,Kevin Love,PF,27,CLE,77,77,2424,409,977,0.419,158,439,0.36,251,538,0.467,258,314,0.822,149,613,762,186,58,41,142,159,1234
2016,Kevin Martin,SG,32,TOT,55,13,1095,156,419,0.372,49,136,0.36,107,283,0.378,153,172,0.89,14,96,110,58,26,3,54,83,514
2016,Kevin Martin,SG,32,MIN,39,12,834,126,334,0.377,38,103,0.369,88,231,0.381,125,142,0.88,10,71,81,46,17,1,41,68,415
2016,Kevin Martin,SG,32,SAS,16,1,261,30,85,0.353,11,33,0.333,19,52,0.365,28,30,0.933,4,25,29,12,9,2,13,15,99
2016,Kevin Séraphin,C,26,NYK,48,0,526,84,205,0.41,0,2,0,84,203,0.414,19,23,0.826,31,95,126,47,8,36,43,67,187
2016,Kevon Looney,PF,19,GSW,5,0,21,4,7,0.571,1,2,0.5,3,5,0.6,0,0,,4,6,10,0,0,0,1,2,9
2016,Khris Middleton,SG,24,MIL,79,79,2852,507,1142,0.444,143,361,0.396,364,781,0.466,277,312,0.888,44,258,302,331,131,19,180,204,1434
2016,Kirk Hinrich,PG,35,TOT,46,7,631,49,129,0.38,24,62,0.387,25,67,0.373,15,16,0.938,8,62,70,73,15,2,30,64,137
2016,Kirk Hinrich,PG,35,CHI,35,7,555,47,118,0.398,23,56,0.411,24,62,0.387,15,16,0.938,7,51,58,59,13,1,27,63,132
2016,Kirk Hinrich,PG,35,ATL,11,0,76,2,11,0.182,1,6,0.167,1,5,0.2,0,0,,1,11,12,14,2,1,3,1,5
2016,Klay Thompson,SG,25,GSW,80,80,2666,651,1386,0.47,276,650,0.425,375,736,0.51,193,221,0.873,35,271,306,166,60,49,138,152,1771
2016,Kobe Bryant*,SF,37,LAL,66,66,1863,398,1113,0.358,133,467,0.285,265,646,0.41,232,281,0.826,41,206,247,184,62,13,129,115,1161
2016,Kosta Koufos,C,26,SAC,78,14,1482,236,444,0.532,0,0,,236,444,0.532,57,104,0.548,169,254,423,33,40,70,48,185,529
2016,Kostas Papanikolaou,SF,25,DEN,26,6,294,24,66,0.364,10,32,0.313,14,34,0.412,9,14,0.643,8,32,40,16,13,5,21,24,67
2016,Kris Humphries,PF,30,TOT,53,17,835,121,295,0.41,34,108,0.315,87,187,0.465,67,84,0.798,57,161,218,36,16,23,38,94,343
2016,Kris Humphries,PF,30,WAS,28,14,466,64,158,0.405,23,67,0.343,41,91,0.451,29,31,0.935,26,89,115,16,3,14,20,42,180
2016,Kris Humphries,PF,30,PHO,4,3,74,10,36,0.278,3,10,0.3,7,26,0.269,6,8,0.75,11,21,32,7,3,2,4,8,29
2016,Kris Humphries,PF,30,ATL,21,0,295,47,101,0.465,8,31,0.258,39,70,0.557,32,45,0.711,20,51,71,13,10,7,14,44,134
2016,Kristaps Porziņģis,PF,20,NYK,72,72,2047,373,886,0.421,81,243,0.333,292,643,0.454,201,240,0.838,132,394,526,94,53,134,121,205,1028
2016,Kyle Anderson,SF,22,SAS,78,11,1245,138,295,0.468,12,37,0.324,126,258,0.488,62,83,0.747,25,219,244,123,60,29,59,97,350
2016,Kyle Korver,SG,34,ATL,80,80,2401,268,616,0.435,158,397,0.398,110,219,0.502,45,54,0.833,14,246,260,164,60,35,98,161,739
2016,Kyle Lowry,PG,29,TOR,77,77,2851,512,1198,0.427,212,547,0.388,300,651,0.461,398,491,0.811,55,310,365,494,158,34,225,211,1634
2016,Kyle O'Quinn,PF,25,NYK,65,1,764,129,271,0.476,5,22,0.227,124,249,0.498,46,60,0.767,76,174,250,72,20,49,61,107,309
2016,Kyle Singler,SF,27,OKC,68,2,977,86,221,0.389,30,97,0.309,56,124,0.452,29,44,0.659,50,91,141,24,30,9,32,120,231
2016,Kyrie Irving,PG,23,CLE,53,53,1667,394,879,0.448,84,262,0.321,310,617,0.502,169,191,0.885,44,113,157,249,56,18,124,107,1041
2016,Lamar Patterson,SG,24,ATL,35,0,395,28,80,0.35,12,49,0.245,16,31,0.516,16,22,0.727,4,46,50,39,9,2,23,45,84
2016,LaMarcus Aldridge,PF,30,SAS,74,74,2261,536,1045,0.513,0,16,0,536,1029,0.521,259,302,0.858,176,456,632,110,38,81,99,151,1331
2016,Lance Stephenson,SF,25,TOT,69,13,1372,228,474,0.481,30,78,0.385,198,396,0.5,87,111,0.784,40,183,223,133,43,9,94,135,573
2016,Lance Stephenson,SF,25,LAC,43,10,680,82,166,0.494,19,47,0.404,63,119,0.529,21,30,0.7,19,89,108,60,24,3,48,79,204
2016,Lance Stephenson,SF,25,MEM,26,3,692,146,308,0.474,11,31,0.355,135,277,0.487,66,81,0.815,21,94,115,73,19,6,46,56,369
2016,Lance Thomas,PF,27,NYK,59,5,1313,169,382,0.442,44,109,0.404,125,273,0.458,102,119,0.857,34,97,131,53,22,7,57,109,484
2016,Langston Galloway,PG,24,NYK,82,7,2033,231,588,0.393,77,224,0.344,154,364,0.423,86,114,0.754,43,245,288,207,77,22,61,177,625
2016,Larry Nance Jr.,PF,23,LAL,63,22,1266,158,300,0.527,1,10,0.1,157,290,0.541,32,47,0.681,101,211,312,44,54,23,41,124,349
2016,Lavoy Allen,PF,26,IND,79,28,1599,191,370,0.516,0,0,,191,370,0.516,46,73,0.63,162,262,424,76,26,42,69,147,428
2016,Leandro Barbosa,SG,33,GSW,68,0,1079,171,370,0.462,39,110,0.355,132,260,0.508,52,62,0.839,28,89,117,82,44,10,53,107,433
2016,LeBron James,SF,31,CLE,76,76,2709,737,1416,0.52,87,282,0.309,650,1134,0.573,359,491,0.731,111,454,565,514,104,49,249,143,1920
2016,Lorenzo Brown,PG,25,PHO,8,0,61,8,25,0.32,1,8,0.125,7,17,0.412,3,4,0.75,0,7,7,11,3,1,9,4,20
2016,Lou Amundson,PF,33,NYK,29,0,204,19,53,0.358,0,0,,19,53,0.358,14,27,0.519,23,26,49,12,6,7,15,44,52
2016,Lou Williams,SG,29,LAL,67,35,1907,283,693,0.408,110,320,0.344,173,373,0.464,352,424,0.83,31,138,169,167,62,19,107,107,1028
2016,Luc Mbah a Moute,PF,29,LAC,75,61,1274,94,207,0.454,13,40,0.325,81,167,0.485,30,57,0.526,60,111,171,30,44,19,34,100,231
2016,Lucas Nogueira,C,23,TOR,29,1,225,28,44,0.636,1,3,0.333,27,41,0.659,8,15,0.533,18,28,46,7,12,12,11,29,65
2016,Luis Montero,SG,22,POR,12,0,42,5,19,0.263,1,9,0.111,4,10,0.4,3,4,0.75,0,4,4,1,0,0,4,1,14
2016,Luis Scola,PF,35,TOR,76,76,1636,269,598,0.45,65,161,0.404,204,437,0.467,61,84,0.726,84,276,360,66,46,27,68,178,664
2016,Luke Babbitt,SF,26,NOP,47,13,845,122,289,0.422,44,109,0.404,78,180,0.433,39,50,0.78,25,123,148,53,11,7,23,90,327
2016,Luol Deng,PF,30,MIA,74,73,2394,339,745,0.455,88,256,0.344,251,489,0.513,145,192,0.755,108,335,443,140,74,29,81,122,911
2016,Manu Ginóbili*,SG,38,SAS,58,0,1134,197,435,0.453,70,179,0.391,127,256,0.496,91,112,0.813,26,120,146,177,66,11,99,99,555
2016,Marc Gasol,C,31,MEM,52,52,1791,328,707,0.464,2,3,0.667,326,704,0.463,203,245,0.829,58,304,362,196,50,70,118,141,861
2016,Marcelo Huertas,PG,32,LAL,53,0,869,97,230,0.422,16,61,0.262,81,169,0.479,27,29,0.931,18,72,90,182,26,7,80,76,237
2016,Marcin Gortat,C,31,WAS,75,74,2256,433,764,0.567,0,1,0,433,763,0.567,146,207,0.705,222,519,741,106,47,96,121,193,1012
2016,Marco Belinelli,SG,29,SAC,68,7,1672,245,635,0.386,91,297,0.306,154,338,0.456,115,138,0.833,10,107,117,127,37,2,80,91,696
2016,Marcus Morris,SF,26,DET,80,80,2856,410,945,0.434,108,298,0.362,302,647,0.467,203,271,0.749,91,313,404,201,67,23,140,170,1131
2016,Marcus Smart,PG,21,BOS,61,10,1667,184,529,0.348,61,241,0.253,123,288,0.427,129,166,0.777,76,179,255,185,91,18,80,183,558
2016,Marcus Thornton,SG,28,TOT,61,8,1109,216,542,0.399,91,270,0.337,125,272,0.46,67,79,0.848,38,112,150,85,47,4,51,90,590
2016,Marcus Thornton,SG,28,HOU,47,6,885,174,435,0.4,73,216,0.338,101,219,0.461,51,58,0.879,31,84,115,66,34,3,40,73,472
2016,Marcus Thornton,SG,28,WAS,14,2,224,42,107,0.393,18,54,0.333,24,53,0.453,16,21,0.762,7,28,35,19,13,1,11,17,118
2016,Mario Chalmers,PG,29,TOT,61,7,1373,182,444,0.41,46,149,0.309,136,295,0.461,218,262,0.832,24,133,157,230,88,13,110,181,628
2016,Mario Chalmers,PG,29,MIA,6,0,120,10,32,0.313,1,11,0.091,9,21,0.429,12,13,0.923,1,13,14,19,8,1,9,16,33
2016,Mario Chalmers,PG,29,MEM,55,7,1253,172,412,0.417,45,138,0.326,127,274,0.464,206,249,0.827,23,120,143,211,80,12,101,165,595
2016,Mario Hezonja,SF,20,ORL,79,9,1413,181,418,0.433,67,192,0.349,114,226,0.504,49,54,0.907,28,148,176,109,39,17,97,124,478
2016,Markel Brown,SG,24,BRK,62,6,982,127,322,0.394,38,121,0.314,89,201,0.443,71,94,0.755,23,99,122,91,38,15,54,94,363
2016,Markieff Morris,PF,26,TOT,64,45,1629,305,718,0.425,47,155,0.303,258,563,0.458,108,147,0.735,73,279,352,124,58,34,135,184,765
2016,Markieff Morris,PF,26,PHO,37,24,917,171,431,0.397,22,76,0.289,149,355,0.42,66,92,0.717,43,151,194,87,33,17,90,104,430
2016,Markieff Morris,PF,26,WAS,27,21,712,134,287,0.467,25,79,0.316,109,208,0.524,42,55,0.764,30,128,158,37,25,17,45,80,335
2016,Marreese Speights,C,28,GSW,72,0,832,197,456,0.432,24,62,0.387,173,394,0.439,94,114,0.825,77,162,239,61,19,34,66,117,512
2016,Marvin Williams,PF,29,CHO,81,81,2338,338,747,0.452,152,378,0.402,186,369,0.504,120,144,0.833,127,394,521,110,58,77,62,133,948
2016,Mason Plumlee,C,25,POR,82,82,2084,267,517,0.516,0,4,0,267,513,0.52,215,335,0.642,201,427,628,226,68,85,154,253,749
2016,Matt Barnes,SF,35,MEM,76,45,2190,264,693,0.381,119,370,0.322,145,323,0.449,111,138,0.804,84,336,420,163,78,57,121,234,758
2016,Matt Bonner,C,35,SAS,30,2,206,29,57,0.509,15,34,0.441,14,23,0.609,3,4,0.75,3,24,27,9,6,1,3,16,76
2016,Matthew Dellavedova,PG,25,CLE,76,14,1867,207,511,0.405,98,239,0.41,109,272,0.401,57,66,0.864,33,129,162,337,44,9,116,178,569
2016,Maurice Harkless,SF,22,POR,78,14,1457,195,411,0.474,39,140,0.279,156,271,0.576,69,111,0.622,101,179,280,67,49,35,62,124,498
2016,Metta World Peace,SF,36,LAL,35,5,590,55,177,0.311,26,84,0.31,29,93,0.312,40,57,0.702,19,70,89,27,22,11,15,67,176
2016,Meyers Leonard,PF,23,POR,61,10,1333,195,435,0.448,86,228,0.377,109,207,0.527,35,46,0.761,51,263,314,92,8,18,77,183,511
2016,Michael Beasley,PF,27,HOU,20,0,363,107,205,0.522,3,9,0.333,104,196,0.531,38,49,0.776,29,69,98,16,11,9,24,39,255
2016,Michael Carter-Williams,PG,24,MIL,54,37,1649,251,555,0.452,15,55,0.273,236,500,0.472,106,162,0.654,48,228,276,281,80,41,153,162,623
2016,Michael Kidd-Gilchrist,SF,22,CHO,7,7,205,33,61,0.541,3,7,0.429,30,54,0.556,20,29,0.69,12,33,45,9,3,3,8,9,89
2016,Mike Conley,PG,28,MEM,56,56,1761,294,696,0.422,78,215,0.363,216,481,0.449,191,229,0.834,26,138,164,342,67,16,84,100,857
2016,Mike Dunleavy,SF,35,CHI,31,30,703,77,188,0.41,39,99,0.394,38,89,0.427,29,37,0.784,8,75,83,39,14,10,26,66,222
2016,Mike Miller,SF,35,DEN,47,2,373,22,62,0.355,19,52,0.365,3,10,0.3,0,0,,6,47,53,40,13,4,17,53,63
2016,Mike Muscala,C,24,ATL,60,0,565,76,152,0.5,12,39,0.308,64,113,0.566,31,39,0.795,38,79,117,34,13,27,27,72,195
2016,Mike Scott,PF,27,ATL,75,0,1146,176,376,0.468,62,158,0.392,114,218,0.523,50,63,0.794,53,153,206,78,25,17,42,102,464
2016,Miles Plumlee,C,27,MIL,61,14,870,140,233,0.601,0,0,,140,233,0.601,34,59,0.576,94,138,232,16,21,50,40,73,314
2016,Mirza Teletović,PF,30,PHO,79,1,1686,332,777,0.427,181,460,0.393,151,317,0.476,120,155,0.774,55,247,302,89,32,21,84,159,965
2016,Mitch McGary,PF,23,OKC,20,0,72,11,23,0.478,0,4,0,11,19,0.579,4,10,0.4,4,14,18,3,1,2,7,10,26
2016,Mo Williams,PG,33,CLE,41,14,748,132,302,0.437,36,102,0.353,96,200,0.48,38,42,0.905,6,66,72,98,14,5,57,60,338
2016,Monta Ellis,SG,30,IND,81,81,2734,436,1021,0.427,87,282,0.309,349,739,0.472,162,206,0.786,42,229,271,383,150,37,203,174,1121
2016,Montrezl Harrell,PF,22,HOU,39,1,379,58,90,0.644,0,1,0,58,89,0.652,24,46,0.522,25,40,65,17,11,11,17,48,140
2016,Myles Turner,C,19,IND,60,30,1367,264,530,0.498,3,14,0.214,261,516,0.506,88,121,0.727,68,264,332,41,25,86,67,158,619
2016,Nate Robinson,PG,31,NOP,2,1,23,0,1,0,0,1,0,0,0,,0,0,,0,0,0,4,1,0,0,5,0
2016,Nazr Mohammed,C,38,OKC,5,0,19,3,5,0.6,0,0,,3,5,0.6,2,2,1,1,3,4,0,0,0,3,4,8
2016,Nemanja Bjelica,PF,27,MIN,60,0,1075,110,235,0.468,48,125,0.384,62,110,0.564,40,55,0.727,49,161,210,83,26,21,47,154,308
2016,Nenê,PF,33,WAS,57,11,1094,209,384,0.544,0,3,0,209,381,0.549,107,185,0.578,52,207,259,97,54,26,76,156,525
2016,Nerlens Noel,C,21,PHI,67,62,1965,306,587,0.521,1,2,0.5,305,585,0.521,134,227,0.59,154,388,542,122,118,100,158,192,747
2016,Nick Collison,PF,35,OKC,59,4,699,50,109,0.459,0,2,0,50,107,0.467,23,33,0.697,68,103,171,52,15,16,50,107,123
2016,Nick Young,SG,30,LAL,54,2,1033,126,372,0.339,77,237,0.325,49,135,0.363,63,76,0.829,14,83,97,34,23,7,30,50,392
2016,Nicolas Batum,SF,27,CHO,70,70,2448,372,873,0.426,139,399,0.348,233,474,0.492,163,192,0.849,55,373,428,403,65,43,205,114,1046
2016,Nik Stauskas,SG,22,PHI,73,35,1809,210,545,0.385,106,325,0.326,104,220,0.473,91,118,0.771,23,160,183,138,44,20,94,115,617
2016,Nikola Jokić,C,20,DEN,80,55,1733,307,600,0.512,28,84,0.333,279,516,0.541,154,190,0.811,181,379,560,189,79,50,104,208,796
2016,Nikola Mirotić,PF,24,CHI,66,38,1646,248,609,0.407,135,346,0.39,113,263,0.43,146,181,0.807,58,304,362,100,58,46,102,151,777
2016,Nikola Peković,C,30,MIN,12,3,156,19,50,0.38,0,0,,19,50,0.38,16,20,0.8,7,14,21,11,1,0,9,22,54
2016,Nikola Vučević,C,25,ORL,65,60,2037,533,1046,0.51,2,9,0.222,531,1037,0.512,113,150,0.753,174,402,576,179,53,70,123,173,1181
2016,Noah Vonleh,PF,20,POR,78,56,1174,117,278,0.421,11,46,0.239,106,232,0.457,38,51,0.745,91,214,305,30,27,26,50,152,283
2016,Norman Powell,SG,22,TOR,49,24,725,97,229,0.424,36,89,0.404,61,140,0.436,43,53,0.811,16,95,111,47,29,10,32,59,273
2016,Norris Cole,PG,27,NOP,45,23,1198,196,484,0.405,33,102,0.324,163,382,0.427,52,65,0.8,10,141,151,167,37,5,75,102,477
2016,O.J. Mayo,SG,28,MIL,41,24,1090,119,321,0.371,52,162,0.321,67,159,0.421,31,40,0.775,13,92,105,118,48,8,72,126,321
2016,Ömer Aşık,C,29,NOP,68,64,1178,104,195,0.533,0,0,,104,195,0.533,61,112,0.545,120,294,414,26,21,23,60,124,269
2016,Omri Casspi,PF,27,SAC,69,21,1880,299,622,0.481,112,274,0.409,187,348,0.537,103,159,0.648,58,352,410,95,56,17,94,154,813
2016,Orlando Johnson,SG,26,TOT,7,1,101,9,34,0.265,2,10,0.2,7,24,0.292,6,8,0.75,4,11,15,2,3,3,4,9,26
2016,Orlando Johnson,SG,26,PHO,2,0,47,5,17,0.294,1,5,0.2,4,12,0.333,5,6,0.833,3,6,9,0,2,3,1,5,16
2016,Orlando Johnson,SG,26,NOP,5,1,54,4,17,0.235,1,5,0.2,3,12,0.25,1,2,0.5,1,5,6,2,1,0,3,4,10
2016,Otto Porter Jr.,SF,22,WAS,75,73,2276,339,717,0.473,98,267,0.367,241,450,0.536,95,126,0.754,97,294,391,120,105,32,70,163,871
2016,P.J. Hairston,SF,23,TOT,66,52,1313,145,408,0.355,70,241,0.29,75,167,0.449,50,64,0.781,25,149,174,38,32,11,41,137,410
2016,P.J. Hairston,SF,23,CHO,48,43,938,99,276,0.359,54,172,0.314,45,104,0.433,34,42,0.81,18,110,128,29,24,7,24,106,286
2016,P.J. Hairston,SF,23,MEM,18,9,375,46,132,0.348,16,69,0.232,30,63,0.476,16,22,0.727,7,39,46,9,8,4,17,31,124
2016,P.J. Tucker,SF,30,PHO,82,80,2540,239,582,0.411,68,206,0.33,171,376,0.455,106,142,0.746,165,347,512,177,106,20,111,202,652
2016,Pablo Prigioni,PG,38,LAC,59,3,823,55,147,0.374,28,95,0.295,27,52,0.519,7,8,0.875,38,76,114,130,53,1,49,82,145
2016,Pat Connaughton,SG,23,POR,34,0,143,13,49,0.265,5,21,0.238,8,28,0.286,5,5,1,11,21,32,10,2,0,10,6,36
2016,Patrick Beverley,PG,27,HOU,71,63,2041,258,594,0.434,124,310,0.4,134,284,0.472,60,88,0.682,73,177,250,239,94,26,91,234,700
2016,Patrick Patterson,PF,26,TOR,79,0,2020,204,493,0.414,106,293,0.362,98,200,0.49,29,34,0.853,77,265,342,94,53,32,65,128,543
2016,Patty Mills,PG,27,SAS,81,3,1662,260,612,0.425,123,320,0.384,137,292,0.469,47,58,0.81,27,131,158,226,59,6,76,102,690
2016,Pau Gasol,C,35,CHI,72,72,2291,467,995,0.469,24,69,0.348,443,926,0.478,229,289,0.792,155,638,793,294,42,146,164,148,1187
2016,Paul George,SF,25,IND,81,81,2819,605,1449,0.418,210,566,0.371,395,883,0.447,454,528,0.86,79,484,563,329,152,29,265,230,1874
2016,Paul Millsap,PF,30,ATL,81,81,2647,501,1066,0.47,74,232,0.319,427,834,0.512,309,408,0.757,198,534,732,265,147,139,191,237,1385
2016,Paul Pierce*,SF,38,LAC,68,38,1231,144,397,0.363,75,242,0.31,69,155,0.445,54,66,0.818,12,174,186,71,33,17,58,129,417
2016,Phil Pressey,PG,24,TOT,23,0,283,30,78,0.385,4,18,0.222,26,60,0.433,13,25,0.52,3,28,31,75,18,4,33,28,77
2016,Phil Pressey,PG,24,PHI,14,0,170,21,55,0.382,4,13,0.308,17,42,0.405,9,18,0.5,0,23,23,46,11,1,19,14,55
2016,Phil Pressey,PG,24,PHO,9,0,113,9,23,0.391,0,5,0,9,18,0.5,4,7,0.571,3,5,8,29,7,3,14,14,22
2016,Quincy Acy,PF,25,SAC,59,29,876,119,214,0.556,19,49,0.388,100,165,0.606,50,68,0.735,65,123,188,27,29,24,27,103,307
2016,R.J. Hunter,SG,22,BOS,36,0,315,36,98,0.367,19,63,0.302,17,35,0.486,6,7,0.857,2,35,37,13,14,4,11,29,97
2016,Rajon Rondo,PG,29,SAC,72,72,2537,355,782,0.454,62,170,0.365,293,612,0.479,87,150,0.58,77,358,435,839,141,10,278,175,859
2016,Rakeem Christmas,PF,24,IND,1,0,6,2,2,1,0,0,,2,2,1,0,0,,1,0,1,0,0,0,0,1,4
2016,Ramon Sessions,PG,29,WAS,82,5,1667,280,592,0.473,36,111,0.324,244,481,0.507,214,283,0.756,25,178,203,239,46,5,115,102,810
2016,Randy Foye,SG,32,TOT,81,8,1642,169,482,0.351,75,250,0.3,94,232,0.405,61,74,0.824,24,132,156,161,39,29,86,131,474
2016,Randy Foye,SG,32,DEN,54,7,1070,117,333,0.351,50,169,0.296,67,164,0.409,39,47,0.83,16,89,105,112,26,16,58,83,323
2016,Randy Foye,SG,32,OKC,27,1,572,52,149,0.349,25,81,0.309,27,68,0.397,22,27,0.815,8,43,51,49,13,13,28,48,151
2016,Rashad Vaughn,SG,19,MIL,70,6,1001,81,266,0.305,43,147,0.293,38,119,0.319,12,15,0.8,11,77,88,39,29,16,28,73,217
2016,Rasual Butler,SF,36,SAS,46,0,432,49,104,0.471,15,49,0.306,34,55,0.618,11,16,0.688,3,53,56,24,13,23,8,11,124
2016,Raul Neto,PG,23,UTA,81,53,1499,180,418,0.431,64,162,0.395,116,256,0.453,52,70,0.743,17,103,120,174,62,2,109,122,476
2016,Ray McCallum,PG,24,TOT,41,6,475,55,146,0.377,15,42,0.357,40,104,0.385,12,15,0.8,8,39,47,60,12,7,24,29,137
2016,Ray McCallum,PG,24,SAS,31,3,256,27,67,0.403,5,16,0.313,22,51,0.431,9,10,0.9,6,25,31,33,5,4,11,14,68
2016,Ray McCallum,PG,24,MEM,10,3,219,28,79,0.354,10,26,0.385,18,53,0.34,3,5,0.6,2,14,16,27,7,3,13,15,69
2016,Raymond Felton,PG,31,DAL,80,31,2192,277,682,0.406,60,213,0.282,217,469,0.463,149,176,0.847,36,222,258,284,68,15,121,141,763
2016,Reggie Bullock,SF,24,DET,37,0,429,43,98,0.439,22,53,0.415,21,45,0.467,14,15,0.933,14,54,68,27,10,2,8,29,122
2016,Reggie Jackson,PG,25,DET,79,79,2424,540,1244,0.434,118,334,0.353,422,910,0.464,291,337,0.864,58,195,253,492,59,11,223,187,1489
2016,Richard Jefferson,SF,35,CLE,74,5,1326,143,312,0.458,66,173,0.382,77,139,0.554,58,87,0.667,15,113,128,59,33,14,43,129,410
2016,Richaun Holmes,PF,22,PHI,51,1,702,114,222,0.514,8,44,0.182,106,178,0.596,51,74,0.689,62,73,135,33,19,40,32,92,287
2016,Ricky Rubio,PG,25,MIN,76,76,2323,219,586,0.374,62,190,0.326,157,396,0.396,266,314,0.847,40,286,326,658,162,10,193,201,766
2016,Robert Covington,SF,25,PHI,67,49,1903,274,712,0.385,170,482,0.353,104,230,0.452,140,177,0.791,65,354,419,97,105,40,143,232,858
2016,Robert Sacre,C,26,LAL,25,1,320,31,75,0.413,0,0,,31,75,0.413,25,38,0.658,32,40,72,14,4,10,12,43,87
2016,Robin Lopez,C,27,NYK,82,82,2219,357,662,0.539,0,1,0,357,661,0.54,128,161,0.795,268,334,602,114,16,129,133,182,842
2016,Rodney Hood,SG,23,UTA,79,79,2541,408,972,0.42,161,449,0.359,247,523,0.472,172,200,0.86,38,229,267,213,73,16,125,202,1149
2016,Rodney Stuckey,PG,29,IND,58,1,1275,183,443,0.413,20,83,0.241,163,360,0.453,131,158,0.829,19,137,156,142,43,8,76,77,517
2016,Rondae Hollis-Jefferson,SF,21,BRK,29,17,615,63,138,0.457,4,14,0.286,59,124,0.476,37,52,0.712,39,115,154,43,39,16,26,61,167
2016,Ronnie Price,PG,32,PHO,62,18,1211,116,302,0.384,68,196,0.347,48,106,0.453,31,41,0.756,25,74,99,147,74,13,70,161,331
2016,Roy Hibbert,C,29,LAL,81,81,1878,182,411,0.443,0,2,0,182,409,0.445,117,145,0.807,132,266,398,95,32,110,76,252,481
2016,Rudy Gay,SF,29,SAC,70,70,2379,466,1007,0.463,74,215,0.344,392,792,0.495,198,254,0.78,103,353,456,120,100,51,139,184,1204
2016,Rudy Gobert,C,23,UTA,61,60,1932,198,354,0.559,0,0,,198,354,0.559,161,283,0.569,208,460,668,91,45,135,114,163,557
2016,Russ Smith,PG,24,MEM,15,0,66,7,22,0.318,1,5,0.2,6,17,0.353,8,13,0.615,1,8,9,11,5,1,7,5,23
2016,Russell Westbrook,PG,27,OKC,80,80,2750,656,1444,0.454,101,341,0.296,555,1103,0.503,465,573,0.812,145,481,626,834,163,20,342,200,1878
2016,Ryan Anderson,PF,27,NOP,66,7,2008,397,929,0.427,131,358,0.366,266,571,0.466,199,228,0.873,131,265,396,73,38,25,90,109,1124
2016,Ryan Hollins,C,31,TOT,37,12,460,49,79,0.62,0,0,,49,79,0.62,26,42,0.619,47,51,98,10,6,21,24,62,124
2016,Ryan Hollins,C,31,WAS,5,3,48,4,7,0.571,0,0,,4,7,0.571,0,0,,7,4,11,0,0,1,3,4,8
2016,Ryan Hollins,C,31,MEM,32,9,412,45,72,0.625,0,0,,45,72,0.625,26,42,0.619,40,47,87,10,6,20,21,58,116
2016,Ryan Kelly,PF,24,LAL,36,0,470,55,149,0.369,5,37,0.135,50,112,0.446,37,54,0.685,21,100,121,20,13,10,18,39,152
2016,Salah Mejri,C,29,DAL,34,6,397,49,78,0.628,0,1,0,49,77,0.636,27,46,0.587,41,82,123,10,8,36,23,54,125
2016,Sam Dekker,PF,21,HOU,3,0,6,0,0,,0,0,,0,0,,0,0,,0,1,1,0,1,0,0,0,0
2016,Sasha Kaun,C,30,CLE,25,0,95,9,17,0.529,0,0,,9,17,0.529,5,11,0.455,12,14,26,3,4,5,7,11,23
2016,Sasha Vujačić,SG,31,NYK,61,25,908,106,277,0.383,52,143,0.364,54,134,0.403,32,39,0.821,26,123,149,84,34,5,44,83,296
2016,Sean Kilpatrick,SG,26,TOT,31,0,616,123,270,0.456,39,114,0.342,84,156,0.538,60,67,0.896,12,44,56,29,12,2,31,37,345
2016,Sean Kilpatrick,SG,26,DEN,8,0,82,8,21,0.381,4,17,0.235,4,4,1,7,8,0.875,2,4,6,3,2,0,4,7,27
2016,Sean Kilpatrick,SG,26,BRK,23,0,534,115,249,0.462,35,97,0.361,80,152,0.526,53,59,0.898,10,40,50,26,10,2,27,30,318
2016,Serge Ibaka,PF,26,OKC,78,78,2500,416,869,0.479,60,184,0.326,356,685,0.52,91,121,0.752,141,392,533,66,38,148,108,211,983
2016,Sergey Karasev,SF,22,BRK,40,5,399,30,74,0.405,11,37,0.297,19,37,0.514,26,28,0.929,8,50,58,35,6,2,22,27,97
2016,Seth Curry,PG,25,SAC,44,9,692,102,224,0.455,50,111,0.45,52,113,0.46,45,54,0.833,9,51,60,67,22,3,36,41,299
2016,Shabazz Muhammad,SF,23,MIN,82,0,1682,317,681,0.465,44,152,0.289,273,529,0.516,185,242,0.764,100,167,267,52,24,7,70,94,863
2016,Shabazz Napier,PG,24,ORL,55,0,600,68,201,0.338,34,104,0.327,34,97,0.351,33,45,0.733,9,46,55,97,23,1,46,38,203
2016,Shane Larkin,PG,23,BRK,78,17,1751,222,502,0.442,39,108,0.361,183,394,0.464,83,107,0.776,28,152,180,342,95,12,146,121,566
2016,Shaun Livingston,PG,30,GSW,78,3,1520,203,379,0.536,2,12,0.167,201,367,0.548,80,93,0.86,42,127,169,237,57,27,78,140,488
2016,Shayne Whittington,PF,24,IND,7,0,41,5,11,0.455,0,2,0,5,9,0.556,1,2,0.5,5,7,12,3,1,1,5,7,11
2016,Shelvin Mack,PG,25,TOT,52,27,1058,182,415,0.439,39,125,0.312,143,290,0.493,45,61,0.738,13,115,128,187,34,3,95,72,448
2016,Shelvin Mack,PG,25,ATL,24,0,179,40,95,0.421,4,27,0.148,36,68,0.529,9,12,0.75,2,20,22,38,8,0,14,7,93
2016,Shelvin Mack,PG,25,UTA,28,27,879,142,320,0.444,35,98,0.357,107,222,0.482,36,49,0.735,11,95,106,149,26,3,81,65,355
2016,Solomon Hill,SF,24,IND,59,3,866,93,208,0.447,24,74,0.324,69,134,0.515,36,42,0.857,39,127,166,57,37,11,33,68,246
2016,Sonny Weems,SG-SF,29,TOT,43,0,499,42,110,0.382,15,41,0.366,27,69,0.391,8,15,0.533,7,46,53,49,10,1,41,47,107
2016,Sonny Weems,SG,29,PHO,36,0,421,35,89,0.393,13,32,0.406,22,57,0.386,7,13,0.538,6,35,41,47,10,1,37,40,90
2016,Sonny Weems,SF,29,PHI,7,0,78,7,21,0.333,2,9,0.222,5,12,0.417,1,2,0.5,1,11,12,2,0,0,4,7,17
2016,Spencer Dinwiddie,PG,22,DET,12,0,159,19,54,0.352,1,10,0.1,18,44,0.409,19,33,0.576,4,13,17,22,3,0,7,20,58
2016,Spencer Hawes,PF,27,CHO,57,6,1035,124,306,0.405,38,102,0.373,86,204,0.422,54,65,0.831,51,193,244,109,22,27,58,111,340
2016,Stanley Johnson,SF,19,DET,73,6,1687,225,600,0.375,63,205,0.307,162,395,0.41,80,102,0.784,58,248,306,118,55,12,114,178,593
2016,Stephen Curry,PG,27,GSW,79,79,2700,805,1598,0.504,402,886,0.454,403,712,0.566,363,400,0.908,68,362,430,527,169,15,262,161,2375
2016,Steve Blake,PG,35,DET,58,2,986,93,240,0.388,52,151,0.344,41,89,0.461,16,20,0.8,9,80,89,200,24,5,81,70,254
2016,Steve Novak,PF,32,TOT,10,0,44,8,18,0.444,7,15,0.467,1,3,0.333,1,1,1,0,5,5,0,0,0,1,3,24
2016,Steve Novak,PF,32,OKC,7,0,24,6,12,0.5,5,9,0.556,1,3,0.333,0,0,,0,4,4,0,0,0,1,1,17
2016,Steve Novak,PF,32,MIL,3,0,20,2,6,0.333,2,6,0.333,0,0,,1,1,1,0,1,1,0,0,0,0,2,7
2016,Steven Adams,C,22,OKC,80,80,2014,261,426,0.613,0,0,,261,426,0.613,114,196,0.582,219,314,533,62,42,89,84,223,636
2016,T.J. McConnell,PG,23,PHI,81,17,1606,218,464,0.47,31,89,0.348,187,375,0.499,26,41,0.634,43,207,250,367,95,10,140,114,493
2016,T.J. Warren,SF,22,PHO,47,4,1070,221,441,0.501,28,70,0.4,193,371,0.52,45,64,0.703,57,90,147,44,37,16,32,94,515
2016,Taj Gibson,PF,30,CHI,73,55,1936,263,500,0.526,0,3,0,263,497,0.529,101,146,0.692,206,298,504,106,47,77,78,180,627
2016,Tarik Black,C,24,LAL,39,0,496,57,104,0.548,0,0,,57,104,0.548,19,45,0.422,44,113,157,16,14,18,22,78,133
2016,Tayshaun Prince,SF,35,MIN,77,44,1462,102,229,0.445,4,23,0.174,98,206,0.476,13,19,0.684,32,115,147,73,36,13,27,62,221
2016,Terrence Jones,PF,24,HOU,50,11,1044,166,367,0.452,25,79,0.316,141,288,0.49,77,116,0.664,62,149,211,41,23,39,49,86,434
2016,Terrence Ross,SF,24,TOR,73,7,1747,270,626,0.431,131,339,0.386,139,287,0.484,49,62,0.79,21,164,185,56,54,25,46,120,720
2016,Terry Rozier,PG,21,BOS,39,0,311,29,106,0.274,6,27,0.222,23,79,0.291,8,10,0.8,24,39,63,37,6,1,19,23,72
2016,Thabo Sefolosha,SF,31,ATL,75,11,1758,188,372,0.505,42,124,0.339,146,248,0.589,62,99,0.626,52,282,334,107,85,37,68,109,480
2016,Thaddeus Young,PF,27,BRK,73,73,2407,495,963,0.514,7,30,0.233,488,933,0.523,105,163,0.644,176,484,660,136,112,37,136,182,1102
2016,Thanasis Antetokounmpo,SF,23,NYK,2,0,6,3,4,0.75,0,1,0,3,3,1,0,0,,0,1,1,0,0,0,0,2,6
2016,Thomas Robinson,PF,24,BRK,71,7,917,130,291,0.447,0,1,0,130,290,0.448,47,109,0.431,136,223,359,46,39,36,69,111,307
2016,Tiago Splitter,C,31,ATL,36,2,579,81,155,0.523,0,2,0,81,153,0.529,39,48,0.813,45,75,120,30,20,12,24,71,201
2016,Tibor Pleiß,C,26,UTA,12,0,82,11,25,0.44,0,2,0,11,23,0.478,2,2,1,6,9,15,2,1,2,8,19,24
2016,Tim Duncan*,C,39,SAS,61,60,1536,215,441,0.488,0,2,0,215,439,0.49,92,131,0.702,115,332,447,163,47,78,90,125,522
2016,Tim Frazier,PG,25,TOT,51,2,741,96,229,0.419,16,48,0.333,80,181,0.442,53,74,0.716,26,84,110,162,33,2,65,73,261
2016,Tim Frazier,PG,25,POR,35,1,272,20,60,0.333,3,17,0.176,17,43,0.395,8,15,0.533,11,28,39,42,10,1,27,31,51
2016,Tim Frazier,PG,25,NOP,16,1,469,76,169,0.45,13,31,0.419,63,138,0.457,45,59,0.763,15,56,71,120,23,1,38,42,210
2016,Tim Hardaway Jr.,SG,23,ATL,51,1,864,114,265,0.43,48,142,0.338,66,123,0.537,50,56,0.893,7,79,86,51,21,7,23,48,326
2016,Timofey Mozgov,C,29,CLE,76,48,1326,203,359,0.565,1,7,0.143,202,352,0.574,68,95,0.716,110,227,337,33,22,57,71,159,475
2016,Tobias Harris,PF,23,TOT,76,74,2513,417,889,0.469,80,239,0.335,337,650,0.518,202,243,0.831,96,414,510,169,65,40,108,153,1116
2016,Tobias Harris,PF,23,ORL,49,49,1610,251,541,0.464,47,151,0.311,204,390,0.523,120,153,0.784,71,271,342,99,47,28,78,91,669
2016,Tobias Harris,PF,23,DET,27,25,903,166,348,0.477,33,88,0.375,133,260,0.512,82,90,0.911,25,143,168,70,18,12,30,62,447
2016,Toney Douglas,PG,29,NOP,61,18,1262,183,445,0.411,81,203,0.399,102,242,0.421,84,99,0.848,25,118,143,157,70,5,64,131,531
2016,Tony Allen,SG,34,MEM,64,57,1620,215,469,0.458,15,42,0.357,200,427,0.468,90,138,0.652,104,192,296,70,110,18,78,175,535
2016,Tony Parker,PG,33,SAS,72,72,1980,350,710,0.493,27,65,0.415,323,645,0.501,130,171,0.76,17,159,176,379,54,11,131,114,857
2016,Tony Snell,SF,24,CHI,64,33,1301,126,339,0.372,56,155,0.361,70,184,0.38,30,33,0.909,19,180,199,63,16,17,52,100,338
2016,Tony Wroten,PG,22,PHI,8,3,144,22,65,0.338,3,17,0.176,19,48,0.396,20,37,0.541,2,19,21,20,3,0,29,11,67
2016,Trevor Ariza,SF,30,HOU,81,81,2859,357,859,0.416,185,499,0.371,172,360,0.478,126,161,0.783,67,299,366,188,160,26,113,177,1025
2016,Trevor Booker,PF,28,UTA,79,2,1632,190,388,0.49,12,41,0.293,178,347,0.513,71,106,0.67,166,286,452,84,59,41,81,169,463
2016,Trey Burke,PG,23,UTA,64,0,1366,262,634,0.413,88,256,0.344,174,378,0.46,67,82,0.817,18,94,112,148,35,6,80,86,679
2016,Trey Lyles,PF,20,UTA,80,33,1382,191,436,0.438,49,128,0.383,142,308,0.461,57,82,0.695,59,240,299,59,26,18,65,114,488
2016,Tristan Thompson,PF,24,CLE,82,34,2269,247,420,0.588,0,0,,247,420,0.588,149,242,0.616,268,470,738,62,38,51,61,202,643
2016,Troy Daniels,SG,24,CHO,43,0,476,89,187,0.476,59,122,0.484,30,65,0.462,5,9,0.556,7,50,57,21,11,3,24,40,242
2016,Ty Lawson,PG,28,TOT,66,13,1411,139,354,0.393,36,108,0.333,103,246,0.419,59,86,0.686,26,94,120,237,53,7,95,87,373
2016,Ty Lawson,PG,28,HOU,53,12,1176,111,287,0.387,31,94,0.33,80,193,0.415,56,80,0.7,20,69,89,180,43,6,82,71,309
2016,Ty Lawson,PG,28,IND,13,1,235,28,67,0.418,5,14,0.357,23,53,0.434,3,6,0.5,6,25,31,57,10,1,13,16,64
2016,Tyler Ennis,PG,21,MIL,46,7,654,84,187,0.449,13,39,0.333,71,148,0.48,25,34,0.735,13,62,75,95,25,1,46,64,206
2016,Tyler Hansbrough,PF,30,CHO,44,0,343,32,71,0.451,2,3,0.667,30,68,0.441,38,65,0.585,40,49,89,8,12,7,12,55,104
2016,Tyler Johnson,SG,23,MIA,36,5,863,118,243,0.486,27,71,0.38,91,172,0.529,51,64,0.797,28,81,109,79,24,14,47,66,314
2016,Tyler Zeller,C,26,BOS,60,3,710,138,290,0.476,0,0,,138,290,0.476,88,108,0.815,62,116,178,29,10,22,46,97,364
2016,Tyreke Evans,SG,26,NOP,25,25,765,136,314,0.433,33,85,0.388,103,229,0.45,74,93,0.796,20,109,129,164,32,8,73,66,379
2016,Tyson Chandler,C,33,PHO,66,60,1618,183,314,0.583,0,1,0,183,313,0.585,106,171,0.62,175,401,576,64,36,44,93,145,472
2016,Tyus Jones,PG,19,MIN,37,0,573,56,156,0.359,16,53,0.302,40,103,0.388,28,39,0.718,7,40,47,108,31,3,33,33,156
2016,Udonis Haslem,PF,35,MIA,37,0,260,23,61,0.377,1,9,0.111,22,52,0.423,12,16,0.75,10,65,75,14,5,2,5,25,59
2016,Victor Oladipo,SG,23,ORL,72,52,2379,425,970,0.438,98,282,0.348,327,688,0.475,205,247,0.83,48,297,345,282,116,54,153,174,1153
2016,Vince Carter,SG,39,MEM,60,3,1005,133,343,0.388,59,169,0.349,74,174,0.425,70,84,0.833,31,115,146,56,38,16,35,101,395
2016,Wayne Ellington,SG,28,BRK,76,41,1615,218,561,0.389,96,268,0.358,122,293,0.416,54,63,0.857,20,154,174,83,48,5,45,82,586
2016,Wesley Johnson,SF,28,LAC,80,9,1666,208,515,0.404,103,309,0.333,105,206,0.51,30,46,0.652,37,211,248,49,89,56,54,173,549
2016,Wesley Matthews,SF,29,DAL,78,78,2644,331,854,0.388,189,525,0.36,142,329,0.432,126,146,0.863,27,211,238,151,78,17,78,179,977
2016,Will Barton,SG,25,DEN,82,1,2353,425,983,0.432,112,325,0.345,313,658,0.476,216,268,0.806,59,417,476,203,71,39,139,147,1178
2016,Willie Cauley-Stein,C,22,SAC,66,39,1412,191,339,0.563,0,2,0,191,337,0.567,81,125,0.648,134,218,352,37,48,66,46,146,463
2016,Willie Reed,C,25,BRK,39,2,426,76,133,0.571,0,0,,76,133,0.571,30,55,0.545,49,73,122,10,6,30,16,47,182
2016,Xavier Munford,SG,23,MEM,14,0,244,32,77,0.416,9,23,0.391,23,54,0.426,7,14,0.5,3,28,31,22,13,3,15,25,80
2016,Zach LaVine,SG,20,MIN,82,33,2294,433,959,0.452,123,316,0.389,310,643,0.482,161,203,0.793,27,201,228,251,69,17,155,193,1150
2016,Zach Randolph,PF,34,MEM,68,53,2016,431,907,0.475,6,26,0.231,425,881,0.482,172,216,0.796,179,350,529,142,43,13,105,146,1040
2016,Zaza Pachulia,C,31,DAL,76,69,2004,219,470,0.466,0,3,0,219,467,0.469,212,276,0.768,249,469,718,128,64,22,119,181,650
2017,A.J. Hammons,C,24,DAL,22,0,163,17,42,0.405,5,10,0.5,12,32,0.375,9,20,0.45,8,28,36,4,1,13,10,21,48
2017,Aaron Brooks,PG,32,IND,65,0,894,121,300,0.403,48,128,0.375,73,172,0.424,32,40,0.8,18,51,69,125,25,9,66,93,322
2017,Aaron Gordon,SF,21,ORL,80,72,2298,393,865,0.454,77,267,0.288,316,598,0.528,156,217,0.719,116,289,405,150,65,40,89,172,1019
2017,Aaron Harrison,SG,22,CHO,5,0,17,0,4,0,0,2,0,0,2,0,1,2,0.5,0,3,3,3,0,0,0,2,1
2017,Adreian Payne,PF,25,MIN,18,0,135,23,54,0.426,3,15,0.2,20,39,0.513,14,19,0.737,9,24,33,7,8,7,8,32,63
2017,Al Horford,C,30,BOS,68,68,2193,379,801,0.473,86,242,0.355,293,559,0.524,108,135,0.8,95,370,465,337,52,86,115,138,952
2017,Al Jefferson,C,32,IND,66,1,931,235,471,0.499,0,1,0,235,470,0.5,65,85,0.765,75,203,278,57,19,16,33,125,535
2017,Al-Farouq Aminu,PF,26,POR,61,25,1773,183,466,0.393,70,212,0.33,113,254,0.445,96,136,0.706,77,374,451,99,60,44,94,102,532
2017,Alan Anderson,SF,34,LAC,30,0,308,30,80,0.375,14,44,0.318,16,36,0.444,12,16,0.75,3,21,24,11,3,0,7,35,86
2017,Alan Williams,C,24,PHO,47,0,708,138,267,0.517,0,1,0,138,266,0.519,70,112,0.625,94,198,292,23,27,32,37,125,346
2017,Alec Burks,SG,25,UTA,42,0,653,99,248,0.399,25,76,0.329,74,172,0.43,60,78,0.769,17,103,120,30,18,5,35,50,283
2017,Álex Abrines,SG,23,OKC,68,6,1055,134,341,0.393,94,247,0.381,40,94,0.426,44,49,0.898,18,68,86,40,37,8,33,114,406
2017,Alex Len,C,23,PHO,77,34,1560,230,463,0.497,3,12,0.25,227,451,0.503,150,208,0.721,156,354,510,44,38,98,102,242,613
2017,Alex Poythress,PF,23,PHI,6,1,157,25,54,0.463,6,19,0.316,19,35,0.543,8,10,0.8,11,18,29,5,3,2,3,14,64
2017,Alexis Ajinça,C,28,NOP,39,15,584,89,178,0.5,0,4,0,89,174,0.511,29,40,0.725,46,131,177,12,20,22,31,77,207
2017,Allen Crabbe,SG,24,POR,79,7,2254,303,647,0.468,134,302,0.444,169,345,0.49,105,124,0.847,19,207,226,94,54,20,62,171,845
2017,Alonzo Gee,SF,29,DEN,13,0,89,3,14,0.214,0,3,0,3,11,0.273,5,9,0.556,4,11,15,6,5,1,4,14,11
2017,Amir Johnson,PF,29,BOS,80,77,1608,213,370,0.576,27,66,0.409,186,304,0.612,67,100,0.67,118,248,366,140,51,62,77,211,520
2017,Anderson Varejão,C,34,GSW,14,1,92,5,14,0.357,0,0,,5,14,0.357,8,11,0.727,12,15,27,10,3,3,8,16,18
2017,Andre Drummond,C,23,DET,81,81,2409,483,911,0.53,2,7,0.286,481,904,0.532,137,355,0.386,345,770,1115,90,124,89,152,237,1105
2017,Andre Iguodala,SF,33,GSW,76,0,1998,219,415,0.528,64,177,0.362,155,238,0.651,72,102,0.706,51,253,304,261,76,39,58,97,574
2017,Andre Roberson,SF,25,OKC,79,79,2376,215,463,0.464,45,184,0.245,170,279,0.609,47,111,0.423,98,305,403,79,94,79,51,204,522
2017,Andrew Bogut,C,32,TOT,27,21,583,38,81,0.469,0,1,0,38,80,0.475,3,11,0.273,56,162,218,49,13,25,43,86,79
2017,Andrew Bogut,C,32,DAL,26,21,582,38,81,0.469,0,1,0,38,80,0.475,3,11,0.273,56,162,218,49,13,25,43,84,79
2017,Andrew Bogut,C,32,CLE,1,0,1,0,0,,0,0,,0,0,,0,0,,0,0,0,0,0,0,0,2,0
2017,Andrew Harrison,PG,22,MEM,72,18,1474,117,360,0.325,43,156,0.276,74,204,0.363,148,194,0.763,23,113,136,198,53,21,85,194,425
2017,Andrew Nicholson,PF,27,TOT,38,0,342,43,111,0.387,5,27,0.185,38,84,0.452,9,14,0.643,15,46,61,10,16,6,17,55,100
2017,Andrew Nicholson,PF,27,WAS,28,0,231,30,77,0.39,3,16,0.188,27,61,0.443,7,12,0.583,11,23,34,7,11,6,11,37,70
2017,Andrew Nicholson,PF,27,BRK,10,0,111,13,34,0.382,2,11,0.182,11,23,0.478,2,2,1,4,23,27,3,5,0,6,18,30
2017,Andrew Wiggins,SF,21,MIN,82,82,3048,709,1570,0.452,103,289,0.356,606,1281,0.473,412,542,0.76,102,226,328,189,82,30,187,183,1933
2017,Anthony Bennett,PF,23,BRK,23,1,264,38,92,0.413,13,48,0.271,25,44,0.568,26,36,0.722,25,53,78,12,5,3,12,18,115
2017,Anthony Brown,SF,24,TOT,11,0,159,18,50,0.36,7,27,0.259,11,23,0.478,0,0,,8,25,33,8,5,1,6,15,43
2017,Anthony Brown,SF,24,NOP,9,0,143,14,41,0.341,6,24,0.25,8,17,0.471,0,0,,6,20,26,6,5,1,5,13,34
2017,Anthony Brown,SF,24,ORL,2,0,16,4,9,0.444,1,3,0.333,3,6,0.5,0,0,,2,5,7,2,0,0,1,2,9
2017,Anthony Davis,C,23,NOP,75,75,2708,770,1526,0.505,40,134,0.299,730,1392,0.524,519,647,0.802,172,712,884,157,94,167,181,168,2099
2017,Anthony Morrow,SG,31,TOT,49,7,714,98,252,0.389,41,133,0.308,57,119,0.479,34,37,0.919,12,19,31,25,24,2,6,44,271
2017,Anthony Morrow,SG,31,OKC,40,7,627,86,223,0.386,35,119,0.294,51,104,0.49,23,26,0.885,11,18,29,19,22,2,6,40,230
2017,Anthony Morrow,SG,31,CHI,9,0,87,12,29,0.414,6,14,0.429,6,15,0.4,11,11,1,1,1,2,6,2,0,0,4,41
2017,Anthony Tolliver,PF,31,SAC,65,9,1477,155,351,0.442,90,230,0.391,65,121,0.537,61,82,0.744,51,186,237,77,34,20,56,109,461
2017,Archie Goodwin,SG,22,TOT,15,0,214,36,66,0.545,5,15,0.333,31,51,0.608,33,42,0.786,7,21,28,24,4,5,14,8,110
2017,Archie Goodwin,SG,22,NOP,3,0,30,2,5,0.4,1,2,0.5,1,3,0.333,10,10,1,0,0,0,1,0,1,0,1,15
2017,Archie Goodwin,SG,22,BRK,12,0,184,34,61,0.557,4,13,0.308,30,48,0.625,23,32,0.719,7,21,28,23,4,4,14,7,95
2017,Arinze Onuaku,C,29,ORL,8,0,28,2,4,0.5,0,0,,2,4,0.5,0,0,,2,4,6,2,0,1,2,3,4
2017,Aron Baynes,C,30,DET,75,2,1163,143,279,0.513,0,0,,143,279,0.513,79,94,0.84,111,222,333,32,17,39,50,166,365
2017,Arron Afflalo,SG,31,SAC,61,45,1580,185,420,0.44,62,151,0.411,123,269,0.457,83,93,0.892,9,116,125,78,21,6,42,104,515
2017,Austin Rivers,SG,24,LAC,74,29,2054,323,731,0.442,111,299,0.371,212,432,0.491,132,191,0.691,20,141,161,204,48,10,115,187,889
2017,Avery Bradley,SG,26,BOS,55,55,1835,359,775,0.463,108,277,0.39,251,498,0.504,68,93,0.731,65,269,334,122,68,11,88,141,894
2017,Axel Toupane,SF,24,TOT,4,0,47,5,9,0.556,1,4,0.25,4,5,0.8,0,0,,0,1,1,0,1,1,0,6,11
2017,Axel Toupane,SF,24,MIL,2,0,6,0,1,0,0,1,0,0,0,,0,0,,0,0,0,0,0,0,0,1,0
2017,Axel Toupane,SF,24,NOP,2,0,41,5,8,0.625,1,3,0.333,4,5,0.8,0,0,,0,1,1,0,1,1,0,5,11
2017,Ben Bentil,PF,21,DAL,3,0,10,0,3,0,0,1,0,0,2,0,0,0,,0,2,2,0,0,0,1,1,0
2017,Ben McLemore,SG,23,SAC,61,26,1176,180,419,0.43,65,170,0.382,115,249,0.462,70,93,0.753,19,110,129,51,29,6,62,108,495
2017,Beno Udrih,PG,34,DET,39,0,560,92,197,0.467,11,32,0.344,81,165,0.491,32,34,0.941,6,51,57,131,13,0,36,29,227
2017,Bismack Biyombo,C,24,ORL,81,27,1793,179,339,0.528,0,0,,179,339,0.528,125,234,0.534,157,410,567,74,25,91,95,202,483
2017,Blake Griffin,PF,27,LAC,61,61,2076,479,971,0.493,38,113,0.336,441,858,0.514,320,421,0.76,112,385,497,300,57,22,142,157,1316
2017,Boban Marjanović,C,28,DET,35,0,293,72,132,0.545,0,0,,72,132,0.545,47,58,0.81,46,84,130,9,6,12,10,25,191
2017,Bobby Brown,PG,32,HOU,25,0,123,23,60,0.383,14,35,0.4,9,25,0.36,2,2,1,0,6,6,14,1,0,5,5,62
2017,Bobby Portis,PF,21,CHI,64,13,1000,183,375,0.488,32,96,0.333,151,279,0.541,39,59,0.661,75,221,296,35,16,11,37,94,437
2017,Bojan Bogdanović,SF,27,TOT,81,54,2083,376,845,0.445,144,392,0.367,232,453,0.512,217,243,0.893,37,240,277,111,34,7,131,146,1113
2017,Bojan Bogdanović,SF,27,BRK,55,54,1482,269,611,0.44,99,277,0.357,170,334,0.509,146,167,0.874,23,174,197,90,24,3,93,99,783
2017,Bojan Bogdanović,SF,27,WAS,26,0,601,107,234,0.457,45,115,0.391,62,119,0.521,71,76,0.934,14,66,80,21,10,4,38,47,330
2017,Boris Diaw,PF,34,UTA,73,33,1283,146,327,0.446,20,81,0.247,126,246,0.512,26,35,0.743,46,112,158,170,18,9,87,83,338
2017,Bradley Beal,SG,23,WAS,77,77,2684,637,1322,0.482,223,552,0.404,414,770,0.538,282,342,0.825,53,187,240,267,83,21,156,169,1779
2017,Brandan Wright,PF,29,MEM,28,5,447,83,135,0.615,0,1,0,83,134,0.619,23,35,0.657,31,47,78,15,11,20,10,42,189
2017,Brandon Bass,PF,31,LAC,52,0,577,107,186,0.575,1,3,0.333,106,183,0.579,77,88,0.875,43,86,129,21,14,11,29,45,292
2017,Brandon Ingram,SF,19,LAL,79,40,2279,276,686,0.402,55,187,0.294,221,499,0.443,133,214,0.621,60,256,316,166,50,36,116,158,740
2017,Brandon Jennings,PG,27,TOT,81,13,1802,192,535,0.359,79,252,0.313,113,283,0.399,114,152,0.75,29,167,196,395,70,4,128,116,577
2017,Brandon Jennings,PG,27,NYK,58,11,1428,163,429,0.38,68,200,0.34,95,229,0.415,102,135,0.756,21,131,152,287,55,4,106,84,496
2017,Brandon Jennings,PG,27,WAS,23,2,374,29,106,0.274,11,52,0.212,18,54,0.333,12,17,0.706,8,36,44,108,15,0,22,32,81
2017,Brandon Knight,SG,25,PHO,54,5,1140,209,525,0.398,45,139,0.324,164,386,0.425,132,154,0.857,25,93,118,130,27,5,88,87,595
2017,Brandon Rush,SG,31,MIN,47,33,1030,70,187,0.374,44,114,0.386,26,73,0.356,13,18,0.722,16,83,99,45,22,23,28,42,197
2017,Brian Roberts,PG,31,CHO,41,2,416,46,122,0.377,17,44,0.386,29,78,0.372,33,39,0.846,5,34,39,52,9,1,26,18,142
2017,Briante Weber,PG,24,TOT,20,0,205,25,60,0.417,1,10,0.1,24,50,0.48,11,16,0.688,8,18,26,21,12,1,8,16,62
2017,Briante Weber,PG,24,GSW,7,0,46,5,14,0.357,0,3,0,5,11,0.455,2,3,0.667,0,4,4,5,3,1,3,4,12
2017,Briante Weber,PG,24,CHO,13,0,159,20,46,0.435,1,7,0.143,19,39,0.487,9,13,0.692,8,14,22,16,9,0,5,12,50
2017,Brice Johnson,PF,22,LAC,3,0,9,2,7,0.286,0,0,,2,7,0.286,0,0,,1,2,3,1,2,1,1,0,4
2017,Brook Lopez,C,28,BRK,75,75,2222,555,1172,0.474,134,387,0.346,421,785,0.536,295,364,0.81,121,282,403,176,38,124,184,192,1539
2017,Bruno Caboclo,SF,21,TOR,9,0,40,6,16,0.375,2,6,0.333,4,10,0.4,0,0,,5,5,10,4,2,1,2,4,14
2017,Bryn Forbes,SG,23,SAS,36,0,285,36,99,0.364,17,53,0.321,19,46,0.413,5,6,0.833,2,21,23,23,1,0,11,20,94
2017,Buddy Hield,SG,24,TOT,82,55,1888,327,767,0.426,148,379,0.391,179,388,0.461,64,76,0.842,35,234,269,121,38,9,101,115,866
2017,Buddy Hield,SG,24,NOP,57,37,1161,185,471,0.393,89,241,0.369,96,230,0.417,29,33,0.879,19,147,166,77,18,7,48,81,488
2017,Buddy Hield,SG,24,SAC,25,18,727,142,296,0.48,59,138,0.428,83,158,0.525,35,43,0.814,16,87,103,44,20,2,53,34,378
2017,C.J. Miles,SF,29,IND,76,29,1776,281,647,0.434,169,409,0.413,112,238,0.471,84,93,0.903,30,199,229,48,46,25,40,151,815
2017,C.J. Watson,PG,32,ORL,62,9,1012,96,248,0.387,32,105,0.305,64,143,0.448,57,66,0.864,16,73,89,114,43,2,47,84,281
2017,C.J. Wilcox,SG,26,ORL,22,0,108,8,31,0.258,3,15,0.2,5,16,0.313,2,2,1,4,8,12,12,2,1,6,8,21
2017,Cameron Payne,PG,22,TOT,31,0,462,64,193,0.332,27,86,0.314,37,107,0.346,5,8,0.625,3,45,48,55,14,4,29,52,160
2017,Cameron Payne,PG,22,OKC,20,0,320,43,130,0.331,16,52,0.308,27,78,0.346,4,4,1,2,29,31,40,10,4,16,38,106
2017,Cameron Payne,PG,22,CHI,11,0,142,21,63,0.333,11,34,0.324,10,29,0.345,1,4,0.25,1,16,17,15,4,0,13,14,54
2017,Caris LeVert,SF,22,BRK,57,26,1237,171,380,0.45,59,184,0.321,112,196,0.571,67,93,0.72,23,165,188,110,49,8,59,91,468
2017,Carmelo Anthony,SF,32,NYK,74,74,2538,602,1389,0.433,151,421,0.359,451,968,0.466,304,365,0.833,62,376,438,213,60,34,153,198,1659
2017,Chandler Parsons,SF,28,MEM,34,34,675,75,222,0.338,25,93,0.269,50,129,0.388,35,43,0.814,6,78,84,55,20,5,24,52,210
2017,Channing Frye,C,33,CLE,74,15,1398,238,520,0.458,137,335,0.409,101,185,0.546,63,74,0.851,37,253,290,45,33,37,53,138,676
2017,Chasson Randle,PG,23,TOT,26,0,299,40,98,0.408,16,47,0.34,24,51,0.471,41,43,0.953,6,26,32,34,9,2,19,39,137
2017,Chasson Randle,PG,23,PHI,8,0,74,12,26,0.462,6,15,0.4,6,11,0.545,12,12,1,0,5,5,6,3,1,3,11,42
2017,Chasson Randle,PG,23,NYK,18,0,225,28,72,0.389,10,32,0.313,18,40,0.45,29,31,0.935,6,21,27,28,6,1,16,28,95
2017,Cheick Diallo,PF,20,NOP,17,0,199,36,76,0.474,0,0,,36,76,0.474,15,21,0.714,23,50,73,4,4,7,7,17,87
2017,Chinanu Onuaku,C,20,HOU,5,1,52,5,7,0.714,0,0,,5,7,0.714,4,4,1,2,8,10,3,3,1,4,6,14
2017,Chris Andersen,C,38,CLE,12,0,114,9,22,0.409,0,3,0,9,19,0.474,10,14,0.714,9,22,31,5,5,7,5,20,28
2017,Chris McCullough,PF,21,TOT,16,0,80,16,32,0.5,1,7,0.143,15,25,0.6,3,5,0.6,9,10,19,2,2,2,3,7,36
2017,Chris McCullough,PF,21,BRK,14,0,72,16,31,0.516,1,6,0.167,15,25,0.6,2,3,0.667,9,8,17,2,1,2,2,7,35
2017,Chris McCullough,PF,21,WAS,2,0,8,0,1,0,0,1,0,0,0,,1,2,0.5,0,2,2,0,1,0,1,0,1
2017,Chris Paul,PG,31,LAC,61,61,1921,374,785,0.476,124,302,0.411,250,483,0.518,232,260,0.892,40,264,304,563,119,8,147,146,1104
2017,Christian Wood,PF,21,CHO,13,0,107,12,23,0.522,0,5,0,12,18,0.667,11,15,0.733,14,15,29,2,3,6,7,11,35
2017,CJ McCollum,SG,25,POR,80,80,2796,692,1441,0.48,185,439,0.421,507,1002,0.506,268,294,0.912,60,229,289,285,72,42,172,202,1837
2017,Clint Capela,C,22,HOU,65,59,1551,362,563,0.643,0,0,,362,563,0.643,94,177,0.531,178,348,526,63,34,79,87,179,818
2017,Cody Zeller,C,24,CHO,62,58,1725,253,443,0.571,0,1,0,253,442,0.572,133,196,0.679,135,270,405,99,62,58,65,189,639
2017,Cole Aldrich,C,28,MIN,62,0,531,45,86,0.523,0,0,,45,86,0.523,15,22,0.682,51,107,158,25,25,23,17,85,105
2017,Corey Brewer,SF,30,TOT,82,11,1281,147,348,0.422,27,118,0.229,120,230,0.522,50,68,0.735,32,134,166,97,61,20,55,133,371
2017,Corey Brewer,SF,30,HOU,58,8,923,94,227,0.414,22,94,0.234,72,133,0.541,32,44,0.727,21,93,114,61,37,12,36,104,242
2017,Corey Brewer,SF,30,LAL,24,3,358,53,121,0.438,5,24,0.208,48,97,0.495,18,24,0.75,11,41,52,36,24,8,19,29,129
2017,Cory Joseph,PG,25,TOR,80,22,2003,299,661,0.452,48,135,0.356,251,526,0.477,94,122,0.77,51,184,235,265,66,13,108,140,740
2017,Courtney Lee,SG,31,NYK,77,74,2459,321,704,0.456,108,269,0.401,213,435,0.49,85,98,0.867,53,206,259,179,81,24,69,141,835
2017,Cristiano Felício,C,24,CHI,66,0,1040,128,221,0.579,0,0,,128,221,0.579,60,93,0.645,124,187,311,40,25,17,33,110,316
2017,D.J. Augustin,PG,29,ORL,78,20,1538,195,517,0.377,95,274,0.347,100,243,0.412,131,161,0.814,15,102,117,209,31,1,90,101,616
2017,D'Angelo Russell,PG,20,LAL,63,60,1811,351,867,0.405,135,384,0.352,216,483,0.447,147,188,0.782,31,190,221,303,87,16,176,130,984
2017,Dahntay Jones,SF,36,CLE,1,0,12,3,8,0.375,0,2,0,3,6,0.5,3,4,0.75,1,1,2,1,0,0,1,1,9
2017,Damian Jones,C,21,GSW,10,0,85,8,16,0.5,0,0,,8,16,0.5,3,10,0.3,9,14,23,0,1,4,6,15,19
2017,Damian Lillard,PG,26,POR,75,75,2694,661,1488,0.444,214,579,0.37,447,909,0.492,488,545,0.895,46,322,368,440,68,20,197,152,2024
2017,Damjan Rudež,SF,30,ORL,45,0,314,31,88,0.352,20,64,0.313,11,24,0.458,0,0,,5,20,25,20,12,1,9,31,82
2017,Daniel Ochefu,C,23,WAS,19,0,75,12,27,0.444,0,0,,12,27,0.444,0,2,0,5,17,22,3,2,0,3,17,24
2017,Danilo Gallinari,SF,28,DEN,63,63,2134,335,750,0.447,126,324,0.389,209,426,0.491,349,387,0.902,39,286,325,135,40,15,82,93,1145
2017,Danny Green,SG,29,SAS,68,68,1807,176,449,0.392,118,311,0.379,58,138,0.42,27,32,0.844,31,193,224,124,70,57,76,120,497
2017,Dante Cunningham,PF,29,NOP,66,35,1649,174,359,0.485,71,181,0.392,103,178,0.579,16,27,0.593,56,221,277,37,39,28,28,100,435
2017,Dante Exum,PG,21,UTA,66,26,1228,155,363,0.427,44,149,0.295,111,214,0.519,58,73,0.795,30,102,132,111,21,12,80,146,412
2017,Danuel House Jr.,SG,23,WAS,1,0,1,0,0,,0,0,,0,0,,0,0,,0,1,1,0,0,0,0,0,0
2017,Dario Šarić,PF,22,PHI,81,36,2129,381,927,0.411,106,341,0.311,275,586,0.469,172,220,0.782,112,401,513,182,57,30,183,162,1040
2017,Darrell Arthur,PF,28,DEN,41,7,639,95,215,0.442,53,117,0.453,42,98,0.429,19,22,0.864,25,87,112,42,19,21,36,76,262
2017,Darren Collison,PG,29,SAC,68,64,2063,340,714,0.476,73,175,0.417,267,539,0.495,147,171,0.86,23,129,152,312,67,9,114,119,900
2017,Darrun Hilliard,SG,23,DET,39,1,381,47,126,0.373,12,46,0.261,35,80,0.438,21,28,0.75,2,31,33,33,11,2,28,39,127
2017,David Lee,PF,33,SAS,79,10,1477,248,420,0.59,0,0,,248,420,0.59,80,113,0.708,149,292,441,124,31,40,82,125,576
2017,David Nwaba,SG,24,LAL,20,2,397,47,81,0.58,1,5,0.2,46,76,0.605,25,39,0.641,17,46,63,14,13,7,11,36,120
2017,David West,C,36,GSW,68,0,854,135,252,0.536,3,8,0.375,132,244,0.541,43,56,0.768,47,156,203,151,42,48,78,105,316
2017,Dāvis Bertāns,PF,24,SAS,67,6,808,103,234,0.44,69,173,0.399,34,61,0.557,28,34,0.824,22,76,98,46,20,28,32,75,303
2017,DeAndre Jordan,C,28,LAC,81,81,2570,412,577,0.714,0,2,0,412,575,0.717,205,425,0.482,298,816,1114,96,51,134,115,212,1029
2017,DeAndre Liggins,SG,28,TOT,62,19,777,55,142,0.387,17,46,0.37,38,96,0.396,25,40,0.625,20,88,108,54,47,14,42,81,152
2017,DeAndre Liggins,SG,28,CLE,61,19,752,52,136,0.382,17,45,0.378,35,91,0.385,23,37,0.622,17,84,101,54,45,14,42,78,144
2017,DeAndre Liggins,SG,28,DAL,1,0,25,3,6,0.5,0,1,0,3,5,0.6,2,3,0.667,3,4,7,0,2,0,0,3,8
2017,DeAndre' Bembry,SF,22,ATL,38,1,371,47,98,0.48,1,18,0.056,46,80,0.575,6,16,0.375,14,45,59,28,8,5,16,21,101
2017,Dejounte Murray,PG,20,SAS,38,8,322,50,116,0.431,9,23,0.391,41,93,0.441,21,30,0.7,6,36,42,48,8,6,38,29,130
2017,Delon Wright,PG,24,TOR,27,0,446,49,116,0.422,10,30,0.333,39,86,0.453,42,55,0.764,16,32,48,57,27,11,25,31,150
2017,DeMar DeRozan,SG,27,TOR,74,74,2620,721,1545,0.467,33,124,0.266,688,1421,0.484,545,647,0.842,70,316,386,290,78,13,180,134,2020
2017,DeMarcus Cousins,C,26,TOT,72,72,2465,647,1432,0.452,131,363,0.361,516,1069,0.483,517,670,0.772,152,642,794,332,100,93,269,278,1942
2017,DeMarcus Cousins,C,26,SAC,55,55,1891,505,1118,0.452,95,267,0.356,410,851,0.482,423,549,0.77,115,468,583,266,75,74,207,203,1528
2017,DeMarcus Cousins,C,26,NOP,17,17,574,142,314,0.452,36,96,0.375,106,218,0.486,94,121,0.777,37,174,211,66,25,19,62,75,414
2017,DeMarre Carroll,SF,30,TOR,72,72,1882,220,550,0.4,109,320,0.341,111,230,0.483,89,117,0.761,63,212,275,74,81,27,54,143,638
2017,Demetrius Jackson,PG,22,BOS,5,0,17,3,4,0.75,1,1,1,2,3,0.667,3,6,0.5,2,2,4,3,0,0,0,0,10
2017,Dennis Schröder,PG,23,ATL,79,78,2485,548,1214,0.451,100,294,0.34,448,920,0.487,218,255,0.855,42,206,248,499,74,16,258,149,1414
2017,Denzel Valentine,SG,23,CHI,57,0,976,102,288,0.354,73,208,0.351,29,80,0.363,14,18,0.778,11,140,151,63,30,7,49,86,291
2017,Deron Williams,PG,32,TOT,64,44,1657,263,600,0.438,85,234,0.363,178,366,0.486,90,109,0.826,14,133,147,360,31,8,138,138,701
2017,Deron Williams,PG,32,DAL,40,40,1171,195,453,0.43,63,181,0.348,132,272,0.485,69,84,0.821,13,89,102,274,25,2,98,96,522
2017,Deron Williams,PG,32,CLE,24,4,486,68,147,0.463,22,53,0.415,46,94,0.489,21,25,0.84,1,44,45,86,6,6,40,42,179
2017,Derrick Favors,PF,25,UTA,50,39,1186,203,417,0.487,3,10,0.3,200,407,0.491,67,109,0.615,92,213,305,56,45,40,60,103,476
2017,Derrick Jones Jr.,SF,19,PHO,32,8,545,68,121,0.562,3,11,0.273,65,110,0.591,29,41,0.707,39,40,79,12,14,13,13,63,168
2017,Derrick Rose,PG,28,NYK,64,64,2082,460,977,0.471,13,60,0.217,447,917,0.487,221,253,0.874,66,180,246,283,44,17,147,84,1154
2017,Derrick Williams,PF,25,TOT,50,11,804,108,244,0.443,30,97,0.309,78,147,0.531,58,89,0.652,19,111,130,28,14,7,28,60,304
2017,Derrick Williams,PF,25,MIA,25,11,377,54,137,0.394,9,45,0.2,45,92,0.489,31,50,0.62,16,57,73,14,9,5,14,33,148
2017,Derrick Williams,PF,25,CLE,25,0,427,54,107,0.505,21,52,0.404,33,55,0.6,27,39,0.692,3,54,57,14,5,2,14,27,156
2017,Devin Booker,SG,20,PHO,78,78,2730,606,1431,0.423,147,405,0.363,459,1026,0.447,367,441,0.832,46,203,249,268,72,21,241,242,1726
2017,Devin Harris,PG,33,DAL,65,0,1087,136,341,0.399,58,177,0.328,78,164,0.476,107,129,0.829,11,116,127,136,43,7,57,101,437
2017,Dewayne Dedmon,C,27,SAS,76,37,1330,161,259,0.622,0,0,,161,259,0.622,65,93,0.699,129,367,496,44,37,61,61,180,387
2017,Deyonta Davis,C,20,MEM,36,0,238,24,47,0.511,0,0,,24,47,0.511,10,18,0.556,20,40,60,2,3,17,8,40,58
2017,Diamond Stone,C,19,LAC,7,0,24,3,13,0.231,0,0,,3,13,0.231,4,4,1,1,5,6,0,0,1,2,5,10
2017,Dion Waiters,SG,25,MIA,46,43,1384,281,663,0.424,85,215,0.395,196,448,0.438,82,127,0.646,18,135,153,200,42,20,103,95,729
2017,Dirk Nowitzki,PF,38,DAL,54,54,1424,296,678,0.437,79,209,0.378,217,469,0.463,98,112,0.875,23,330,353,82,30,38,51,113,769
2017,Domantas Sabonis,PF,20,OKC,81,66,1632,192,481,0.399,51,159,0.321,141,322,0.438,44,67,0.657,46,242,288,82,39,32,83,200,479
2017,Donatas Motiejūnas,PF,26,NOP,34,0,479,57,138,0.413,11,47,0.234,46,91,0.505,25,49,0.51,26,75,101,32,18,11,31,55,150
2017,Dorian Finney-Smith,PF,23,DAL,81,35,1642,124,333,0.372,56,191,0.293,68,142,0.479,46,61,0.754,55,167,222,67,52,25,45,125,350
2017,Doug McDermott,SF,25,TOT,66,5,1508,222,497,0.447,77,208,0.37,145,289,0.502,71,84,0.845,20,159,179,58,13,5,38,79,592
2017,Doug McDermott,SF,25,CHI,44,4,1078,166,373,0.445,56,150,0.373,110,223,0.493,59,67,0.881,14,116,130,45,11,4,32,57,447
2017,Doug McDermott,SF,25,OKC,22,1,430,56,124,0.452,21,58,0.362,35,66,0.53,12,17,0.706,6,43,49,13,2,1,6,22,145
2017,Dragan Bender,PF,19,PHO,43,0,574,57,161,0.354,28,101,0.277,29,60,0.483,4,11,0.364,23,80,103,23,10,22,32,74,146
2017,Draymond Green,PF,26,GSW,76,76,2471,272,650,0.418,81,263,0.308,191,387,0.494,151,213,0.709,98,501,599,533,154,106,184,217,776
2017,Dwight Howard,C,31,ATL,74,74,2199,388,613,0.633,0,2,0,388,611,0.635,226,424,0.533,296,644,940,104,64,92,170,203,1002
2017,Dwight Powell,C,25,DAL,77,3,1333,194,377,0.515,21,74,0.284,173,303,0.571,107,141,0.759,93,213,306,49,61,39,34,135,516
2017,Dwyane Wade,SG,35,CHI,60,59,1792,414,955,0.434,45,145,0.31,369,810,0.456,223,281,0.794,63,207,270,228,86,41,138,112,1096
2017,E'Twaun Moore,SG,27,NOP,73,22,1820,283,619,0.457,77,208,0.37,206,411,0.501,57,74,0.77,33,119,152,164,50,32,62,131,700
2017,Ed Davis,PF,27,POR,46,12,789,75,142,0.528,0,0,,75,142,0.528,50,81,0.617,96,148,244,26,15,22,37,137,200
2017,Edy Tavares,C,24,TOT,2,0,28,4,5,0.8,0,0,,4,5,0.8,0,3,0,4,7,11,1,0,6,2,3,8
2017,Edy Tavares,C,24,ATL,1,0,4,1,1,1,0,0,,1,1,1,0,2,0,0,1,1,0,0,0,0,0,2
2017,Edy Tavares,C,24,CLE,1,0,24,3,4,0.75,0,0,,3,4,0.75,0,1,0,4,6,10,1,0,6,2,3,6
2017,Elfrid Payton,PG,22,ORL,82,58,2412,430,912,0.471,40,146,0.274,390,766,0.509,146,211,0.692,89,298,387,529,88,40,178,177,1046
2017,Elijah Millsap,SG,29,PHO,2,0,23,1,7,0.143,0,2,0,1,5,0.2,1,2,0.5,3,3,6,1,0,0,2,2,3
2017,Emmanuel Mudiay,PG,20,DEN,55,41,1406,208,551,0.377,56,178,0.315,152,373,0.408,131,167,0.784,29,149,178,217,41,13,123,95,603
2017,Enes Freedom,C,24,OKC,72,0,1533,402,737,0.545,5,38,0.132,397,699,0.568,224,285,0.786,195,287,482,67,32,38,123,154,1033
2017,Eric Bledsoe,PG,27,PHO,66,66,2176,449,1034,0.434,104,310,0.335,345,724,0.477,388,458,0.847,52,268,320,418,91,31,224,164,1390
2017,Eric Gordon,SG,28,HOU,75,15,2323,412,1016,0.406,246,661,0.372,166,355,0.468,147,175,0.84,29,172,201,188,48,41,121,150,1217
2017,Ersan İlyasova,PF,29,TOT,82,52,2142,384,890,0.431,142,402,0.353,242,488,0.496,161,207,0.778,115,366,481,141,58,23,116,211,1071
2017,Ersan İlyasova,PF,29,OKC,3,0,62,6,16,0.375,3,12,0.25,3,4,0.75,0,0,,2,14,16,1,3,1,4,5,15
2017,Ersan İlyasova,PF,29,PHI,53,40,1447,285,648,0.44,107,298,0.359,178,350,0.509,109,142,0.768,71,243,314,97,33,14,78,133,786
2017,Ersan İlyasova,PF,29,ATL,26,12,633,93,226,0.412,32,92,0.348,61,134,0.455,52,65,0.8,42,109,151,43,22,8,34,73,270
2017,Evan Fournier,SG,24,ORL,68,66,2234,408,930,0.439,128,360,0.356,280,570,0.491,223,277,0.805,44,165,209,202,66,4,141,180,1167
2017,Evan Turner,SF,28,POR,65,12,1658,235,552,0.426,31,118,0.263,204,434,0.47,85,103,0.825,36,211,247,205,53,24,100,121,586
2017,Frank Kaminsky,C,23,CHO,75,16,1954,320,802,0.399,116,354,0.328,204,448,0.455,118,156,0.756,57,279,336,162,46,34,76,139,874
2017,Fred VanVleet,PG,22,TOR,37,0,294,39,111,0.351,11,29,0.379,28,82,0.341,18,22,0.818,4,38,42,35,16,3,15,36,107
2017,Garrett Temple,SG,30,SAC,65,21,1728,183,432,0.424,82,220,0.373,101,212,0.476,58,74,0.784,32,152,184,168,84,28,78,141,506
2017,Gary Harris,SG,22,DEN,57,56,1782,320,637,0.502,107,255,0.42,213,382,0.558,104,134,0.776,48,130,178,164,71,8,76,92,851
2017,Gary Neal,SG,32,ATL,2,0,18,0,7,0,0,2,0,0,5,0,4,4,1,0,1,1,1,0,0,0,1,4
2017,Gary Payton II,PG,24,MIL,6,0,99,8,22,0.364,1,9,0.111,7,13,0.538,3,5,0.6,0,12,12,13,3,4,10,9,20
2017,George Hill,PG,30,UTA,49,49,1544,289,606,0.477,94,233,0.403,195,373,0.523,157,196,0.801,23,144,167,204,50,11,85,114,829
2017,Georges Niang,PF,23,IND,23,0,93,9,36,0.25,1,12,0.083,8,24,0.333,2,2,1,2,15,17,5,3,0,5,6,21
2017,Georgios Papagiannis,C,19,SAC,22,0,355,56,102,0.549,0,2,0,56,100,0.56,12,14,0.857,24,62,86,20,3,17,24,44,124
2017,Gerald Green,SF,31,BOS,47,0,538,95,232,0.409,39,111,0.351,56,121,0.463,33,41,0.805,16,68,84,33,9,7,25,48,262
2017,Gerald Henderson,SG,29,PHI,72,41,1667,234,553,0.423,61,173,0.353,173,380,0.455,133,165,0.806,34,151,185,112,40,15,62,129,662
2017,Giannis Antetokounmpo,SF,22,MIL,80,80,2845,656,1259,0.521,49,180,0.272,607,1079,0.563,471,612,0.77,142,558,700,434,131,151,234,246,1832
2017,Glenn Robinson III,SF,23,IND,69,27,1427,158,338,0.467,49,125,0.392,109,213,0.512,54,76,0.711,57,189,246,47,41,20,37,63,419
2017,Goran Dragić,PG,30,MIA,73,73,2459,534,1124,0.475,117,289,0.405,417,835,0.499,298,377,0.79,62,217,279,423,89,13,212,199,1483
2017,Gordon Hayward,SF,26,UTA,73,73,2516,545,1156,0.471,149,374,0.398,396,782,0.506,362,429,0.844,49,345,394,252,73,20,140,117,1601
2017,Gorgui Dieng,PF,27,MIN,82,82,2653,332,661,0.502,16,43,0.372,316,618,0.511,136,167,0.814,188,459,647,158,88,95,107,254,816
2017,Greg Monroe,C,26,MIL,81,0,1823,387,726,0.533,0,4,0,387,722,0.536,177,239,0.741,167,365,532,187,92,38,140,168,951
2017,Greivis Vásquez,PG,30,BRK,3,0,39,2,8,0.25,1,3,0.333,1,5,0.2,2,3,0.667,0,2,2,5,1,1,1,6,7
2017,Harrison Barnes,PF,24,DAL,79,79,2803,599,1280,0.468,78,222,0.351,521,1058,0.492,242,281,0.861,93,301,394,116,65,15,102,128,1518
2017,Hassan Whiteside,C,27,MIA,77,77,2513,542,973,0.557,0,0,,542,973,0.557,225,358,0.628,293,795,1088,57,57,161,154,226,1309
2017,Henry Ellenson,PF,20,DET,19,2,146,23,64,0.359,10,35,0.286,13,29,0.448,4,8,0.5,8,33,41,7,1,1,14,6,60
2017,Hollis Thompson,SG,25,TOT,40,9,752,77,200,0.385,32,95,0.337,45,105,0.429,19,29,0.655,19,93,112,35,20,6,11,69,205
2017,Hollis Thompson,SG,25,PHI,31,1,561,66,159,0.415,26,71,0.366,40,88,0.455,13,20,0.65,15,69,84,26,14,6,9,55,171
2017,Hollis Thompson,SG,25,NOP,9,8,191,11,41,0.268,6,24,0.25,5,17,0.294,6,9,0.667,4,24,28,9,6,0,2,14,34
2017,Ian Clark,SG,25,GSW,77,0,1137,211,433,0.487,61,163,0.374,150,270,0.556,44,58,0.759,22,99,121,90,39,8,55,77,527
2017,Ian Mahinmi,C,30,WAS,31,0,555,65,111,0.586,0,0,,65,111,0.586,43,75,0.573,47,103,150,19,33,24,34,90,173
2017,Iman Shumpert,SG,26,CLE,76,31,1937,201,489,0.411,94,261,0.36,107,228,0.469,71,90,0.789,39,179,218,109,62,27,78,150,567
2017,Isaiah Canaan,SG,25,CHI,39,0,592,63,173,0.364,25,94,0.266,38,79,0.481,30,33,0.909,6,44,50,37,22,1,21,35,181
2017,Isaiah Taylor,PG,22,HOU,4,0,52,1,7,0.143,0,2,0,1,5,0.2,1,2,0.5,1,2,3,3,1,1,0,6,3
2017,Isaiah Thomas,PG,27,BOS,76,76,2569,682,1473,0.463,245,646,0.379,437,827,0.528,590,649,0.909,43,162,205,448,70,13,210,167,2199
2017,Isaiah Whitehead,PG,21,BRK,73,26,1643,204,508,0.402,44,149,0.295,160,359,0.446,91,113,0.805,32,152,184,192,42,36,142,175,543
2017,Ish Smith,PG,28,DET,81,32,1955,329,749,0.439,28,105,0.267,301,644,0.467,72,102,0.706,21,214,235,418,61,33,112,127,758
2017,Ivica Zubac,C,19,LAL,38,11,609,126,238,0.529,0,3,0,126,235,0.536,32,49,0.653,41,118,159,30,14,33,30,66,284
2017,J.J. Barea,PG,32,DAL,35,6,771,142,343,0.414,53,148,0.358,89,195,0.456,44,51,0.863,9,75,84,193,14,1,63,30,381
2017,J.J. Redick,SG,32,LAC,78,78,2198,396,890,0.445,201,468,0.429,195,422,0.462,180,202,0.891,11,160,171,110,54,13,98,125,1173
2017,J.R. Smith,SG,31,CLE,41,35,1187,123,356,0.346,95,271,0.351,28,85,0.329,10,15,0.667,17,96,113,62,40,11,26,77,351
2017,Jabari Parker,PF,21,MIL,51,50,1728,399,814,0.49,65,178,0.365,334,636,0.525,162,218,0.743,79,235,314,142,50,22,93,111,1025
2017,Jae Crowder,SF,26,BOS,72,72,2335,333,720,0.463,157,394,0.398,176,326,0.54,176,217,0.811,48,367,415,155,73,23,80,161,999
2017,Jahlil Okafor,C,21,PHI,50,33,1134,242,471,0.514,0,0,,242,471,0.514,106,158,0.671,81,159,240,58,20,49,91,122,590
2017,Jake Layman,SF,22,POR,35,1,249,26,89,0.292,13,51,0.255,13,38,0.342,13,17,0.765,6,18,24,11,9,3,11,22,78
2017,Jakob Poeltl,C,21,TOR,54,4,626,67,115,0.583,0,0,,67,115,0.583,31,57,0.544,78,87,165,12,17,20,29,113,165
2017,Jamal Crawford,SG,36,LAC,82,1,2157,359,870,0.413,116,322,0.36,243,548,0.443,174,203,0.857,17,112,129,214,61,14,134,115,1008
2017,Jamal Murray,SG,19,DEN,82,10,1764,295,730,0.404,115,344,0.334,180,386,0.466,106,120,0.883,41,173,214,170,51,24,113,124,811
2017,Jameer Nelson,PG,34,DEN,75,39,2045,268,604,0.444,106,273,0.388,162,331,0.489,45,63,0.714,28,164,192,385,54,8,128,197,687
2017,James Ennis III,SF,26,MEM,64,28,1501,146,321,0.455,51,137,0.372,95,184,0.516,86,110,0.782,69,190,259,64,46,19,59,165,429
2017,James Harden,PG,27,HOU,81,81,2947,674,1533,0.44,262,756,0.347,412,777,0.53,746,881,0.847,95,564,659,907,121,38,464,215,2356
2017,James Johnson,PF,29,MIA,76,5,2085,368,769,0.479,87,256,0.34,281,513,0.548,152,215,0.707,66,310,376,276,76,86,171,197,975
2017,James Jones,SF,36,CLE,48,2,381,44,92,0.478,31,66,0.47,13,26,0.5,13,20,0.65,3,34,37,14,6,10,10,37,132
2017,James Michael McAdoo,PF,24,GSW,52,2,457,62,117,0.53,2,8,0.25,60,109,0.55,21,42,0.5,34,57,91,18,18,29,19,47,147
2017,James Young,SG,21,BOS,29,0,220,25,58,0.431,12,35,0.343,13,23,0.565,6,9,0.667,6,20,26,4,10,2,4,15,68
2017,JaMychal Green,PF,26,MEM,77,75,2101,250,500,0.5,55,145,0.379,195,355,0.549,134,167,0.802,167,377,544,84,47,34,94,248,689
2017,Jared Dudley,PF,31,PHO,64,7,1362,157,346,0.454,77,203,0.379,80,143,0.559,43,65,0.662,31,194,225,121,42,16,73,154,434
2017,Jared Sullinger,PF,24,TOR,11,1,118,15,47,0.319,3,18,0.167,12,29,0.414,4,8,0.5,10,17,27,3,4,1,4,17,37
2017,Jarell Eddie,SF,25,PHO,5,0,62,6,19,0.316,4,16,0.25,2,3,0.667,8,9,0.889,1,6,7,0,1,0,1,1,24
2017,Jarell Martin,PF,22,MEM,42,3,558,58,151,0.384,9,25,0.36,49,126,0.389,40,50,0.8,42,120,162,8,17,9,28,91,165
2017,Jarnell Stokes,C,23,DEN,2,0,7,1,1,1,0,0,,1,1,1,1,2,0.5,1,1,2,2,1,0,0,3,3
2017,Jarrett Jack,PG,33,NOP,2,0,33,2,3,0.667,0,1,0,2,2,1,2,2,1,0,0,0,5,2,0,3,4,6
2017,Jarrod Uthoff,PF,23,DAL,9,0,115,16,38,0.421,3,9,0.333,13,29,0.448,5,7,0.714,8,14,22,9,2,4,3,8,40
2017,Jason Smith,C,30,WAS,74,3,1068,174,329,0.529,37,78,0.474,137,251,0.546,35,51,0.686,64,194,258,37,21,54,58,168,420
2017,Jason Terry,SG,39,MIL,74,0,1365,105,243,0.432,73,171,0.427,32,72,0.444,24,29,0.828,15,91,106,98,46,20,36,95,307
2017,JaVale McGee,C,29,GSW,77,10,739,208,319,0.652,0,3,0,208,316,0.658,56,111,0.505,100,144,244,17,19,67,40,109,472
2017,Jaylen Brown,SF,20,BOS,78,20,1341,192,423,0.454,46,135,0.341,146,288,0.507,85,124,0.685,45,175,220,64,35,18,68,142,515
2017,Jeff Green,PF,30,ORL,69,11,1534,220,558,0.394,53,193,0.275,167,365,0.458,145,168,0.863,39,175,214,81,37,13,75,103,638
2017,Jeff Teague,PG,28,IND,82,82,2657,402,909,0.442,90,252,0.357,312,657,0.475,360,415,0.867,33,297,330,639,100,32,216,165,1254
2017,Jeff Withey,C,26,UTA,51,1,432,55,103,0.534,0,1,0,55,102,0.539,36,48,0.75,52,69,121,7,16,32,14,52,146
2017,Jerami Grant,PF,22,TOT,80,4,1531,152,328,0.463,43,116,0.371,109,212,0.514,90,147,0.612,38,167,205,46,33,79,44,149,437
2017,Jerami Grant,PF,22,PHI,2,0,41,6,17,0.353,0,2,0,6,15,0.4,4,8,0.5,0,6,6,0,0,4,3,5,16
2017,Jerami Grant,PF,22,OKC,78,4,1490,146,311,0.469,43,114,0.377,103,197,0.523,86,139,0.619,38,161,199,46,33,75,41,144,421
2017,Jeremy Lamb,SG,24,CHO,62,5,1143,226,491,0.46,41,146,0.281,185,345,0.536,110,129,0.853,30,234,264,75,27,23,40,98,603
2017,Jeremy Lin,PG,28,BRK,36,33,883,175,400,0.438,58,156,0.372,117,244,0.48,115,141,0.816,11,124,135,184,42,14,86,79,523
2017,Jerian Grant,PG,24,CHI,63,28,1028,128,301,0.425,49,134,0.366,79,167,0.473,65,73,0.89,17,94,111,121,47,8,44,93,370
2017,Jerryd Bayless,PG,28,PHI,3,1,71,11,32,0.344,2,5,0.4,9,27,0.333,9,10,0.9,3,9,12,13,0,0,9,4,33
2017,Jimmy Butler,SF,27,CHI,76,75,2809,570,1252,0.455,91,248,0.367,479,1004,0.477,585,676,0.865,129,341,470,417,143,32,159,112,1816
2017,Joakim Noah,C,31,NYK,46,46,1015,99,202,0.49,0,1,0,99,201,0.493,34,78,0.436,162,241,403,103,30,37,58,127,232
2017,Jodie Meeks,SG,29,ORL,36,10,738,103,256,0.402,56,137,0.409,47,119,0.395,65,74,0.878,5,72,77,45,34,4,36,41,327
2017,Joe Harris,SG,25,BRK,52,11,1138,154,362,0.425,85,221,0.385,69,141,0.489,35,49,0.714,16,131,147,54,30,8,55,121,428
2017,Joe Ingles,SF,29,UTA,82,26,1972,204,451,0.452,123,279,0.441,81,172,0.471,50,68,0.735,23,238,261,225,96,8,107,163,581
2017,Joe Johnson,SF,35,UTA,78,14,1843,273,626,0.436,106,258,0.411,167,368,0.454,63,77,0.818,33,210,243,144,36,18,69,93,715
2017,Joe Young,PG,24,IND,33,0,135,26,72,0.361,5,23,0.217,21,49,0.429,11,15,0.733,1,16,17,15,4,0,5,5,68
2017,Joel Anthony,C,34,SAS,19,0,122,10,16,0.625,0,0,,10,16,0.625,5,8,0.625,8,23,31,3,2,6,4,11,25
2017,Joel Bolomboy,PF,23,UTA,12,0,53,9,16,0.563,1,4,0.25,8,12,0.667,3,6,0.5,4,13,17,2,1,2,2,1,22
2017,Joel Embiid,C,22,PHI,31,31,786,200,429,0.466,36,98,0.367,164,331,0.495,191,244,0.783,61,182,243,66,27,76,117,112,627
2017,Joffrey Lauvergne,PF-C,25,TOT,70,1,980,148,336,0.44,33,98,0.337,115,238,0.483,46,73,0.63,72,179,251,70,25,6,56,83,375
2017,Joffrey Lauvergne,PF,25,OKC,50,0,739,111,244,0.455,27,78,0.346,84,166,0.506,37,58,0.638,51,132,183,51,18,6,40,71,286
2017,Joffrey Lauvergne,C,25,CHI,20,1,241,37,92,0.402,6,20,0.3,31,72,0.431,9,15,0.6,21,47,68,19,7,0,16,12,89
2017,John Henson,C,26,MIL,58,39,1123,159,309,0.515,0,1,0,159,308,0.516,74,107,0.692,92,203,295,57,29,78,52,151,392
2017,John Jenkins,SG,25,PHO,4,0,13,2,5,0.4,1,2,0.5,1,3,0.333,2,2,1,0,1,1,1,0,0,0,0,7
2017,John Lucas III,PG,34,MIN,5,0,11,1,4,0.25,0,1,0,1,3,0.333,0,0,,0,0,0,1,2,0,0,0,2
2017,John Wall,PG,26,WAS,78,78,2836,647,1435,0.451,89,272,0.327,558,1163,0.48,422,527,0.801,59,267,326,831,157,49,322,151,1805
2017,Johnny O'Bryant,PF,23,TOT,11,0,80,15,30,0.5,3,6,0.5,12,24,0.5,5,6,0.833,9,10,19,6,0,1,6,10,38
2017,Johnny O'Bryant,PF,23,DEN,7,0,46,7,15,0.467,2,3,0.667,5,12,0.417,4,4,1,5,6,11,2,0,1,3,4,20
2017,Johnny O'Bryant,PF,23,CHO,4,0,34,8,15,0.533,1,3,0.333,7,12,0.583,1,2,0.5,4,4,8,4,0,0,3,6,18
2017,Jon Leuer,PF,27,DET,75,34,1944,310,646,0.48,49,167,0.293,261,479,0.545,98,113,0.867,102,300,402,111,31,26,66,145,767
2017,Jonas Jerebko,PF,29,BOS,78,6,1232,114,262,0.435,45,130,0.346,69,132,0.523,26,37,0.703,59,213,272,71,25,17,39,122,299
2017,Jonas Valančiūnas,C,24,TOR,80,80,2066,391,702,0.557,1,2,0.5,390,700,0.557,176,217,0.811,226,533,759,57,37,63,106,216,959
2017,Jonathan Gibson,PG,29,DAL,17,0,231,35,95,0.368,15,45,0.333,20,50,0.4,21,29,0.724,1,21,22,26,8,0,21,21,106
2017,Jonathon Simmons,SG,27,SAS,78,8,1392,177,421,0.42,30,102,0.294,147,319,0.461,99,132,0.75,20,140,160,126,47,25,76,146,483
2017,Jordan Clarkson,SG,24,LAL,82,19,2397,477,1071,0.445,117,356,0.329,360,715,0.503,134,168,0.798,49,197,246,213,88,8,164,150,1205
2017,Jordan Crawford,SG,28,NOP,19,0,442,105,218,0.482,37,95,0.389,68,123,0.553,20,26,0.769,4,30,34,57,11,2,25,30,267
2017,Jordan Farmar,PG,30,SAC,2,0,35,4,12,0.333,4,9,0.444,0,3,0,0,0,,1,2,3,9,2,0,3,1,12
2017,Jordan Hill,C,29,MIN,7,0,47,5,13,0.385,0,0,,5,13,0.385,2,2,1,8,6,14,0,1,0,4,9,12
2017,Jordan McRae,SG,25,CLE,37,4,384,58,150,0.387,18,51,0.353,40,99,0.404,27,34,0.794,6,35,41,19,8,6,14,31,161
2017,Jordan Mickey,PF,22,BOS,25,1,141,15,34,0.441,0,1,0,15,33,0.455,8,14,0.571,13,21,34,7,3,6,9,12,38
2017,José Calderón,PG,35,TOT,41,13,539,55,134,0.41,20,64,0.313,35,70,0.5,11,12,0.917,15,59,74,88,11,1,41,36,141
2017,José Calderón,PG,35,LAL,24,11,292,32,77,0.416,12,34,0.353,20,43,0.465,4,4,1,8,34,42,51,7,1,26,22,80
2017,José Calderón,PG,35,ATL,17,2,247,23,57,0.404,8,30,0.267,15,27,0.556,7,8,0.875,7,25,32,37,4,0,15,14,61
2017,Josh Huestis,PF,25,OKC,2,0,31,6,11,0.545,2,4,0.5,4,7,0.571,0,1,0,4,5,9,3,0,3,0,0,14
2017,Josh McRoberts,PF,29,MIA,22,14,381,44,118,0.373,13,31,0.419,31,87,0.356,6,9,0.667,23,51,74,50,10,4,23,31,107
2017,Josh Richardson,SG,23,MIA,53,34,1614,202,513,0.394,75,227,0.33,127,286,0.444,60,77,0.779,35,133,168,140,60,39,65,132,539
2017,Jrue Holiday,PG,26,NOP,67,61,2190,405,893,0.454,100,281,0.356,305,612,0.498,119,168,0.708,46,218,264,488,100,44,194,133,1029
2017,Juancho Hernangómez,PF,21,DEN,62,9,842,101,224,0.451,46,113,0.407,55,111,0.495,57,76,0.75,43,144,187,29,30,12,31,62,305
2017,Julius Randle,PF,22,LAL,74,73,2132,377,773,0.488,17,63,0.27,360,710,0.507,204,282,0.723,150,486,636,264,49,37,173,248,975
2017,Justin Anderson,SF,23,TOT,75,10,1228,186,439,0.424,58,194,0.299,128,245,0.522,102,129,0.791,69,176,245,66,41,23,66,109,532
2017,Justin Anderson,SF,23,DAL,51,2,710,111,277,0.401,37,122,0.303,74,155,0.477,70,88,0.795,39,110,149,32,28,16,40,64,329
2017,Justin Anderson,SF,23,PHI,24,8,518,75,162,0.463,21,72,0.292,54,90,0.6,32,41,0.78,30,66,96,34,13,7,26,45,203
2017,Justin Hamilton,C,26,BRK,64,7,1177,174,379,0.459,55,180,0.306,119,199,0.598,39,52,0.75,71,191,262,55,29,43,43,91,442
2017,Justin Harper,PF,27,PHI,3,0,31,5,12,0.417,2,7,0.286,3,5,0.6,0,0,,2,3,5,2,0,0,4,2,12
2017,Justin Holiday,SG,27,NYK,82,4,1639,233,538,0.433,97,273,0.355,136,265,0.513,66,80,0.825,27,198,225,102,65,31,66,109,629
2017,Justise Winslow,SF,20,MIA,18,15,625,80,225,0.356,7,35,0.2,73,190,0.384,29,47,0.617,23,71,94,66,26,6,33,52,196
2017,Jusuf Nurkić,C,22,TOT,65,48,1391,271,534,0.507,0,1,0,271,533,0.508,120,210,0.571,154,313,467,123,50,74,143,161,662
2017,Jusuf Nurkić,C,22,DEN,45,29,807,151,298,0.507,0,0,,151,298,0.507,56,113,0.496,89,171,260,60,25,36,81,88,358
2017,Jusuf Nurkić,C,22,POR,20,19,584,120,236,0.508,0,1,0,120,235,0.511,64,97,0.66,65,142,207,63,25,38,62,73,304
2017,K.J. McDaniels,SF,23,TOT,49,0,505,77,169,0.456,20,66,0.303,57,103,0.553,32,38,0.842,15,67,82,13,19,18,29,49,206
2017,K.J. McDaniels,SF,23,HOU,29,0,212,31,68,0.456,9,27,0.333,22,41,0.537,9,10,0.9,6,24,30,4,7,8,10,24,80
2017,K.J. McDaniels,SF,23,BRK,20,0,293,46,101,0.455,11,39,0.282,35,62,0.565,23,28,0.821,9,43,52,9,12,10,19,25,126
2017,Karl-Anthony Towns,C,21,MIN,82,82,3030,802,1480,0.542,101,275,0.367,701,1205,0.582,356,428,0.832,296,711,1007,220,56,103,212,241,2061
2017,Kawhi Leonard,SF,25,SAS,74,74,2474,636,1312,0.485,147,387,0.38,489,925,0.529,469,533,0.88,80,350,430,260,133,55,154,122,1888
2017,Kay Felder,PG,21,CLE,42,0,386,62,158,0.392,7,22,0.318,55,136,0.404,35,49,0.714,3,38,41,58,18,7,30,38,166
2017,Kelly Olynyk,C,25,BOS,75,6,1538,260,508,0.512,68,192,0.354,192,316,0.608,90,123,0.732,73,288,361,148,43,29,96,207,678
2017,Kelly Oubre Jr.,SF,21,WAS,79,5,1605,186,442,0.421,54,188,0.287,132,254,0.52,75,99,0.758,61,200,261,47,58,17,50,195,501
2017,Kemba Walker,PG,26,CHO,79,79,2739,643,1449,0.444,240,602,0.399,403,847,0.476,304,359,0.847,45,263,308,434,85,22,168,119,1830
2017,Kenneth Faried,PF,27,DEN,61,34,1296,228,416,0.548,0,6,0,228,410,0.556,131,189,0.693,183,279,462,55,43,40,59,124,587
2017,Kent Bazemore,SF,27,ATL,73,64,1963,295,721,0.409,92,266,0.346,203,455,0.446,119,168,0.708,45,186,231,177,91,52,125,165,801
2017,Kentavious Caldwell-Pope,SG,23,DET,76,75,2529,370,928,0.399,153,437,0.35,217,491,0.442,154,185,0.832,55,193,248,193,89,12,86,118,1047
2017,Kevin Durant,PF,28,GSW,62,62,2070,551,1026,0.537,117,312,0.375,434,714,0.608,336,384,0.875,39,474,513,300,66,99,138,117,1555
2017,Kevin Love,PF,28,CLE,60,60,1885,370,867,0.427,145,389,0.373,225,478,0.471,257,295,0.871,148,518,666,116,53,21,122,125,1142
2017,Kevin Séraphin,PF,27,IND,49,3,559,109,198,0.551,0,2,0,109,196,0.556,14,22,0.636,41,101,142,23,7,20,29,66,232
2017,Kevon Looney,C,20,GSW,53,4,447,56,107,0.523,2,9,0.222,54,98,0.551,21,34,0.618,44,80,124,29,15,17,17,64,135
2017,Khris Middleton,SF,25,MIL,29,23,889,150,333,0.45,45,104,0.433,105,229,0.459,81,92,0.88,11,112,123,99,41,7,65,79,426
2017,Klay Thompson,SG,26,GSW,78,78,2649,644,1376,0.468,268,647,0.414,376,729,0.516,186,218,0.853,49,236,285,160,66,40,128,139,1742
2017,Kosta Koufos,C,27,SAC,71,62,1419,216,392,0.551,0,1,0,216,391,0.552,38,62,0.613,118,285,403,47,36,48,61,172,470
2017,Kris Dunn,PG,22,MIN,78,7,1333,118,313,0.377,21,73,0.288,97,240,0.404,36,59,0.61,24,142,166,188,78,36,89,178,293
2017,Kris Humphries,PF,31,ATL,56,4,689,87,214,0.407,19,54,0.352,68,160,0.425,64,82,0.78,60,146,206,29,15,21,28,69,257
2017,Kristaps Porziņģis,PF,21,NYK,66,65,2164,443,985,0.45,112,314,0.357,331,671,0.493,198,252,0.786,111,364,475,97,47,129,118,244,1196
2017,Kyle Anderson,SF,23,SAS,72,14,1020,93,209,0.445,15,40,0.375,78,169,0.462,45,57,0.789,33,175,208,91,51,26,39,63,246
2017,Kyle Korver,SG,35,TOT,67,22,1753,239,515,0.464,162,359,0.451,77,156,0.494,38,42,0.905,7,179,186,110,34,21,69,107,678
2017,Kyle Korver,SG,35,ATL,32,21,894,108,246,0.439,65,159,0.409,43,87,0.494,24,27,0.889,0,89,89,75,23,13,40,47,305
2017,Kyle Korver,SG,35,CLE,35,1,859,131,269,0.487,97,200,0.485,34,69,0.493,14,15,0.933,7,90,97,35,11,8,29,60,373
2017,Kyle Lowry,PG,30,TOR,60,60,2244,426,918,0.464,193,468,0.412,233,450,0.518,299,365,0.819,48,238,286,417,88,19,173,170,1344
2017,Kyle O'Quinn,C,26,NYK,79,8,1229,215,413,0.521,2,17,0.118,213,396,0.538,64,83,0.771,157,282,439,117,36,104,76,174,496
2017,Kyle Singler,SF,28,OKC,32,2,385,34,83,0.41,7,37,0.189,27,46,0.587,13,17,0.765,8,40,48,9,7,5,11,29,88
2017,Kyle Wiltjer,PF,24,HOU,14,0,44,4,14,0.286,4,13,0.308,0,1,0,1,2,0.5,4,6,10,2,3,1,5,4,13
2017,Kyrie Irving,PG,24,CLE,72,72,2525,671,1420,0.473,177,441,0.401,494,979,0.505,297,328,0.905,52,178,230,418,83,24,180,157,1816
2017,Lamar Patterson,SG,25,ATL,5,0,40,3,15,0.2,1,6,0.167,2,9,0.222,2,3,0.667,1,6,7,6,1,0,4,6,9
2017,LaMarcus Aldridge,PF,31,SAS,72,72,2335,500,1049,0.477,23,56,0.411,477,993,0.48,220,271,0.812,172,351,523,139,46,88,98,158,1243
2017,Lance Stephenson,SG,26,TOT,18,0,361,54,120,0.45,6,20,0.3,48,100,0.48,8,13,0.615,4,48,52,59,5,3,26,32,122
2017,Lance Stephenson,SG,26,NOP,6,0,162,26,55,0.473,1,10,0.1,25,45,0.556,5,8,0.625,3,15,18,29,2,1,11,18,58
2017,Lance Stephenson,SG,26,MIN,6,0,67,10,21,0.476,0,2,0,10,19,0.526,1,2,0.5,0,10,10,5,0,0,4,2,21
2017,Lance Stephenson,SG,26,IND,6,0,132,18,44,0.409,5,8,0.625,13,36,0.361,2,3,0.667,1,23,24,25,3,2,11,12,43
2017,Lance Thomas,PF,28,NYK,46,15,968,97,244,0.398,38,85,0.447,59,159,0.371,43,51,0.843,32,110,142,35,21,5,25,85,275
2017,Langston Galloway,PG,25,TOT,74,2,1495,207,545,0.38,120,308,0.39,87,237,0.367,51,64,0.797,27,129,156,93,46,6,46,96,585
2017,Langston Galloway,PG,25,NOP,55,0,1120,165,441,0.374,101,268,0.377,64,173,0.37,40,52,0.769,20,101,121,65,40,5,28,76,471
2017,Langston Galloway,PG,25,SAC,19,2,375,42,104,0.404,19,40,0.475,23,64,0.359,11,12,0.917,7,28,35,28,6,1,18,20,114
2017,Larry Nance Jr.,PF,24,LAL,63,7,1442,190,361,0.526,10,36,0.278,180,325,0.554,59,80,0.738,120,249,369,96,82,39,56,149,449
2017,Larry Sanders,C,28,CLE,5,0,13,1,4,0.25,0,0,,1,4,0.25,2,2,1,3,1,4,0,1,1,2,5,4
2017,Lavoy Allen,PF,27,IND,61,5,871,77,168,0.458,0,1,0,77,167,0.461,23,33,0.697,105,114,219,57,18,24,29,78,177
2017,Leandro Barbosa,SG,34,PHO,67,0,963,172,392,0.439,35,98,0.357,137,294,0.466,40,45,0.889,15,89,104,81,31,8,48,82,419
2017,LeBron James,SF,32,CLE,74,74,2794,736,1344,0.548,124,342,0.363,612,1002,0.611,358,531,0.674,97,542,639,646,92,44,303,134,1954
2017,Lou Williams,SG,30,TOT,81,1,1994,428,998,0.429,163,446,0.365,265,552,0.48,402,457,0.88,26,176,202,239,80,20,160,92,1421
2017,Lou Williams,SG,30,LAL,58,1,1403,326,734,0.444,122,317,0.385,204,417,0.489,304,344,0.884,14,118,132,183,65,11,120,67,1078
2017,Lou Williams,SG,30,HOU,23,0,591,102,264,0.386,41,129,0.318,61,135,0.452,98,113,0.867,12,58,70,56,15,9,40,25,343
2017,Luc Mbah a Moute,SF,30,LAC,80,76,1787,191,378,0.505,43,110,0.391,148,268,0.552,59,87,0.678,44,126,170,39,81,35,46,122,484
2017,Lucas Nogueira,C,24,TOR,57,6,1088,103,156,0.66,3,12,0.25,100,144,0.694,44,67,0.657,82,162,244,42,52,89,46,137,253
2017,Luis Scola,PF,36,BRK,36,1,461,71,151,0.47,17,50,0.34,54,101,0.535,25,37,0.676,51,88,139,37,14,4,34,63,184
2017,Luke Babbitt,SF,27,MIA,68,55,1065,113,281,0.402,87,210,0.414,26,71,0.366,11,15,0.733,12,129,141,36,20,11,25,118,324
2017,Luol Deng,SF,31,LAL,56,49,1486,164,424,0.387,51,165,0.309,113,259,0.436,46,63,0.73,63,232,295,74,48,20,43,61,425
2017,Malachi Richardson,SG,21,SAC,22,0,198,28,68,0.412,8,28,0.286,20,40,0.5,15,19,0.789,3,20,23,11,5,1,8,23,79
2017,Malcolm Brogdon,SG,24,MIL,75,28,1982,290,635,0.457,78,193,0.404,212,442,0.48,109,126,0.865,47,166,213,317,84,12,113,140,767
2017,Malcolm Delaney,PG,27,ATL,73,2,1248,145,388,0.374,26,110,0.236,119,278,0.428,75,93,0.806,10,113,123,193,39,1,95,112,391
2017,Malik Beasley,SG,20,DEN,22,1,165,33,73,0.452,9,28,0.321,24,45,0.533,8,10,0.8,5,12,17,11,7,0,8,10,83
2017,Manny Harris,SG,27,DAL,4,0,25,3,15,0.2,0,2,0,3,13,0.231,2,4,0.5,3,6,9,2,0,0,2,1,8
2017,Manu Ginóbili*,SG,39,SAS,69,0,1291,171,439,0.39,89,227,0.392,82,212,0.387,86,107,0.804,28,129,157,183,82,16,96,119,517
2017,Marc Gasol,C,32,MEM,74,74,2531,532,1160,0.459,104,268,0.388,428,892,0.48,278,332,0.837,60,404,464,338,67,99,166,171,1446
2017,Marcelo Huertas,PG,33,LAL,23,1,237,25,68,0.368,4,19,0.211,21,49,0.429,9,17,0.529,2,22,24,52,10,2,19,16,63
2017,Marcin Gortat,C,32,WAS,82,82,2556,390,674,0.579,0,2,0,390,672,0.58,103,159,0.648,238,611,849,121,40,61,119,213,883
2017,Marco Belinelli,SG,30,CHO,74,0,1778,264,615,0.429,102,283,0.36,162,332,0.488,150,168,0.893,14,164,178,147,44,9,70,90,780
2017,Marcus Georges-Hunt,SG,22,ORL,5,0,48,2,7,0.286,1,2,0.5,1,5,0.2,9,10,0.9,1,8,9,3,1,0,2,5,14
2017,Marcus Morris,SF,27,DET,79,79,2565,421,1007,0.418,118,357,0.331,303,650,0.466,145,185,0.784,77,289,366,160,52,25,87,168,1105
2017,Marcus Smart,SG,22,BOS,79,24,2399,269,749,0.359,94,332,0.283,175,417,0.42,203,250,0.812,78,227,305,364,125,34,159,192,835
2017,Marcus Thornton,SG,29,WAS,33,1,575,84,210,0.4,28,80,0.35,56,130,0.431,23,27,0.852,22,54,76,41,19,3,25,48,219
2017,Mario Hezonja,SF,21,ORL,65,2,960,117,330,0.355,43,144,0.299,74,186,0.398,40,50,0.8,20,126,146,62,30,15,58,74,317
2017,Markieff Morris,PF,27,WAS,76,76,2374,406,889,0.457,71,196,0.362,335,693,0.483,180,215,0.837,107,386,493,126,82,42,129,254,1063
2017,Marquese Chriss,PF,19,PHO,82,75,1743,284,632,0.449,72,224,0.321,212,408,0.52,113,181,0.624,96,252,348,60,67,70,108,263,753
2017,Marreese Speights,C,29,LAC,82,2,1286,244,548,0.445,103,277,0.372,141,271,0.52,120,137,0.876,88,285,373,65,23,41,69,229,711
2017,Marshall Plumlee,C,24,NYK,21,1,170,16,30,0.533,0,0,,16,30,0.533,8,19,0.421,23,28,51,10,4,4,12,23,40
2017,Marvin Williams,PF,30,CHO,76,76,2295,297,704,0.422,124,354,0.35,173,350,0.494,131,150,0.873,89,411,500,106,58,53,60,134,849
2017,Mason Plumlee,C,26,TOT,81,64,2148,334,623,0.536,0,6,0,334,617,0.541,174,300,0.58,170,435,605,284,69,92,134,226,842
2017,Mason Plumlee,C,26,POR,54,54,1516,235,442,0.532,0,5,0,235,437,0.538,127,224,0.567,120,312,432,214,50,63,88,149,597
2017,Mason Plumlee,C,26,DEN,27,10,632,99,181,0.547,0,1,0,99,180,0.55,47,76,0.618,50,123,173,70,19,29,46,77,245
2017,Matt Barnes,SF,36,TOT,74,18,1777,185,473,0.391,87,263,0.331,98,210,0.467,70,89,0.787,70,314,384,195,48,26,107,185,527
2017,Matt Barnes,SF,36,SAC,54,13,1367,147,383,0.384,69,211,0.327,78,172,0.453,50,66,0.758,55,238,293,150,36,17,83,138,413
2017,Matt Barnes,SF,36,GSW,20,5,410,38,90,0.422,18,52,0.346,20,38,0.526,20,23,0.87,15,76,91,45,12,9,24,47,114
2017,Matthew Dellavedova,PG,26,MIL,76,54,1986,208,534,0.39,79,215,0.367,129,319,0.404,82,96,0.854,24,123,147,357,53,0,133,153,577
2017,Maurice Harkless,SF,23,POR,77,69,2223,314,624,0.503,68,194,0.351,246,430,0.572,77,124,0.621,125,216,341,88,85,70,86,214,773
2017,Maurice Ndour,PF,24,NYK,32,4,331,39,86,0.453,1,7,0.143,38,79,0.481,19,26,0.731,22,42,64,8,15,8,12,30,98
2017,Metta World Peace,SF,37,LAL,25,2,160,19,68,0.279,9,38,0.237,10,30,0.333,10,16,0.625,5,15,20,11,10,2,7,18,57
2017,Meyers Leonard,PF,24,POR,74,12,1222,146,378,0.386,74,213,0.347,72,165,0.436,35,40,0.875,27,210,237,71,13,28,35,172,401
2017,Michael Beasley,PF,28,MIL,56,6,935,216,406,0.532,18,43,0.419,198,363,0.545,78,105,0.743,40,153,193,53,27,27,66,92,528
2017,Michael Carter-Williams,PG,25,CHI,45,19,846,112,306,0.366,15,64,0.234,97,242,0.401,58,77,0.753,24,129,153,113,38,23,66,102,297
2017,Michael Gbinije,SG,24,DET,9,0,32,1,10,0.1,0,4,0,1,6,0.167,2,2,1,2,1,3,2,0,0,0,2,4
2017,Michael Kidd-Gilchrist,SF,23,CHO,81,81,2349,295,618,0.477,1,9,0.111,294,609,0.483,152,194,0.784,156,409,565,114,81,77,56,187,743
2017,Mike Conley,PG,29,MEM,69,68,2292,464,1009,0.46,171,419,0.408,293,590,0.497,316,368,0.859,31,210,241,433,92,19,156,126,1415
2017,Mike Dunleavy,SF,36,TOT,53,2,841,93,220,0.423,53,134,0.396,40,86,0.465,36,45,0.8,18,97,115,50,15,7,28,67,275
2017,Mike Dunleavy,SF,36,CLE,23,2,366,36,90,0.4,20,57,0.351,16,33,0.485,14,19,0.737,5,42,47,20,6,2,14,32,106
2017,Mike Dunleavy,SF,36,ATL,30,0,475,57,130,0.438,33,77,0.429,24,53,0.453,22,26,0.846,13,55,68,30,9,5,14,35,169
2017,Mike Miller,SF,36,DEN,20,0,151,9,23,0.391,8,20,0.4,1,3,0.333,2,2,1,2,36,38,22,2,0,13,9,28
2017,Mike Muscala,C,25,ATL,70,3,1237,170,337,0.504,46,110,0.418,124,227,0.546,49,64,0.766,76,164,240,95,30,41,55,97,435
2017,Mike Scott,PF,28,ATL,18,0,195,17,59,0.288,4,27,0.148,13,32,0.406,7,8,0.875,10,27,37,17,4,3,8,12,45
2017,Mike Tobey,C,22,CHO,2,0,25,1,4,0.25,0,0,,1,4,0.25,0,0,,2,1,3,1,0,0,1,2,2
2017,Miles Plumlee,C,28,TOT,45,12,484,44,92,0.478,0,0,,44,92,0.478,25,39,0.641,38,57,95,21,18,13,30,73,113
2017,Miles Plumlee,C,28,MIL,32,12,310,30,68,0.441,0,0,,30,68,0.441,22,35,0.629,23,30,53,18,11,9,22,48,82
2017,Miles Plumlee,C,28,CHO,13,0,174,14,24,0.583,0,0,,14,24,0.583,3,4,0.75,15,27,42,3,7,4,8,25,31
2017,Mindaugas Kuzminskas,SF,27,NYK,68,5,1016,158,369,0.428,54,168,0.321,104,201,0.517,55,68,0.809,47,79,126,69,29,11,51,79,425
2017,Mirza Teletović,PF,31,MIL,70,2,1133,156,418,0.373,104,305,0.341,52,113,0.46,35,45,0.778,11,151,162,48,12,13,37,109,451
2017,Monta Ellis,SG,31,IND,74,33,1998,247,557,0.443,43,135,0.319,204,422,0.483,93,128,0.727,19,185,204,236,78,27,135,149,630
2017,Montrezl Harrell,C,23,HOU,58,14,1064,225,345,0.652,1,7,0.143,224,338,0.663,76,121,0.628,81,138,219,64,20,42,44,126,527
2017,Myles Turner,C,20,IND,81,81,2541,444,869,0.511,40,115,0.348,404,754,0.536,245,303,0.809,139,450,589,106,74,172,105,262,1173
2017,Nemanja Bjelica,PF,28,MIN,65,1,1190,151,356,0.424,56,177,0.316,95,179,0.531,45,61,0.738,57,187,244,79,40,20,59,154,403
2017,Nenê,C,34,HOU,67,8,1198,245,397,0.617,3,9,0.333,242,388,0.624,116,197,0.589,95,187,282,65,56,39,73,163,609
2017,Nerlens Noel,C,22,TOT,51,19,1047,184,309,0.595,0,1,0,184,308,0.597,77,111,0.694,93,201,294,50,65,50,51,126,445
2017,Nerlens Noel,C,22,PHI,29,7,564,107,175,0.611,0,1,0,107,174,0.615,43,63,0.683,46,98,144,30,43,26,29,71,257
2017,Nerlens Noel,C,22,DAL,22,12,483,77,134,0.575,0,0,,77,134,0.575,34,48,0.708,47,103,150,20,22,24,22,55,188
2017,Nick Collison,PF,36,OKC,20,0,128,14,23,0.609,0,1,0,14,22,0.636,5,8,0.625,9,22,31,12,2,2,4,17,33
2017,Nick Young,SG,31,LAL,60,60,1556,272,633,0.43,170,421,0.404,102,212,0.481,77,90,0.856,25,113,138,58,37,14,36,137,791
2017,Nicolas Batum,SG,28,CHO,77,77,2617,393,975,0.403,135,405,0.333,258,570,0.453,243,284,0.856,46,435,481,456,86,29,194,109,1164
2017,Nicolás Brussino,SG,23,DAL,54,2,521,52,141,0.369,29,95,0.305,23,46,0.5,17,22,0.773,26,69,95,47,17,8,26,43,150
2017,Nicolás Laprovíttola,PG,27,SAS,18,3,174,20,47,0.426,10,27,0.37,10,20,0.5,9,9,1,1,9,10,28,4,1,19,19,59
2017,Nik Stauskas,SG,23,PHI,80,27,2188,251,634,0.396,132,359,0.368,119,275,0.433,122,150,0.813,21,205,226,188,45,32,128,144,756
2017,Nikola Jokić,C,21,DEN,73,59,2038,494,854,0.578,45,139,0.324,449,715,0.628,188,228,0.825,212,506,718,359,61,55,171,214,1221
2017,Nikola Mirotić,PF,25,CHI,70,15,1679,258,625,0.413,129,377,0.342,129,248,0.52,99,128,0.773,61,323,384,75,53,55,80,128,744
2017,Nikola Vučević,C,26,ORL,75,55,2163,483,1031,0.468,23,75,0.307,460,956,0.481,107,160,0.669,176,603,779,208,76,74,117,180,1096
2017,Noah Vonleh,PF,21,POR,74,41,1265,130,270,0.481,7,20,0.35,123,250,0.492,60,94,0.638,131,256,387,31,30,27,64,154,327
2017,Norman Powell,SG,23,TOR,76,18,1368,227,506,0.449,56,173,0.324,171,333,0.514,126,159,0.792,26,143,169,82,52,14,70,127,636
2017,Norris Cole,PG,28,OKC,13,0,125,16,52,0.308,3,13,0.231,13,39,0.333,8,10,0.8,0,11,11,14,8,0,7,18,43
2017,Okaro White,PF,24,MIA,35,0,471,33,87,0.379,12,34,0.353,21,53,0.396,20,22,0.909,25,57,82,21,10,10,18,52,98
2017,Ömer Aşık,C,30,NOP,31,19,482,31,65,0.477,0,0,,31,65,0.477,23,39,0.59,48,115,163,15,5,10,14,51,85
2017,Omri Casspi,PF,28,TOT,36,2,643,77,164,0.47,15,43,0.349,62,121,0.512,17,29,0.586,27,85,112,37,23,3,29,50,186
2017,Omri Casspi,PF,28,SAC,22,2,397,53,117,0.453,11,29,0.379,42,88,0.477,12,21,0.571,20,70,90,26,10,1,17,23,129
2017,Omri Casspi,PF,28,NOP,1,0,24,5,9,0.556,2,4,0.5,3,5,0.6,0,0,,1,1,2,0,0,0,2,3,12
2017,Omri Casspi,PF,28,MIN,13,0,222,19,38,0.5,2,10,0.2,17,28,0.607,5,8,0.625,6,14,20,11,13,2,10,24,45
2017,Otto Porter Jr.,SF,23,WAS,80,80,2605,414,803,0.516,148,341,0.434,266,462,0.576,99,119,0.832,118,396,514,121,116,42,44,193,1075
2017,P.J. Tucker,SF,31,TOT,81,21,2236,199,482,0.413,70,196,0.357,129,286,0.451,72,93,0.774,117,354,471,99,116,19,66,196,540
2017,P.J. Tucker,SF,31,PHO,57,17,1627,147,354,0.415,46,136,0.338,101,218,0.463,61,77,0.792,94,248,342,73,85,14,52,143,401
2017,P.J. Tucker,SF,31,TOR,24,4,609,52,128,0.406,24,60,0.4,28,68,0.412,11,16,0.688,23,106,129,26,31,5,14,53,139
2017,Pascal Siakam,PF,22,TOR,55,38,859,103,205,0.502,1,7,0.143,102,198,0.515,22,32,0.688,64,121,185,17,26,45,33,109,229
2017,Pat Connaughton,SG,24,POR,39,1,316,37,72,0.514,17,33,0.515,20,39,0.513,7,9,0.778,10,42,52,28,6,2,17,23,98
2017,Patricio Garino,SG,23,ORL,5,0,43,0,7,0,0,5,0,0,2,0,0,0,,1,6,7,0,0,0,3,4,0
2017,Patrick Beverley,SG,28,HOU,67,67,2058,228,543,0.42,110,288,0.382,118,255,0.463,73,95,0.768,95,298,393,281,99,25,100,222,639
2017,Patrick McCaw,SG,21,GSW,71,20,1074,106,245,0.433,41,123,0.333,65,122,0.533,29,37,0.784,21,79,100,77,32,15,36,62,282
2017,Patrick Patterson,PF,27,TOR,65,8,1599,154,384,0.401,94,253,0.372,60,131,0.458,43,60,0.717,62,231,293,76,40,23,38,120,445
2017,Patty Mills,PG,28,SAS,80,8,1754,273,621,0.44,147,355,0.414,126,266,0.474,66,80,0.825,24,117,141,280,65,3,101,109,759
2017,Pau Gasol,C,36,SAS,64,39,1627,303,604,0.502,56,104,0.538,247,500,0.494,130,184,0.707,107,394,501,150,24,70,81,110,792
2017,Paul George,SF,26,IND,75,75,2689,622,1348,0.461,195,496,0.393,427,852,0.501,336,374,0.898,58,434,492,251,119,27,220,206,1775
2017,Paul Millsap,PF,31,ATL,69,67,2343,430,972,0.442,75,241,0.311,355,731,0.486,311,405,0.768,111,422,533,252,90,62,158,186,1246
2017,Paul Pierce*,SF,39,LAC,25,7,277,28,70,0.4,15,43,0.349,13,27,0.481,10,13,0.769,1,47,48,10,4,5,16,40,81
2017,Paul Zipser,SF,22,CHI,44,18,843,88,221,0.398,33,99,0.333,55,122,0.451,31,40,0.775,15,110,125,36,15,16,40,78,240
2017,Pierre Jackson,PG,25,DAL,8,1,84,13,39,0.333,3,11,0.273,10,28,0.357,6,7,0.857,1,8,9,19,2,0,3,5,35
2017,Quincy Acy,PF,26,TOT,38,1,558,70,170,0.412,37,90,0.411,33,80,0.413,45,60,0.75,20,95,115,18,14,15,21,67,222
2017,Quincy Acy,PF,26,DAL,6,0,48,5,17,0.294,1,7,0.143,4,10,0.4,2,3,0.667,2,6,8,0,0,0,2,9,13
2017,Quincy Acy,PF,26,BRK,32,1,510,65,153,0.425,36,83,0.434,29,70,0.414,43,57,0.754,18,89,107,18,14,15,19,58,209
2017,Quinn Cook,PG,23,TOT,14,0,188,33,66,0.5,11,26,0.423,22,40,0.55,2,5,0.4,1,6,7,26,4,0,13,13,79
2017,Quinn Cook,PG,23,DAL,5,0,77,11,25,0.44,5,14,0.357,6,11,0.545,0,2,0,0,3,3,12,1,0,8,6,27
2017,Quinn Cook,PG,23,NOP,9,0,111,22,41,0.537,6,12,0.5,16,29,0.552,2,3,0.667,1,3,4,14,3,0,5,7,52
2017,R.J. Hunter,SG,23,CHI,3,0,9,0,1,0,0,1,0,0,0,,0,0,,0,1,1,0,0,0,0,0,0
2017,Rajon Rondo,PG,30,CHI,69,42,1843,229,561,0.408,50,133,0.376,179,428,0.418,30,50,0.6,73,282,355,461,99,11,169,144,538
2017,Rakeem Christmas,PF,25,IND,29,0,219,19,43,0.442,0,0,,19,43,0.442,21,29,0.724,26,30,56,4,3,6,8,37,59
2017,Ramon Sessions,PG,30,CHO,50,1,811,100,263,0.38,21,62,0.339,79,201,0.393,91,118,0.771,11,62,73,129,27,3,46,43,312
2017,Randy Foye,SG,33,BRK,69,40,1284,118,325,0.363,67,203,0.33,51,122,0.418,54,63,0.857,9,146,155,135,35,9,80,99,357
2017,Rashad Vaughn,SG,20,MIL,41,2,458,57,156,0.365,26,81,0.321,31,75,0.413,2,5,0.4,4,45,49,23,19,10,14,32,142
2017,Raul Neto,PG,24,UTA,40,0,346,41,91,0.451,10,31,0.323,31,60,0.517,8,9,0.889,4,26,30,34,21,5,15,48,100
2017,Raymond Felton,PG,32,LAC,80,11,1700,221,514,0.43,46,144,0.319,175,370,0.473,50,64,0.781,33,185,218,191,66,22,83,125,538
2017,Reggie Bullock,SF,25,DET,31,5,467,54,128,0.422,28,73,0.384,26,55,0.473,5,7,0.714,13,51,64,29,18,3,10,22,141
2017,Reggie Jackson,PG,26,DET,52,50,1424,284,677,0.419,66,184,0.359,218,493,0.442,118,136,0.868,21,93,114,270,35,5,114,129,752
2017,Reggie Williams,SF,30,NOP,6,0,79,8,23,0.348,5,11,0.455,3,12,0.25,6,7,0.857,2,4,6,4,3,0,0,2,27
2017,Richard Jefferson,SF,36,CLE,79,13,1614,153,343,0.446,62,186,0.333,91,157,0.58,80,108,0.741,28,175,203,78,26,10,52,153,448
2017,Richaun Holmes,C,23,PHI,57,17,1193,230,412,0.558,27,77,0.351,203,335,0.606,72,103,0.699,94,217,311,58,42,55,55,136,559
2017,Ricky Rubio,PG,26,MIN,75,75,2469,261,650,0.402,60,196,0.306,201,454,0.443,254,285,0.891,68,237,305,682,128,10,195,202,836
2017,Robert Covington,SF,26,PHI,67,67,2119,292,732,0.399,137,412,0.333,155,320,0.484,143,174,0.822,92,344,436,102,127,69,131,203,864
2017,Robin Lopez,C,28,CHI,81,81,2271,382,775,0.493,0,2,0,382,773,0.494,75,104,0.721,244,276,520,80,18,117,91,151,839
2017,Rodney Hood,SG,24,UTA,59,55,1593,272,666,0.408,114,307,0.371,158,359,0.44,90,115,0.783,16,186,202,96,38,11,65,132,748
2017,Rodney McGruder,SG,25,MIA,78,65,1966,190,460,0.413,73,220,0.332,117,240,0.488,44,71,0.62,94,162,256,124,46,18,56,140,497
2017,Rodney Stuckey,PG,30,IND,39,0,696,91,244,0.373,19,60,0.317,72,184,0.391,80,107,0.748,6,78,84,84,16,0,53,44,281
2017,Ron Baker,SG,23,NYK,52,13,857,82,217,0.378,23,86,0.267,59,131,0.45,28,43,0.651,12,86,98,107,34,8,56,74,215
2017,Rondae Hollis-Jefferson,SF,22,BRK,78,50,1761,235,542,0.434,15,67,0.224,220,475,0.463,190,253,0.751,96,356,452,154,82,44,116,177,675
2017,Ronnie Price,PG,33,PHO,14,0,134,4,24,0.167,3,17,0.176,1,7,0.143,3,4,0.75,3,8,11,18,11,1,3,14,14
2017,Roy Hibbert,C,30,TOT,48,13,682,80,147,0.544,0,0,,80,147,0.544,61,75,0.813,54,98,152,21,8,46,32,100,221
2017,Roy Hibbert,C,30,CHO,42,13,671,78,144,0.542,0,0,,78,144,0.542,61,75,0.813,53,97,150,20,8,44,31,97,217
2017,Roy Hibbert,C,30,DEN,6,0,11,2,3,0.667,0,0,,2,3,0.667,0,0,,1,1,2,1,0,2,1,3,4
2017,Rudy Gay,SF,30,SAC,30,30,1013,201,442,0.455,42,113,0.372,159,329,0.483,118,138,0.855,35,155,190,83,44,26,74,79,562
2017,Rudy Gobert,C,24,UTA,81,81,2744,413,625,0.661,0,1,0,413,624,0.662,311,476,0.653,314,721,1035,97,49,214,147,246,1137
2017,Russell Westbrook,PG,28,OKC,81,81,2802,824,1941,0.425,200,583,0.343,624,1358,0.459,710,840,0.845,137,727,864,840,132,31,438,190,2558
2017,Ryan Anderson,PF,28,HOU,72,72,2116,323,773,0.418,204,506,0.403,119,267,0.446,129,150,0.86,112,218,330,68,31,14,55,142,979
2017,Ryan Kelly,PF,25,ATL,16,0,110,8,28,0.286,4,10,0.4,4,18,0.222,5,6,0.833,1,17,18,8,4,5,4,5,25
2017,Salah Mejri,C,30,DAL,73,11,905,88,137,0.642,1,3,0.333,87,134,0.649,36,61,0.59,97,211,308,14,32,61,40,152,213
2017,Sam Dekker,PF,22,HOU,77,2,1419,203,429,0.473,60,187,0.321,143,242,0.591,38,68,0.559,94,190,284,76,38,21,41,83,504
2017,Sasha Vujačić,SG,32,NYK,42,4,408,42,136,0.309,23,74,0.311,19,62,0.306,17,24,0.708,12,47,59,52,13,2,16,38,124
2017,Sean Kilpatrick,SG,27,BRK,70,24,1754,305,735,0.415,105,308,0.341,200,427,0.468,204,242,0.843,22,258,280,157,45,6,135,118,919
2017,Semaj Christon,PG,24,OKC,64,1,973,77,223,0.345,12,63,0.19,65,160,0.406,17,31,0.548,19,68,87,130,28,7,43,79,183
2017,Serge Ibaka,PF,27,TOT,79,79,2422,471,982,0.48,124,317,0.391,347,665,0.522,107,125,0.856,129,409,538,75,41,124,105,215,1173
2017,Serge Ibaka,PF,27,ORL,56,56,1710,343,703,0.488,83,214,0.388,260,489,0.532,77,91,0.846,100,282,382,60,34,91,66,139,846
2017,Serge Ibaka,PF,27,TOR,23,23,712,128,279,0.459,41,103,0.398,87,176,0.494,30,34,0.882,29,127,156,15,7,33,39,76,327
2017,Sergio Rodríguez,PG,30,PHI,68,30,1518,210,536,0.392,92,252,0.365,118,284,0.415,18,27,0.667,21,136,157,344,49,4,128,95,530
2017,Seth Curry,PG,26,DAL,70,42,2029,338,703,0.481,137,322,0.425,201,381,0.528,85,100,0.85,25,154,179,189,79,7,92,126,898
2017,Shabazz Muhammad,SF,24,MIN,78,1,1516,288,598,0.482,49,145,0.338,239,453,0.528,147,190,0.774,84,136,220,35,22,6,56,86,772
2017,Shabazz Napier,PG,25,POR,53,2,512,73,183,0.399,34,92,0.37,39,91,0.429,38,49,0.776,8,53,61,67,32,2,41,38,218
2017,Shaun Livingston,PG,31,GSW,76,3,1345,173,316,0.547,1,3,0.333,172,313,0.55,42,60,0.7,28,123,151,139,38,20,62,120,389
2017,Shawn Long,C,24,PHI,18,0,234,61,109,0.56,7,19,0.368,54,90,0.6,19,35,0.543,41,44,85,13,9,9,13,49,148
2017,Sheldon Mac,SG,24,WAS,30,3,287,30,75,0.4,7,30,0.233,23,45,0.511,23,27,0.852,4,30,34,15,8,2,5,17,90
2017,Shelvin Mack,PG,26,UTA,55,9,1205,170,381,0.446,37,120,0.308,133,261,0.51,53,77,0.688,20,105,125,154,42,3,90,100,430
2017,Skal Labissière,PF,20,SAC,33,12,612,117,218,0.537,3,8,0.375,114,210,0.543,52,74,0.703,51,111,162,27,16,13,37,64,289
2017,Solomon Hill,SF,25,NOP,80,71,2374,183,478,0.383,94,270,0.348,89,208,0.428,103,128,0.805,51,256,307,141,72,32,82,182,563
2017,Spencer Dinwiddie,PG,23,BRK,59,18,1334,134,302,0.444,38,101,0.376,96,201,0.478,126,159,0.792,27,137,164,185,44,23,66,119,432
2017,Spencer Hawes,PF,28,TOT,54,1,797,134,277,0.484,25,81,0.309,109,196,0.556,44,52,0.846,38,153,191,81,15,30,49,77,337
2017,Spencer Hawes,PF,28,CHO,35,1,626,104,218,0.477,16,55,0.291,88,163,0.54,30,34,0.882,32,114,146,62,13,26,40,61,254
2017,Spencer Hawes,PF,28,MIL,19,0,171,30,59,0.508,9,26,0.346,21,33,0.636,14,18,0.778,6,39,45,19,2,4,9,16,83
2017,Stanley Johnson,SF,20,DET,77,1,1371,129,365,0.353,45,154,0.292,84,211,0.398,36,53,0.679,36,153,189,105,56,24,71,121,339
2017,Stephen Curry,PG,28,GSW,79,79,2638,675,1443,0.468,324,789,0.411,351,654,0.537,325,362,0.898,61,292,353,524,142,17,239,183,1999
2017,Stephen Zimmerman,C,20,ORL,19,0,108,10,31,0.323,0,0,,10,31,0.323,3,5,0.6,11,24,35,4,2,5,3,17,23
2017,Steve Novak,PF,33,MIL,8,0,22,2,7,0.286,1,6,0.167,1,1,1,0,0,,0,3,3,0,0,0,0,1,5
2017,Steven Adams,C,23,OKC,80,80,2389,374,655,0.571,0,1,0,374,654,0.572,157,257,0.611,281,332,613,86,89,78,146,195,905
2017,T.J. McConnell,PG,24,PHI,81,51,2133,236,512,0.461,11,55,0.2,225,457,0.492,73,90,0.811,39,212,251,534,134,10,159,139,556
2017,T.J. Warren,SF,23,PHO,66,59,2048,403,814,0.495,26,98,0.265,377,716,0.527,119,154,0.773,125,214,339,75,76,39,57,175,951
2017,Taj Gibson,PF,31,TOT,78,71,1989,365,709,0.515,3,13,0.231,362,696,0.52,113,158,0.715,158,327,485,73,41,65,105,163,846
2017,Taj Gibson,PF,31,CHI,55,55,1502,276,530,0.521,2,12,0.167,274,518,0.529,85,119,0.714,120,262,382,60,27,50,77,123,639
2017,Taj Gibson,PF,31,OKC,23,16,487,89,179,0.497,1,1,1,88,178,0.494,28,39,0.718,38,65,103,13,14,15,28,40,207
2017,Tarik Black,C,25,LAL,67,16,1091,150,294,0.51,1,2,0.5,149,292,0.51,82,109,0.752,144,199,343,39,29,44,58,173,383
2017,Taurean Prince,SF,22,ATL,59,10,981,114,285,0.4,33,102,0.324,81,183,0.443,74,94,0.787,25,132,157,55,43,27,61,96,335
2017,Terrence Jones,PF,25,TOT,54,12,1270,231,492,0.47,19,75,0.253,212,417,0.508,103,170,0.606,65,241,306,59,40,54,48,67,584
2017,Terrence Jones,PF,25,NOP,51,12,1264,231,489,0.472,19,75,0.253,212,414,0.512,103,170,0.606,65,238,303,59,39,53,48,67,584
2017,Terrence Jones,PF,25,MIL,3,0,6,0,3,0,0,0,,0,3,0,0,0,,0,3,3,0,1,1,0,0,0
2017,Terrence Ross,SF,25,TOT,78,24,1955,326,746,0.437,142,391,0.363,184,355,0.518,64,77,0.831,18,188,206,88,87,33,68,143,858
2017,Terrence Ross,SF,25,TOR,54,0,1207,211,479,0.441,96,256,0.375,115,223,0.516,41,50,0.82,14,124,138,45,53,20,33,82,559
2017,Terrence Ross,SF,25,ORL,24,24,748,115,267,0.431,46,135,0.341,69,132,0.523,23,27,0.852,4,64,68,43,34,13,35,61,299
2017,Terry Rozier,PG,22,BOS,74,0,1263,151,411,0.367,57,179,0.318,94,232,0.405,51,66,0.773,40,187,227,131,46,11,47,69,410
2017,Thabo Sefolosha,SF,32,ATL,62,42,1596,174,395,0.441,41,120,0.342,133,275,0.484,55,75,0.733,54,216,270,107,96,31,58,97,444
2017,Thaddeus Young,PF,28,IND,74,74,2237,362,687,0.527,45,118,0.381,317,569,0.557,45,86,0.523,131,317,448,122,113,29,95,135,814
2017,Thomas Robinson,PF,25,LAL,48,1,560,105,196,0.536,0,1,0,105,195,0.538,31,66,0.47,84,139,223,31,26,9,46,76,241
2017,Thon Maker,C,19,MIL,57,34,562,83,181,0.459,28,74,0.378,55,107,0.514,32,49,0.653,40,74,114,23,10,26,17,84,226
2017,Tiago Splitter,C,32,PHI,8,0,76,14,31,0.452,2,6,0.333,12,25,0.48,9,11,0.818,8,14,22,4,1,1,6,8,39
2017,Tim Frazier,PG,26,NOP,65,35,1525,163,404,0.403,40,128,0.313,123,276,0.446,98,129,0.76,34,139,173,335,56,6,101,133,464
2017,Tim Hardaway Jr.,SG,24,ATL,79,30,2154,415,912,0.455,149,417,0.357,266,495,0.537,164,214,0.766,35,189,224,182,55,15,106,103,1143
2017,Tim Quarterman,SG,22,POR,16,0,80,13,29,0.448,5,13,0.385,8,16,0.5,0,3,0,4,10,14,11,2,3,11,6,31
2017,Timofey Mozgov,C,30,LAL,54,52,1104,169,328,0.515,0,1,0,169,327,0.517,63,78,0.808,104,160,264,43,16,31,72,133,401
2017,Timothé Luwawu-Cabarrot,SF,21,PHI,69,19,1190,145,361,0.402,50,161,0.311,95,200,0.475,105,123,0.854,25,124,149,75,32,10,73,154,445
2017,Tobias Harris,PF,24,DET,82,48,2567,511,1063,0.481,109,314,0.347,402,749,0.537,190,226,0.841,63,353,416,142,60,39,96,133,1321
2017,Tomáš Satoranský,SG,25,WAS,57,3,719,61,147,0.415,9,37,0.243,52,110,0.473,23,33,0.697,25,58,83,92,26,6,38,60,154
2017,Toney Douglas,PG,30,MEM,24,0,394,43,117,0.368,7,42,0.167,36,75,0.48,24,29,0.828,13,48,61,56,18,5,21,50,117
2017,Tony Allen,SG,35,MEM,71,66,1914,274,595,0.461,15,54,0.278,259,541,0.479,80,130,0.615,166,225,391,98,115,29,100,178,643
2017,Tony Parker,PG,34,SAS,63,63,1587,265,569,0.466,23,69,0.333,242,500,0.484,85,117,0.726,9,104,113,285,34,2,89,92,638
2017,Tony Snell,SG,25,MIL,80,80,2336,246,541,0.455,144,355,0.406,102,186,0.548,47,58,0.81,22,226,248,96,55,14,55,125,683
2017,Treveon Graham,SG,23,CHO,27,1,189,19,40,0.475,9,15,0.6,10,25,0.4,10,15,0.667,5,17,22,6,6,1,3,18,57
2017,Trevor Ariza,SF,31,HOU,80,80,2773,326,798,0.409,191,555,0.344,135,243,0.556,93,126,0.738,54,404,458,175,147,20,73,133,936
2017,Trevor Booker,PF,29,BRK,71,43,1754,305,591,0.516,25,78,0.321,280,513,0.546,74,110,0.673,143,428,571,138,75,28,127,152,709
2017,Trey Burke,PG,24,WAS,57,0,703,116,255,0.455,31,70,0.443,85,185,0.459,22,29,0.759,7,40,47,100,11,5,48,54,285
2017,Trey Lyles,PF,21,UTA,71,4,1158,159,439,0.362,65,204,0.319,94,235,0.4,57,79,0.722,48,187,235,69,26,20,64,97,440
2017,Tristan Thompson,C,25,CLE,78,78,2336,262,437,0.6,0,3,0,262,434,0.604,106,213,0.498,286,429,715,77,39,84,64,176,630
2017,Troy Daniels,SG,25,MEM,67,3,1183,185,495,0.374,138,355,0.389,47,140,0.336,43,54,0.796,22,78,100,46,20,4,45,90,551
2017,Troy Williams,SF,22,TOT,30,16,557,73,167,0.437,18,62,0.29,55,105,0.524,21,32,0.656,15,54,69,25,27,10,32,60,185
2017,Troy Williams,SF,22,MEM,24,13,418,51,123,0.415,10,41,0.244,41,82,0.5,15,25,0.6,6,39,45,19,24,9,26,42,127
2017,Troy Williams,SF,22,HOU,6,3,139,22,44,0.5,8,21,0.381,14,23,0.609,6,7,0.857,9,15,24,6,3,1,6,18,58
2017,Ty Lawson,PG,29,SAC,69,24,1732,237,522,0.454,34,118,0.288,203,404,0.502,173,217,0.797,44,135,179,334,74,6,129,119,681
2017,Tyler Ennis,PG,22,TOT,53,2,588,90,208,0.433,27,70,0.386,63,138,0.457,21,25,0.84,9,36,45,86,25,2,45,58,228
2017,Tyler Ennis,PG,22,HOU,31,0,196,25,64,0.391,6,16,0.375,19,48,0.396,2,3,0.667,4,15,19,34,6,0,24,29,58
2017,Tyler Ennis,PG,22,LAL,22,2,392,65,144,0.451,21,54,0.389,44,90,0.489,19,22,0.864,5,21,26,52,19,2,21,29,170
2017,Tyler Johnson,PG,24,MIA,73,0,2178,357,824,0.433,93,250,0.372,264,574,0.46,195,254,0.768,50,243,293,233,84,44,90,176,1002
2017,Tyler Ulis,PG,21,PHO,61,15,1123,184,437,0.421,21,79,0.266,163,358,0.455,55,71,0.775,20,75,95,226,48,5,77,73,444
2017,Tyler Zeller,C,27,BOS,51,5,525,78,158,0.494,0,1,0,78,157,0.497,22,39,0.564,43,81,124,42,7,21,20,61,178
2017,Tyreke Evans,SF,27,TOT,40,6,788,150,370,0.405,42,118,0.356,108,252,0.429,69,92,0.75,13,124,137,124,35,9,61,60,411
2017,Tyreke Evans,SF,27,NOP,26,0,474,91,227,0.401,21,70,0.3,70,157,0.446,45,58,0.776,6,80,86,91,23,4,39,41,248
2017,Tyreke Evans,SF,27,SAC,14,6,314,59,143,0.413,21,48,0.438,38,95,0.4,24,34,0.706,7,44,51,33,12,5,22,19,163
2017,Tyson Chandler,C,34,PHO,47,46,1298,153,228,0.671,0,0,,153,228,0.671,91,124,0.734,153,386,539,30,33,24,65,126,397
2017,Tyus Jones,PG,20,MIN,60,0,774,75,181,0.414,26,73,0.356,49,108,0.454,33,43,0.767,10,57,67,156,48,5,38,50,209
2017,Udonis Haslem,C,36,MIA,16,0,130,11,23,0.478,0,3,0,11,20,0.55,9,15,0.6,8,28,36,6,6,1,8,22,31
2017,Victor Oladipo,SG,24,OKC,67,67,2222,412,932,0.442,127,352,0.361,285,580,0.491,116,154,0.753,39,252,291,176,78,21,119,155,1067
2017,Vince Carter,SF,40,MEM,73,15,1799,193,490,0.394,112,296,0.378,81,194,0.418,88,115,0.765,36,191,227,133,60,36,50,163,586
2017,Wade Baldwin,PG,20,MEM,33,1,405,36,115,0.313,3,22,0.136,33,93,0.355,31,37,0.838,11,35,46,61,18,7,39,40,106
2017,Wayne Ellington,SG,29,MIA,62,13,1500,231,555,0.416,149,394,0.378,82,161,0.509,37,43,0.86,18,114,132,70,35,4,30,70,648
2017,Wayne Selden,SG,22,TOT,14,5,236,25,58,0.431,7,28,0.25,18,30,0.6,14,22,0.636,1,15,16,13,6,1,12,18,71
2017,Wayne Selden,SG,22,NOP,3,3,47,5,8,0.625,4,7,0.571,1,1,1,2,4,0.5,0,5,5,1,2,0,3,6,16
2017,Wayne Selden,SG,22,MEM,11,2,189,20,50,0.4,3,21,0.143,17,29,0.586,12,18,0.667,1,10,11,12,4,1,9,12,55
2017,Wesley Johnson,SF,29,LAC,68,3,810,73,200,0.365,29,118,0.246,44,82,0.537,11,17,0.647,26,155,181,23,29,30,18,83,186
2017,Wesley Matthews,SG,30,DAL,73,73,2495,333,847,0.393,174,479,0.363,159,368,0.432,146,179,0.816,18,241,259,210,77,15,102,161,986
2017,Will Barton,SG,26,DEN,60,19,1705,295,666,0.443,87,235,0.37,208,431,0.483,143,190,0.753,58,201,259,206,48,28,97,110,820
2017,Willie Cauley-Stein,C,23,SAC,75,21,1421,255,481,0.53,0,2,0,255,479,0.532,101,151,0.669,85,254,339,80,53,44,69,147,611
2017,Willie Reed,C,26,MIA,71,5,1031,162,285,0.568,1,4,0.25,161,281,0.573,49,88,0.557,129,203,332,26,18,47,31,137,374
2017,Willy Hernangómez,C,22,NYK,72,22,1324,246,465,0.529,4,15,0.267,242,450,0.538,91,125,0.728,170,332,502,96,41,36,100,150,587
2017,Wilson Chandler,SF,29,DEN,71,33,2197,433,939,0.461,110,326,0.337,323,613,0.527,141,194,0.727,103,357,460,141,51,30,114,172,1117
2017,Yogi Ferrell,PG,23,TOT,46,29,1197,160,394,0.406,68,176,0.386,92,218,0.422,74,89,0.831,20,91,111,172,42,9,70,90,462
2017,Yogi Ferrell,PG,23,BRK,10,0,151,18,49,0.367,8,27,0.296,10,22,0.455,10,16,0.625,4,8,12,17,2,2,14,11,54
2017,Yogi Ferrell,PG,23,DAL,36,29,1046,142,345,0.412,60,149,0.403,82,196,0.418,64,73,0.877,16,83,99,155,40,7,56,79,408
2017,Zach LaVine,SG,21,MIN,47,47,1749,326,710,0.459,120,310,0.387,206,400,0.515,117,140,0.836,19,141,160,139,41,10,85,104,889
2017,Zach Randolph,PF,35,MEM,73,5,1786,433,964,0.449,21,94,0.223,412,870,0.474,141,193,0.731,182,416,598,122,38,10,99,136,1028
2017,Zaza Pachulia,C,32,GSW,70,70,1268,164,307,0.534,0,2,0,164,305,0.538,98,126,0.778,140,270,410,132,59,33,87,166,426
2018,Aaron Brooks,PG,33,MIN,32,1,189,28,69,0.406,11,31,0.355,17,38,0.447,8,11,0.727,7,10,17,20,6,0,11,28,75
2018,Aaron Gordon,PF,22,ORL,58,57,1909,375,865,0.434,115,342,0.336,260,523,0.497,157,225,0.698,87,370,457,136,59,45,107,111,1022
2018,Aaron Harrison,SG,23,DAL,9,3,233,19,69,0.275,9,43,0.209,10,26,0.385,13,17,0.765,4,20,24,11,9,2,3,27,60
2018,Aaron Jackson,PG,31,HOU,1,0,35,3,9,0.333,1,4,0.25,2,5,0.4,1,2,0.5,2,1,3,1,0,0,1,4,8
2018,Abdel Nader,SF,24,BOS,48,1,522,50,149,0.336,23,65,0.354,27,84,0.321,23,39,0.59,13,58,71,26,15,10,34,45,146
2018,Adreian Payne,PF,26,ORL,5,0,43,7,10,0.7,2,3,0.667,5,7,0.714,5,6,0.833,2,7,9,0,2,0,2,6,21
2018,Al Horford,C,31,BOS,72,72,2277,368,753,0.489,97,226,0.429,271,527,0.514,94,120,0.783,103,427,530,339,43,78,132,138,927
2018,Al Jefferson,C,33,IND,36,1,484,111,208,0.534,0,3,0,111,205,0.541,30,36,0.833,30,113,143,30,16,23,21,66,252
2018,Al-Farouq Aminu,PF,27,POR,69,67,2072,230,582,0.395,125,339,0.369,105,243,0.432,59,80,0.738,97,428,525,84,79,40,79,136,644
2018,Alan Williams,PF,25,PHO,5,0,70,7,18,0.389,0,0,,7,18,0.389,6,9,0.667,3,19,22,8,5,1,7,13,20
2018,Alec Burks,SG,26,UTA,64,1,1059,170,414,0.411,47,142,0.331,123,272,0.452,107,124,0.863,19,173,192,67,37,8,60,75,494
2018,Alec Peters,PF,22,PHO,20,0,225,28,74,0.378,18,58,0.31,10,16,0.625,8,10,0.8,8,29,37,12,2,2,4,13,82
2018,Álex Abrines,SG,24,OKC,75,8,1134,115,291,0.395,84,221,0.38,31,70,0.443,39,46,0.848,26,88,114,28,38,8,25,124,353
2018,Alex Caruso,PG,23,LAL,37,7,562,50,116,0.431,13,43,0.302,37,73,0.507,21,30,0.7,15,50,65,75,23,10,42,52,134
2018,Alex Len,C,24,PHO,69,13,1395,214,378,0.566,1,3,0.333,213,375,0.568,158,231,0.684,175,343,518,82,27,61,78,158,587
2018,Alex Poythress,PF,24,IND,25,0,104,11,26,0.423,4,11,0.364,7,15,0.467,0,0,,7,10,17,2,3,1,2,16,26
2018,Alfonzo McKinnie,SF,25,TOR,14,0,53,8,15,0.533,3,9,0.333,5,6,0.833,2,3,0.667,1,6,7,1,1,1,3,8,21
2018,Allen Crabbe,SG,25,BRK,75,68,2197,337,827,0.407,201,532,0.378,136,295,0.461,115,135,0.852,28,296,324,117,47,35,78,168,990
2018,Amir Johnson,C,30,PHI,74,18,1171,140,260,0.538,10,32,0.313,130,228,0.57,52,85,0.612,123,207,330,118,45,44,55,192,342
2018,Andre Drummond,C,24,DET,78,78,2625,466,881,0.529,0,11,0,466,870,0.536,239,395,0.605,399,848,1247,237,114,127,200,250,1171
2018,Andre Iguodala,SF,34,GSW,64,7,1622,148,320,0.463,33,117,0.282,115,203,0.567,55,87,0.632,50,196,246,210,54,38,67,99,384
2018,Andre Ingram,SG,32,LAL,2,0,64,8,17,0.471,5,9,0.556,3,8,0.375,3,3,1,1,5,6,7,3,3,3,3,24
2018,Andre Roberson,SG,26,OKC,39,39,1037,87,162,0.537,8,36,0.222,79,126,0.627,12,38,0.316,75,110,185,46,45,35,30,89,194
2018,Andrew Bogut,C,33,LAL,24,5,216,17,25,0.68,0,0,,17,25,0.68,2,2,1,26,52,78,15,4,13,19,40,36
2018,Andrew Harrison,PG,23,MEM,56,46,1326,181,429,0.422,47,142,0.331,134,287,0.467,124,159,0.78,23,108,131,177,38,26,81,138,533
2018,Andrew White,SF,24,ATL,15,0,209,25,73,0.342,18,49,0.367,7,24,0.292,1,4,0.25,4,30,34,6,3,1,8,12,69
2018,Andrew Wiggins,SF,22,MIN,82,82,2979,569,1300,0.438,112,338,0.331,457,962,0.475,202,314,0.643,82,276,358,160,91,51,138,163,1452
2018,Ante Žižić,C,21,CLE,32,2,214,49,67,0.731,0,0,,49,67,0.731,21,29,0.724,24,36,60,5,2,13,11,30,119
2018,Anthony Brown,SF,25,MIN,1,0,4,1,1,1,1,1,1,0,0,,0,0,,0,0,0,1,0,0,0,0,3
2018,Anthony Davis,PF,24,NOP,75,75,2727,780,1462,0.534,55,162,0.34,725,1300,0.558,495,598,0.828,187,645,832,174,115,193,162,159,2110
2018,Anthony Tolliver,PF,32,DET,79,14,1757,219,472,0.464,159,365,0.436,60,107,0.561,106,133,0.797,50,191,241,90,32,21,58,144,703
2018,Antonio Blakeney,SG,21,CHI,19,0,314,53,143,0.371,15,52,0.288,38,91,0.418,30,39,0.769,4,29,33,20,7,1,11,19,151
2018,Antonius Cleveland,SG,23,TOT,17,0,123,8,21,0.381,3,4,0.75,5,17,0.294,4,6,0.667,3,11,14,2,7,5,7,23,23
2018,Antonius Cleveland,SG,23,DAL,13,0,81,4,14,0.286,0,1,0,4,13,0.308,2,4,0.5,2,8,10,2,6,4,2,11,10
2018,Antonius Cleveland,SG,23,ATL,4,0,42,4,7,0.571,3,3,1,1,4,0.25,2,2,1,1,3,4,0,1,1,5,12,13
2018,Aron Baynes,C,31,BOS,81,67,1485,210,446,0.471,3,21,0.143,207,425,0.487,59,78,0.756,130,304,434,93,22,51,80,200,482
2018,Arron Afflalo,SG,32,ORL,53,3,682,65,162,0.401,27,70,0.386,38,92,0.413,22,26,0.846,4,62,66,30,4,9,21,56,179
2018,Austin Rivers,SG,25,LAC,61,59,2057,341,805,0.424,136,360,0.378,205,445,0.461,102,159,0.642,27,118,145,242,74,16,109,152,920
2018,Avery Bradley,SG,27,TOT,46,46,1433,259,625,0.414,75,203,0.369,184,422,0.436,63,82,0.768,22,94,116,94,51,8,101,92,656
2018,Avery Bradley,SG,27,DET,40,40,1268,233,570,0.409,74,194,0.381,159,376,0.423,61,80,0.763,19,75,94,83,46,7,93,80,601
2018,Avery Bradley,SG,27,LAC,6,6,165,26,55,0.473,1,9,0.111,25,46,0.543,2,2,1,3,19,22,11,5,1,8,12,55
2018,Bam Adebayo,C,20,MIA,69,19,1368,174,340,0.512,0,7,0,174,333,0.523,129,179,0.721,118,263,381,101,32,41,66,138,477
2018,Ben McLemore,SG,24,MEM,56,17,1091,157,373,0.421,55,159,0.346,102,214,0.477,53,64,0.828,34,105,139,51,38,15,61,139,422
2018,Ben Moore,PF,22,IND,2,0,9,0,0,,0,0,,0,0,,0,0,,0,1,1,1,0,0,0,4,0
2018,Ben Simmons,PG,21,PHI,81,81,2732,544,998,0.545,0,11,0,544,987,0.551,191,341,0.56,145,514,659,661,140,70,278,211,1279
2018,Bismack Biyombo,C,25,ORL,82,25,1495,183,352,0.52,0,1,0,183,351,0.521,102,157,0.65,144,324,468,66,21,95,84,158,468
2018,Blake Griffin,PF,28,TOT,58,58,1970,436,996,0.438,111,322,0.345,325,674,0.482,259,330,0.785,73,355,428,334,41,18,165,139,1242
2018,Blake Griffin,PF,28,LAC,33,33,1139,255,578,0.441,64,187,0.342,191,391,0.488,172,219,0.785,46,216,262,179,30,9,99,78,746
2018,Blake Griffin,PF,28,DET,25,25,831,181,418,0.433,47,135,0.348,134,283,0.473,87,111,0.784,27,139,166,155,11,9,66,61,496
2018,Boban Marjanović,C,29,TOT,39,1,337,79,148,0.534,0,0,,79,148,0.534,77,97,0.794,48,96,144,22,10,11,36,51,235
2018,Boban Marjanović,C,29,DET,19,1,171,41,79,0.519,0,0,,41,79,0.519,36,45,0.8,15,42,57,14,4,6,22,28,118
2018,Boban Marjanović,C,29,LAC,20,0,166,38,69,0.551,0,0,,38,69,0.551,41,52,0.788,33,54,87,8,6,5,14,23,117
2018,Bobby Brown,PG,33,HOU,20,0,115,19,58,0.328,11,40,0.275,8,18,0.444,1,2,0.5,0,7,7,11,4,0,9,6,50
2018,Bobby Portis,PF,22,CHI,73,4,1643,382,811,0.471,80,223,0.359,302,588,0.514,120,156,0.769,159,339,498,123,50,23,103,130,964
2018,Bogdan Bogdanović,SG,25,SAC,78,53,2175,344,772,0.446,129,329,0.392,215,443,0.485,100,119,0.84,31,192,223,258,72,16,125,172,917
2018,Bojan Bogdanović,SF,28,IND,80,80,2464,404,852,0.474,155,386,0.402,249,466,0.534,178,205,0.868,30,240,270,119,55,8,106,129,1141
2018,Bradley Beal,SG,24,WAS,82,82,2977,683,1484,0.46,199,530,0.375,484,954,0.507,292,369,0.791,61,302,363,373,96,36,214,160,1857
2018,Brandan Wright,PF,30,TOT,28,1,381,59,102,0.578,0,0,,59,102,0.578,21,33,0.636,33,62,95,13,13,26,8,32,139
2018,Brandan Wright,PF,30,MEM,27,1,366,57,99,0.576,0,0,,57,99,0.576,21,33,0.636,32,61,93,13,13,25,8,29,135
2018,Brandan Wright,PF,30,HOU,1,0,15,2,3,0.667,0,0,,2,3,0.667,0,0,,1,1,2,0,0,1,0,3,4
2018,Brandon Ingram,SF,20,LAL,59,59,1975,358,761,0.47,41,105,0.39,317,656,0.483,192,282,0.681,57,257,314,230,45,43,149,163,949
2018,Brandon Jennings,PG,28,MIL,14,0,205,27,72,0.375,9,33,0.273,18,39,0.462,10,10,1,5,26,31,44,6,4,18,11,73
2018,Brandon Paul,SG,26,SAS,64,2,576,55,127,0.433,15,54,0.278,40,73,0.548,22,43,0.512,6,62,68,37,25,7,29,58,147
2018,Briante Weber,PG,25,TOT,18,0,237,19,43,0.442,4,11,0.364,15,32,0.469,8,10,0.8,8,27,35,22,18,5,15,28,50
2018,Briante Weber,PG,25,HOU,13,0,118,9,22,0.409,4,9,0.444,5,13,0.385,4,4,1,3,15,18,13,10,3,7,18,26
2018,Briante Weber,PG,25,MEM,5,0,119,10,21,0.476,0,2,0,10,19,0.526,4,6,0.667,5,12,17,9,8,2,8,10,24
2018,Brice Johnson,PF,23,TOT,18,0,98,20,42,0.476,0,1,0,20,41,0.488,3,5,0.6,9,22,31,2,9,6,5,13,43
2018,Brice Johnson,PF,23,LAC,9,0,38,7,11,0.636,0,1,0,7,10,0.7,2,2,1,2,11,13,1,6,2,4,7,16
2018,Brice Johnson,PF,23,MEM,9,0,60,13,31,0.419,0,0,,13,31,0.419,1,3,0.333,7,11,18,1,3,4,1,6,27
2018,Brook Lopez,C,29,LAL,74,72,1735,369,793,0.465,112,325,0.345,257,468,0.549,111,158,0.703,74,220,294,126,30,98,98,195,961
2018,Bruno Caboclo,SF,22,TOT,12,0,107,9,31,0.29,3,17,0.176,6,14,0.429,5,6,0.833,7,15,22,4,3,4,4,8,26
2018,Bruno Caboclo,SF,22,TOR,2,0,7,0,2,0,0,2,0,0,0,,0,0,,0,1,1,1,1,0,0,1,0
2018,Bruno Caboclo,SF,22,SAC,10,0,100,9,29,0.31,3,15,0.2,6,14,0.429,5,6,0.833,7,14,21,3,2,4,4,7,26
2018,Bryn Forbes,SG,24,SAS,80,12,1517,209,497,0.421,89,228,0.39,120,269,0.446,48,72,0.667,12,98,110,80,28,2,37,108,555
2018,Buddy Hield,SG,25,SAC,80,12,2024,416,933,0.446,176,408,0.431,240,525,0.457,71,81,0.877,55,252,307,155,85,22,124,148,1079
2018,C.J. Miles,SF,30,TOR,70,3,1337,227,599,0.379,164,454,0.361,63,145,0.434,81,97,0.835,18,134,152,55,37,21,39,134,699
2018,C.J. Williams,SG,27,LAC,38,17,707,87,197,0.442,22,78,0.282,65,119,0.546,13,16,0.813,12,44,56,43,31,13,20,63,209
2018,Caleb Swanigan,PF,20,POR,27,3,189,24,60,0.4,1,8,0.125,23,52,0.442,12,18,0.667,15,39,54,14,5,3,18,37,61
2018,Cameron Payne,PG,23,CHI,25,14,582,87,215,0.405,35,91,0.385,52,124,0.419,12,16,0.75,18,51,69,113,26,9,36,44,221
2018,Caris LeVert,SF,23,BRK,71,10,1864,320,735,0.435,85,245,0.347,235,490,0.48,133,187,0.711,53,207,260,299,82,22,153,159,858
2018,Carmelo Anthony,PF,33,OKC,78,78,2501,472,1168,0.404,169,474,0.357,303,694,0.437,148,193,0.767,67,386,453,103,47,49,99,197,1261
2018,Cedi Osman,SF,22,CLE,61,12,672,90,186,0.484,32,87,0.368,58,99,0.586,26,46,0.565,19,101,120,41,22,3,32,78,238
2018,Chandler Parsons,SF,29,MEM,36,8,691,108,234,0.462,51,121,0.421,57,113,0.504,17,27,0.63,14,76,90,69,18,11,35,53,284
2018,Channing Frye,C,34,TOT,53,1,695,104,212,0.491,39,115,0.339,65,97,0.67,17,19,0.895,12,123,135,38,18,13,21,69,264
2018,Channing Frye,C,34,CLE,44,1,545,84,169,0.497,30,90,0.333,54,79,0.684,14,15,0.933,10,100,110,28,17,12,17,54,212
2018,Channing Frye,C,34,LAL,9,0,150,20,43,0.465,9,25,0.36,11,18,0.611,3,4,0.75,2,23,25,10,1,1,4,15,52
2018,Charles Cooke,SG,23,NOP,13,0,38,2,14,0.143,1,8,0.125,1,6,0.167,1,2,0.5,0,2,2,1,1,0,1,0,6
2018,Cheick Diallo,PF,21,NOP,52,0,581,102,176,0.58,0,0,,102,176,0.58,50,66,0.758,47,164,211,19,11,21,28,82,254
2018,Chinanu Onuaku,C,21,HOU,1,0,22,2,5,0.4,0,0,,2,5,0.4,0,0,,1,3,4,1,0,0,3,4,4
2018,Chris Boucher,PF,25,GSW,1,0,1,0,1,0,0,1,0,0,0,,0,0,,0,1,1,0,0,0,0,0,0
2018,Chris McCullough,PF,22,WAS,19,0,90,18,42,0.429,1,8,0.125,17,34,0.5,9,14,0.643,7,18,25,4,0,5,2,8,46
2018,Chris Paul,PG,32,HOU,58,58,1847,367,798,0.46,144,379,0.38,223,419,0.532,203,221,0.919,37,276,313,457,96,14,128,141,1081
2018,CJ McCollum,SG,26,POR,81,81,2923,667,1505,0.443,189,476,0.397,478,1029,0.465,209,250,0.836,53,268,321,272,77,35,151,168,1732
2018,Clint Capela,C,23,HOU,74,74,2034,441,676,0.652,0,1,0,441,675,0.653,144,257,0.56,241,561,802,68,58,137,103,185,1026
2018,Cody Zeller,C,25,CHO,33,0,627,85,156,0.545,2,3,0.667,83,153,0.542,61,85,0.718,67,110,177,31,14,21,33,81,233
2018,Cole Aldrich,C,29,MIN,21,0,49,5,15,0.333,0,0,,5,15,0.333,2,6,0.333,3,12,15,3,2,1,1,11,12
2018,Corey Brewer,SF-SG,31,TOT,72,18,1208,142,316,0.449,31,110,0.282,111,206,0.539,65,90,0.722,43,111,154,65,79,14,49,139,380
2018,Corey Brewer,SF,31,LAL,54,2,694,78,172,0.453,8,43,0.186,70,129,0.543,34,51,0.667,23,70,93,41,41,8,38,83,198
2018,Corey Brewer,SG,31,OKC,18,16,514,64,144,0.444,23,67,0.343,41,77,0.532,31,39,0.795,20,41,61,24,38,6,11,56,182
2018,Cory Joseph,PG,26,IND,82,17,2210,256,604,0.424,67,190,0.353,189,414,0.457,70,94,0.745,39,224,263,260,80,18,87,141,649
2018,Courtney Lee,SG,32,NYK,76,69,2310,343,755,0.454,113,278,0.406,230,477,0.482,114,124,0.919,30,194,224,180,80,17,84,109,913
2018,Cristiano Felício,C,25,CHI,55,16,977,127,215,0.591,0,2,0,127,213,0.596,54,81,0.667,83,150,233,55,16,11,54,104,308
2018,D.J. Augustin,PG,30,ORL,75,36,1760,244,540,0.452,114,272,0.419,130,268,0.485,164,189,0.868,30,130,160,287,54,0,123,94,766
2018,D.J. Wilson,PF,21,MIL,22,0,71,9,16,0.563,2,5,0.4,7,11,0.636,1,2,0.5,2,8,10,3,3,1,4,7,21
2018,D'Angelo Russell,PG,21,BRK,48,35,1234,278,672,0.414,90,278,0.324,188,394,0.477,97,131,0.74,30,159,189,249,36,17,147,93,743
2018,Dakari Johnson,C,22,OKC,31,6,161,22,39,0.564,0,0,,22,39,0.564,11,20,0.55,16,18,34,8,6,8,3,27,55
2018,Damian Jones,C,22,GSW,15,0,89,11,22,0.5,0,0,,11,22,0.5,3,5,0.6,5,9,14,2,1,3,4,14,25
2018,Damian Lillard,PG,27,POR,73,73,2670,621,1415,0.439,227,629,0.361,394,786,0.501,493,538,0.916,62,263,325,481,77,27,206,117,1962
2018,Damien Wilkins,SF,38,IND,19,1,152,13,39,0.333,4,18,0.222,9,21,0.429,3,4,0.75,5,11,16,9,2,1,5,7,33
2018,Damion Lee,SG,25,ATL,15,11,404,62,152,0.408,15,60,0.25,47,92,0.511,22,29,0.759,11,60,71,29,19,1,14,25,161
2018,Damyean Dotson,SG,23,NYK,44,2,474,72,161,0.447,22,68,0.324,50,93,0.538,16,23,0.696,9,75,84,31,12,2,17,34,182
2018,Daniel Hamilton,SG,22,OKC,6,0,28,5,11,0.455,2,5,0.4,3,6,0.5,0,0,,0,5,5,8,1,0,2,2,12
2018,Daniel Theis,C,25,BOS,63,3,936,126,233,0.541,18,58,0.31,108,175,0.617,61,81,0.753,90,184,274,56,30,48,56,157,331
2018,Danilo Gallinari,SF,29,LAC,21,21,671,102,256,0.398,36,111,0.324,66,145,0.455,81,87,0.931,9,92,101,41,12,10,26,30,321
2018,Danny Green,SG,30,SAS,70,60,1791,217,561,0.387,116,320,0.363,101,241,0.419,50,65,0.769,41,208,249,110,63,80,74,122,600
2018,Dante Cunningham,SF,30,TOT,73,25,1562,164,364,0.451,58,168,0.345,106,196,0.541,31,52,0.596,78,220,298,48,39,30,33,111,417
2018,Dante Cunningham,SF,30,NOP,51,24,1115,99,225,0.44,35,108,0.324,64,117,0.547,20,36,0.556,50,143,193,26,27,16,16,75,253
2018,Dante Cunningham,SF,30,BRK,22,1,447,65,139,0.468,23,60,0.383,42,79,0.532,11,16,0.688,28,77,105,22,12,14,17,36,164
2018,Dante Exum,PG,22,UTA,14,0,235,42,87,0.483,5,18,0.278,37,69,0.536,25,31,0.806,4,22,26,43,8,3,20,20,114
2018,Danuel House Jr.,SG,24,PHO,23,3,403,56,129,0.434,15,58,0.259,41,71,0.577,25,31,0.806,13,63,76,25,7,6,11,23,152
2018,Dario Šarić,PF,23,PHI,78,73,2310,403,890,0.453,157,399,0.393,246,491,0.501,178,207,0.86,154,366,520,202,51,20,148,160,1141
2018,Darius Miller,SF,27,NOP,82,3,1944,216,487,0.444,147,358,0.411,69,129,0.535,58,67,0.866,18,146,164,111,28,17,58,160,637
2018,Darrell Arthur,PF,29,DEN,19,1,141,22,47,0.468,8,23,0.348,14,24,0.583,2,3,0.667,3,12,15,9,8,3,15,22,54
2018,Darren Collison,PG,30,IND,69,64,2018,316,638,0.495,96,205,0.468,220,433,0.508,127,144,0.882,37,141,178,368,92,15,86,122,855
2018,Darrun Hilliard,SG,24,SAS,14,0,95,5,19,0.263,0,6,0,5,13,0.385,6,7,0.857,0,7,7,11,2,0,4,7,16
2018,David Nwaba,SG,25,CHI,70,21,1646,202,423,0.478,18,52,0.346,184,371,0.496,133,203,0.655,89,237,326,104,59,29,77,158,555
2018,David Stockton,PG,26,UTA,3,0,9,2,3,0.667,2,3,0.667,0,0,,4,4,1,0,0,0,0,0,0,1,3,10
2018,David West,C,37,GSW,73,0,999,216,378,0.571,3,8,0.375,213,370,0.576,60,79,0.759,64,174,238,138,47,75,80,120,495
2018,Dāvis Bertāns,PF,25,SAS,77,10,1086,161,366,0.44,94,252,0.373,67,114,0.588,40,49,0.816,18,135,153,74,26,28,36,93,456
2018,Davon Reed,SG,22,PHO,21,1,242,22,76,0.289,11,38,0.289,11,38,0.289,8,12,0.667,2,37,39,13,10,2,10,17,63
2018,De'Aaron Fox,PG,20,SAC,73,60,2026,328,797,0.412,47,153,0.307,281,644,0.436,141,195,0.723,33,171,204,320,70,20,173,163,844
2018,DeAndre Jordan,C,29,LAC,77,77,2424,373,578,0.645,0,0,,373,578,0.645,181,312,0.58,329,842,1171,117,39,71,137,203,927
2018,DeAndre Liggins,SG,29,TOT,58,4,724,40,106,0.377,19,53,0.358,21,53,0.396,2,5,0.4,7,68,75,48,37,14,20,81,101
2018,DeAndre Liggins,SG,29,MIL,31,1,480,22,65,0.338,11,36,0.306,11,29,0.379,2,5,0.4,5,44,49,27,27,10,13,61,57
2018,DeAndre Liggins,SG,29,NOP,27,3,244,18,41,0.439,8,17,0.471,10,24,0.417,0,0,,2,24,26,21,10,4,7,20,44
2018,DeAndre' Bembry,SF,23,ATL,26,3,455,53,128,0.414,11,30,0.367,42,98,0.429,19,33,0.576,8,64,72,49,21,12,47,38,136
2018,Dejounte Murray,PG,21,SAS,81,48,1743,270,609,0.443,9,34,0.265,261,575,0.454,105,148,0.709,110,349,459,231,97,31,134,151,654
2018,Delon Wright,PG,25,TOR,69,4,1433,201,432,0.465,56,153,0.366,145,279,0.52,97,117,0.829,45,153,198,200,72,33,78,81,555
2018,DeMar DeRozan,SG,28,TOR,80,80,2711,645,1413,0.456,89,287,0.31,556,1126,0.494,461,559,0.825,59,256,315,417,85,22,175,151,1840
2018,DeMarcus Cousins,C,27,NOP,48,48,1737,406,864,0.47,104,294,0.354,302,570,0.53,294,394,0.746,105,512,617,257,79,76,242,183,1210
2018,DeMarre Carroll,PF,31,BRK,73,73,2180,325,785,0.414,145,391,0.371,180,394,0.457,188,246,0.764,105,374,479,147,59,30,103,165,983
2018,Demetrius Jackson,PG,23,TOT,15,0,80,7,18,0.389,1,7,0.143,6,11,0.545,1,2,0.5,5,7,12,9,5,1,10,7,16
2018,Demetrius Jackson,PG,23,HOU,12,0,63,4,14,0.286,0,6,0,4,8,0.5,0,0,,4,7,11,5,4,1,9,6,8
2018,Demetrius Jackson,PG,23,PHI,3,0,17,3,4,0.75,1,1,1,2,3,0.667,1,2,0.5,1,0,1,4,1,0,1,1,8
2018,Dennis Schröder,PG,24,ATL,67,67,2078,500,1146,0.436,76,262,0.29,424,884,0.48,225,265,0.849,44,164,208,417,72,6,183,147,1301
2018,Dennis Smith Jr.,PG,20,DAL,69,69,2049,404,1024,0.395,106,339,0.313,298,685,0.435,134,193,0.694,50,210,260,358,71,18,194,152,1048
2018,Denzel Valentine,SG,24,CHI,77,37,2095,301,721,0.417,143,370,0.386,158,351,0.45,38,51,0.745,48,345,393,244,65,11,99,185,783
2018,Derrick Favors,C,26,UTA,77,77,2153,395,702,0.563,14,63,0.222,381,639,0.596,140,215,0.651,198,354,552,102,54,82,88,164,944
2018,Derrick Jones Jr.,SF,20,TOT,20,8,245,21,53,0.396,3,18,0.167,18,35,0.514,16,24,0.667,21,17,38,9,4,13,7,24,61
2018,Derrick Jones Jr.,SF,20,PHO,6,0,33,2,4,0.5,0,2,0,2,2,1,5,6,0.833,2,2,4,3,1,4,1,2,9
2018,Derrick Jones Jr.,SF,20,MIA,14,8,212,19,49,0.388,3,16,0.188,16,33,0.485,11,18,0.611,19,15,34,6,3,9,6,22,52
2018,Derrick Rose,PG,29,TOT,25,7,420,81,186,0.435,7,30,0.233,74,156,0.474,40,46,0.87,13,22,35,37,7,4,35,16,209
2018,Derrick Rose,PG,29,CLE,16,7,308,58,132,0.439,6,24,0.25,52,108,0.481,35,41,0.854,10,19,29,26,3,4,28,14,157
2018,Derrick Rose,PG,29,MIN,9,0,112,23,54,0.426,1,6,0.167,22,48,0.458,5,5,1,3,3,6,11,4,0,7,2,52
2018,Derrick Walton,PG,22,MIA,16,0,147,8,25,0.32,7,17,0.412,1,8,0.125,6,6,1,2,14,16,16,7,3,2,7,29
2018,Derrick White,PG,23,SAS,17,0,139,16,33,0.485,8,13,0.615,8,20,0.4,14,20,0.7,5,21,26,9,4,3,6,8,54
2018,Derrick Williams,PF,26,LAL,2,0,9,1,4,0.25,0,2,0,1,2,0.5,0,0,,0,1,1,0,0,0,0,0,2
2018,Devin Booker,SG,21,PHO,54,54,1865,455,1054,0.432,147,384,0.383,308,670,0.46,289,329,0.878,26,218,244,253,47,14,194,168,1346
2018,Devin Harris,PG,34,TOT,71,1,1340,187,454,0.412,79,227,0.348,108,227,0.476,142,170,0.835,12,115,127,152,47,12,76,158,595
2018,Devin Harris,PG,34,DAL,44,1,807,118,284,0.415,44,125,0.352,74,159,0.465,93,112,0.83,9,76,85,85,33,8,49,103,373
2018,Devin Harris,PG,34,DEN,27,0,533,69,170,0.406,35,102,0.343,34,68,0.5,49,58,0.845,3,39,42,67,14,4,27,55,222
2018,Devin Robinson,SF,22,WAS,1,0,13,1,3,0.333,0,0,,1,3,0.333,0,0,,2,3,5,0,1,0,0,2,2
2018,Dewayne Dedmon,C,28,ATL,62,46,1542,250,477,0.524,50,141,0.355,200,336,0.595,67,86,0.779,100,389,489,90,40,51,86,162,617
2018,Deyonta Davis,C,21,MEM,62,6,943,161,265,0.608,0,0,,161,265,0.608,38,57,0.667,75,175,250,40,15,39,32,125,360
2018,Dillon Brooks,SF,22,MEM,82,74,2350,340,772,0.44,94,264,0.356,246,508,0.484,124,166,0.747,49,208,257,135,73,17,124,233,898
2018,Dion Waiters,SG,26,MIA,30,30,918,163,410,0.398,52,170,0.306,111,240,0.463,51,69,0.739,8,69,77,113,23,9,70,61,429
2018,Dirk Nowitzki,C,39,DAL,77,77,1900,346,758,0.456,138,337,0.409,208,421,0.494,97,108,0.898,22,416,438,120,43,45,51,146,927
2018,Domantas Sabonis,C,21,IND,74,19,1810,340,661,0.514,13,37,0.351,327,624,0.524,168,224,0.75,165,407,572,151,40,32,137,220,861
2018,Donovan Mitchell,SG,21,UTA,79,71,2638,595,1362,0.437,187,550,0.34,408,812,0.502,239,297,0.805,52,244,296,291,118,27,215,213,1616
2018,Dorian Finney-Smith,PF,24,DAL,21,13,448,46,121,0.38,20,67,0.299,26,54,0.481,11,15,0.733,22,53,75,26,10,4,21,43,123
2018,Doug McDermott,SF,26,TOT,81,4,1768,237,508,0.467,92,216,0.426,145,292,0.497,64,81,0.79,40,160,200,79,19,16,56,122,630
2018,Doug McDermott,SF,26,NYK,55,1,1172,151,328,0.46,53,137,0.387,98,191,0.513,40,53,0.755,33,101,134,50,10,12,34,73,395
2018,Doug McDermott,SF,26,DAL,26,3,596,86,180,0.478,39,79,0.494,47,101,0.465,24,28,0.857,7,59,66,29,9,4,22,49,235
2018,Dragan Bender,PF,20,PHO,82,37,2069,187,484,0.386,118,322,0.366,69,162,0.426,39,51,0.765,40,321,361,130,22,53,112,166,531
2018,Draymond Green,PF,27,GSW,70,70,2287,281,619,0.454,77,256,0.301,204,363,0.562,134,173,0.775,75,460,535,508,95,91,202,185,773
2018,Dwayne Bacon,SG,22,CHO,53,6,713,72,192,0.375,11,43,0.256,61,149,0.409,20,25,0.8,4,120,124,38,16,2,23,46,175
2018,Dwight Buycks,PG,28,DET,29,0,427,82,198,0.414,15,45,0.333,67,153,0.438,36,41,0.878,12,29,41,59,19,2,39,39,215
2018,Dwight Howard,C,32,CHO,81,81,2463,506,911,0.555,1,7,0.143,505,904,0.559,334,582,0.574,255,757,1012,105,48,131,208,249,1347
2018,Dwight Powell,C,26,DAL,79,25,1672,255,430,0.593,28,84,0.333,227,346,0.656,133,185,0.719,135,309,444,91,67,32,59,186,671
2018,Dwyane Wade,SG,36,TOT,67,3,1536,299,682,0.438,32,111,0.288,267,571,0.468,135,189,0.714,50,202,252,228,61,47,140,124,765
2018,Dwyane Wade,SG,36,CLE,46,3,1069,198,435,0.455,23,70,0.329,175,365,0.479,94,134,0.701,39,142,181,163,42,32,92,84,513
2018,Dwyane Wade,SG,36,MIA,21,0,467,101,247,0.409,9,41,0.22,92,206,0.447,41,55,0.745,11,60,71,65,19,15,48,40,252
2018,E'Twaun Moore,SG,28,NOP,82,80,2586,423,832,0.508,128,301,0.425,295,531,0.556,48,68,0.706,57,181,238,187,79,12,102,182,1022
2018,Ed Davis,C,28,POR,78,0,1471,170,292,0.582,0,1,0,170,291,0.584,74,111,0.667,183,392,575,40,32,52,66,188,414
2018,Edmond Sumner,PG,22,IND,1,0,2,1,1,1,0,0,,1,1,1,0,0,,0,1,1,0,0,0,0,1,2
2018,Ekpe Udoh,C,30,UTA,63,3,810,60,120,0.5,0,1,0,60,119,0.504,42,56,0.75,68,82,150,53,43,74,20,105,162
2018,Elfrid Payton,PG,23,TOT,63,63,1808,329,667,0.493,30,92,0.326,299,575,0.52,109,168,0.649,64,210,274,393,83,22,168,147,797
2018,Elfrid Payton,PG,23,ORL,44,44,1257,238,458,0.52,25,67,0.373,213,391,0.545,72,114,0.632,47,127,174,275,64,16,114,97,573
2018,Elfrid Payton,PG,23,PHO,19,19,551,91,209,0.435,5,25,0.2,86,184,0.467,37,54,0.685,17,83,100,118,19,6,54,50,224
2018,Emeka Okafor,C,35,NOP,26,19,353,48,95,0.505,0,0,,48,95,0.505,18,22,0.818,47,73,120,8,8,25,13,30,114
2018,Emmanuel Mudiay,PG,21,TOT,64,14,1245,204,526,0.388,47,148,0.318,157,378,0.415,98,129,0.76,26,126,152,206,41,11,113,80,553
2018,Emmanuel Mudiay,PG,21,DEN,42,0,752,129,322,0.401,38,102,0.373,91,220,0.414,63,78,0.808,16,78,94,121,21,4,72,47,359
2018,Emmanuel Mudiay,PG,21,NYK,22,14,493,75,204,0.368,9,46,0.196,66,158,0.418,35,51,0.686,10,48,58,85,20,7,41,33,194
2018,Enes Freedom,C,25,NYK,71,71,1830,422,713,0.592,0,2,0,422,711,0.594,156,184,0.848,273,507,780,105,36,37,122,187,1000
2018,Eric Bledsoe,PG,28,TOT,74,74,2322,468,989,0.473,125,360,0.347,343,629,0.545,252,317,0.795,51,233,284,370,149,42,216,185,1313
2018,Eric Bledsoe,PG,28,PHO,3,3,83,16,40,0.4,4,13,0.308,12,27,0.444,11,14,0.786,3,4,7,9,4,2,10,6,47
2018,Eric Bledsoe,PG,28,MIL,71,71,2239,452,949,0.476,121,347,0.349,331,602,0.55,241,303,0.795,48,229,277,361,145,40,206,179,1266
2018,Eric Gordon,SG,29,HOU,69,30,2154,415,970,0.428,218,608,0.359,197,362,0.544,195,241,0.809,25,145,170,154,44,27,130,116,1243
2018,Eric Moreland,PF,26,DET,67,3,805,66,122,0.541,0,0,,66,122,0.541,11,29,0.379,81,197,278,78,31,51,42,116,143
2018,Erik McCree,SF,24,UTA,4,0,8,0,2,0,0,1,0,0,1,0,0,0,,0,1,1,0,1,0,1,0,0
2018,Ersan İlyasova,PF,30,TOT,69,43,1729,277,613,0.452,91,253,0.36,186,360,0.517,105,135,0.778,118,287,405,90,61,26,72,157,750
2018,Ersan İlyasova,PF,30,ATL,46,40,1175,184,401,0.459,61,170,0.359,123,231,0.532,72,90,0.8,74,177,251,51,44,17,43,92,501
2018,Ersan İlyasova,PF,30,PHI,23,3,554,93,212,0.439,30,83,0.361,63,129,0.488,33,45,0.733,44,110,154,39,17,9,29,65,249
2018,Evan Fournier,SF,25,ORL,57,57,1837,368,802,0.459,127,335,0.379,241,467,0.516,150,173,0.867,23,157,180,165,47,16,95,138,1013
2018,Evan Turner,SF,29,POR,79,40,2034,258,577,0.447,42,132,0.318,216,445,0.485,91,107,0.85,30,214,244,173,47,29,99,163,649
2018,Frank Kaminsky,PF,24,CHO,79,4,1835,307,716,0.429,104,274,0.38,203,442,0.459,155,194,0.799,46,242,288,129,36,19,66,95,873
2018,Frank Mason III,PG,23,SAC,52,2,984,144,380,0.379,31,86,0.36,113,294,0.384,94,115,0.817,30,100,130,147,34,10,65,72,413
2018,Frank Ntilikina,PG,19,NYK,78,9,1706,182,500,0.364,50,157,0.318,132,343,0.385,49,68,0.721,37,140,177,250,65,18,131,181,463
2018,Fred VanVleet,PG,23,TOR,76,0,1520,232,545,0.426,108,261,0.414,124,284,0.437,84,101,0.832,25,159,184,243,68,19,74,130,656
2018,Furkan Korkmaz,SG,20,PHI,14,0,80,8,28,0.286,5,17,0.294,3,11,0.273,2,4,0.5,2,9,11,4,2,1,2,12,23
2018,Garrett Temple,SG,31,SAC,65,35,1615,199,476,0.418,89,227,0.392,110,249,0.442,60,78,0.769,22,130,152,124,57,27,79,135,547
2018,Gary Harris,SG,23,DEN,67,65,2304,440,908,0.485,156,394,0.396,284,514,0.553,134,162,0.827,37,139,176,194,122,15,119,119,1170
2018,Gary Payton II,PG,25,TOT,23,6,221,30,74,0.405,6,25,0.24,24,49,0.49,3,9,0.333,13,31,44,21,7,3,7,30,69
2018,Gary Payton II,PG,25,MIL,12,6,106,13,33,0.394,2,12,0.167,11,21,0.524,2,3,0.667,4,13,17,9,3,1,3,17,30
2018,Gary Payton II,PG,25,LAL,11,0,115,17,41,0.415,4,13,0.308,13,28,0.464,1,6,0.167,9,18,27,12,4,2,4,13,39
2018,George Hill,PG,31,TOT,67,60,1812,236,513,0.46,85,205,0.415,151,308,0.49,110,140,0.786,42,139,181,186,61,27,88,128,667
2018,George Hill,PG,31,SAC,43,36,1143,153,326,0.469,58,128,0.453,95,198,0.48,77,99,0.778,22,95,117,119,39,12,60,75,441
2018,George Hill,PG,31,CLE,24,24,669,83,187,0.444,27,77,0.351,56,110,0.509,33,41,0.805,20,44,64,67,22,15,28,53,226
2018,Georges Niang,PF,24,UTA,9,0,32,4,11,0.364,0,4,0,4,7,0.571,1,2,0.5,3,6,9,3,2,0,3,1,9
2018,Georgios Papagiannis,C,20,TOT,17,0,122,18,42,0.429,0,0,,18,42,0.429,0,0,,13,24,37,9,4,6,8,12,36
2018,Georgios Papagiannis,C,20,SAC,16,0,118,17,41,0.415,0,0,,17,41,0.415,0,0,,12,24,36,9,2,6,8,12,34
2018,Georgios Papagiannis,C,20,POR,1,0,4,1,1,1,0,0,,1,1,1,0,0,,1,0,1,0,2,0,0,0,2
2018,Gerald Green,SG,32,HOU,41,2,929,168,413,0.407,110,298,0.369,58,115,0.504,51,60,0.85,15,118,133,25,24,15,31,87,497
2018,Gian Clavell,SG,24,DAL,7,0,64,6,18,0.333,6,15,0.4,0,3,0,2,2,1,1,6,7,3,2,0,2,8,20
2018,Giannis Antetokounmpo,PF,23,MIL,75,75,2756,742,1402,0.529,43,140,0.307,699,1262,0.554,487,641,0.76,156,597,753,361,109,106,223,231,2014
2018,Glenn Robinson III,SF,24,IND,23,1,338,36,85,0.424,14,34,0.412,22,51,0.431,9,11,0.818,11,26,37,17,13,1,5,14,95
2018,Goran Dragić,PG,31,MIA,75,75,2378,484,1075,0.45,111,300,0.37,373,775,0.481,217,271,0.801,54,252,306,359,63,12,166,180,1296
2018,Gordon Hayward,SF,27,BOS,1,1,5,1,2,0.5,0,1,0,1,1,1,0,0,,0,1,1,0,0,0,0,1,2
2018,Gorgui Dieng,C,28,MIN,79,0,1333,186,388,0.479,19,61,0.311,167,327,0.511,79,102,0.775,106,254,360,71,45,39,59,147,470
2018,Greg Monroe,C,27,TOT,51,14,1040,218,386,0.565,0,0,,218,386,0.565,88,119,0.739,109,241,350,114,44,23,94,95,524
2018,Greg Monroe,C,27,MIL,5,0,79,16,33,0.485,0,0,,16,33,0.485,2,4,0.5,6,19,25,5,0,0,6,7,34
2018,Greg Monroe,C,27,PHO,20,14,465,97,155,0.626,0,0,,97,155,0.626,31,46,0.674,50,110,160,50,16,6,40,40,225
2018,Greg Monroe,C,27,BOS,26,0,496,105,198,0.53,0,0,,105,198,0.53,55,69,0.797,53,112,165,59,28,17,48,48,265
2018,Guerschon Yabusele,PF,22,BOS,33,4,235,26,61,0.426,12,37,0.324,14,24,0.583,15,22,0.682,17,35,52,16,4,5,12,23,79
2018,Harrison Barnes,PF,25,DAL,77,77,2634,537,1208,0.445,119,333,0.357,418,875,0.478,259,313,0.827,77,391,468,152,49,14,118,94,1452
2018,Hassan Whiteside,C,28,MIA,54,54,1364,312,578,0.54,2,2,1,310,576,0.538,128,182,0.703,174,444,618,54,37,94,92,131,754
2018,Henry Ellenson,PF,21,DET,38,0,329,53,146,0.363,20,60,0.333,33,86,0.384,25,29,0.862,10,71,81,20,5,0,18,22,151
2018,Ian Clark,SG,26,NOP,74,2,1455,222,495,0.448,62,195,0.318,160,300,0.533,45,59,0.763,10,117,127,110,33,10,57,120,551
2018,Ian Mahinmi,C,31,WAS,77,0,1145,138,248,0.556,0,2,0,138,246,0.561,90,128,0.703,135,177,312,53,38,42,100,230,366
2018,Ike Anigbogu,C,19,IND,11,0,30,4,9,0.444,0,0,,4,9,0.444,5,6,0.833,5,4,9,0,1,3,2,1,13
2018,Iman Shumpert,SG,27,CLE,14,6,276,22,58,0.379,7,26,0.269,15,32,0.469,11,15,0.733,7,34,41,17,9,4,16,22,62
2018,Isaiah Canaan,PG-SG,26,TOT,20,1,422,52,137,0.38,22,66,0.333,30,71,0.423,46,51,0.902,6,39,45,76,16,1,29,36,172
2018,Isaiah Canaan,SG,26,HOU,1,0,4,0,1,0,0,0,,0,1,0,0,0,,0,1,1,0,0,0,0,0,0
2018,Isaiah Canaan,PG,26,PHO,19,1,418,52,136,0.382,22,66,0.333,30,70,0.429,46,51,0.902,6,38,44,76,16,1,29,36,172
2018,Isaiah Hicks,PF,23,NYK,18,0,240,33,72,0.458,2,9,0.222,31,63,0.492,12,18,0.667,10,31,41,16,2,4,16,45,80
2018,Isaiah Taylor,PG,23,ATL,67,9,1167,163,390,0.418,20,80,0.25,143,310,0.461,99,141,0.702,22,72,94,206,34,10,84,116,445
2018,Isaiah Thomas,PG,28,TOT,32,15,862,157,421,0.373,55,188,0.293,102,233,0.438,117,131,0.893,17,50,67,153,15,3,95,58,486
2018,Isaiah Thomas,PG,28,CLE,15,14,406,70,194,0.361,22,87,0.253,48,107,0.449,59,68,0.868,7,24,31,68,9,2,41,25,221
2018,Isaiah Thomas,PG,28,LAL,17,1,456,87,227,0.383,33,101,0.327,54,126,0.429,58,63,0.921,10,26,36,85,6,1,54,33,265
2018,Isaiah Whitehead,PG,22,BRK,16,0,180,40,86,0.465,7,18,0.389,33,68,0.485,13,19,0.684,4,22,26,20,8,2,24,23,100
2018,Ish Smith,PG,29,DET,82,35,2043,389,801,0.486,35,101,0.347,354,700,0.506,81,116,0.698,27,197,224,360,64,20,108,140,894
2018,Ivan Rabb,PF,20,MEM,36,5,516,86,152,0.566,0,0,,86,152,0.566,29,36,0.806,53,105,158,32,12,13,35,55,201
2018,Ivica Zubac,C,20,LAL,43,0,410,61,122,0.5,0,1,0,61,121,0.504,39,51,0.765,45,78,123,25,8,15,26,47,161
2018,J.J. Barea,PG,33,DAL,69,10,1603,303,690,0.439,115,313,0.367,188,377,0.499,80,102,0.784,15,186,201,434,35,3,143,83,801
2018,J.J. Redick,SG,33,PHI,70,70,2116,404,879,0.46,193,460,0.42,211,419,0.504,197,218,0.904,9,169,178,210,35,6,103,123,1198
2018,J.R. Smith,SG,32,CLE,80,61,2244,240,595,0.403,143,381,0.375,97,214,0.453,39,56,0.696,29,206,235,141,68,11,81,161,662
2018,Jabari Bird,SG,23,BOS,13,1,115,15,26,0.577,3,7,0.429,12,19,0.632,6,13,0.462,6,13,19,8,3,1,8,7,39
2018,Jabari Parker,PF,22,MIL,31,3,743,160,332,0.482,31,81,0.383,129,251,0.514,40,54,0.741,42,109,151,59,25,10,45,50,391
2018,Jack Cooley,PF,26,SAC,7,0,87,13,27,0.481,0,0,,13,27,0.481,14,19,0.737,14,16,30,6,1,0,3,13,40
2018,Jacob Pullen,PG,28,PHI,3,0,6,1,2,0.5,0,1,0,1,1,1,0,0,,0,0,0,0,0,0,1,0,2
2018,Jacob Wiley,PF,23,BRK,5,0,33,1,4,0.25,1,2,0.5,0,2,0,1,2,0.5,2,9,11,2,1,0,0,4,4
2018,Jae Crowder,SF,27,TOT,80,47,2090,271,671,0.404,110,341,0.323,161,330,0.488,121,148,0.818,59,216,275,99,64,21,74,187,773
2018,Jae Crowder,SF,27,CLE,53,47,1346,157,376,0.418,62,189,0.328,95,187,0.508,78,92,0.848,41,132,173,58,41,12,42,124,454
2018,Jae Crowder,SF,27,UTA,27,0,744,114,295,0.386,48,152,0.316,66,143,0.462,43,56,0.768,18,84,102,41,23,9,32,63,319
2018,Jahlil Okafor,C,22,TOT,28,0,353,77,138,0.558,1,4,0.25,76,134,0.567,21,29,0.724,21,64,85,12,3,18,21,51,176
2018,Jahlil Okafor,C,22,PHI,2,0,25,4,9,0.444,0,0,,4,9,0.444,2,4,0.5,4,5,9,1,0,2,3,7,10
2018,Jahlil Okafor,C,22,BRK,26,0,328,73,129,0.566,1,4,0.25,72,125,0.576,19,25,0.76,17,59,76,11,3,16,18,44,166
2018,JaKarr Sampson,SF,24,SAC,22,6,344,44,81,0.543,5,10,0.5,39,71,0.549,10,16,0.625,21,57,78,9,8,22,8,48,103
2018,Jake Layman,SF,23,POR,35,1,160,14,47,0.298,4,20,0.2,10,27,0.37,2,3,0.667,4,12,16,11,6,4,5,13,34
2018,Jakob Poeltl,C,22,TOR,82,0,1524,253,384,0.659,1,2,0.5,252,382,0.66,60,101,0.594,165,228,393,57,39,100,85,212,567
2018,Jalen Jones,SF,24,TOT,16,0,181,26,68,0.382,10,26,0.385,16,42,0.381,12,19,0.632,13,25,38,4,5,1,7,22,74
2018,Jalen Jones,SF,24,NOP,4,0,19,1,4,0.25,1,1,1,0,3,0,2,2,1,0,3,3,0,0,0,0,2,5
2018,Jalen Jones,SF,24,DAL,12,0,162,25,64,0.391,9,25,0.36,16,39,0.41,10,17,0.588,13,22,35,4,5,1,7,20,69
2018,Jamal Crawford,SG,37,MIN,80,0,1653,308,742,0.415,104,314,0.331,204,428,0.477,102,113,0.903,21,78,99,185,40,9,95,85,822
2018,Jamal Murray,PG,20,DEN,81,80,2565,479,1062,0.451,165,436,0.378,314,626,0.502,229,253,0.905,82,215,297,274,79,28,172,173,1352
2018,Jameel Warney,PF,24,DAL,3,0,27,7,12,0.583,0,0,,7,12,0.583,3,5,0.6,4,5,9,0,0,0,1,2,17
2018,Jameer Nelson,PG,35,TOT,50,0,1013,95,244,0.389,41,124,0.331,54,120,0.45,16,20,0.8,13,91,104,179,27,4,67,81,247
2018,Jameer Nelson,PG,35,NOP,43,0,897,84,205,0.41,40,110,0.364,44,95,0.463,13,17,0.765,11,85,96,156,23,3,56,67,221
2018,Jameer Nelson,PG,35,DET,7,0,116,11,39,0.282,1,14,0.071,10,25,0.4,3,3,1,2,6,8,23,4,1,11,14,26
2018,Jamel Artis,SG,25,ORL,15,1,279,31,79,0.392,8,29,0.276,23,50,0.46,7,12,0.583,4,34,38,18,2,3,8,11,77
2018,James Ennis III,SF,27,TOT,72,22,1604,182,384,0.474,51,153,0.333,131,231,0.567,97,116,0.836,73,151,224,71,47,18,56,134,512
2018,James Ennis III,SF,27,MEM,45,14,1053,108,222,0.486,30,84,0.357,78,138,0.565,64,73,0.877,53,104,157,49,32,12,38,81,310
2018,James Ennis III,SF,27,DET,27,8,551,74,162,0.457,21,69,0.304,53,93,0.57,33,43,0.767,20,47,67,22,15,6,18,53,202
2018,James Harden,SG,28,HOU,72,72,2551,651,1449,0.449,265,722,0.367,386,727,0.531,624,727,0.858,41,348,389,630,126,50,315,169,2191
2018,James Johnson,PF,30,MIA,73,41,1943,309,614,0.503,57,185,0.308,252,429,0.587,113,162,0.698,61,297,358,280,70,51,141,192,788
2018,James Michael McAdoo,PF,25,PHI,3,0,18,2,7,0.286,2,7,0.286,0,0,,2,2,1,0,2,2,0,0,1,1,1,8
2018,James Webb III,SF,24,BRK,10,0,120,6,24,0.25,4,19,0.211,2,5,0.4,0,0,,8,16,24,4,1,0,4,10,16
2018,James Young,SG,22,PHI,6,0,61,5,14,0.357,3,10,0.3,2,4,0.5,4,6,0.667,0,2,2,2,0,0,1,4,17
2018,Jamil Wilson,SF,27,LAC,15,10,274,38,81,0.469,27,63,0.429,11,18,0.611,2,4,0.5,3,29,32,10,5,8,8,34,105
2018,JaMychal Green,PF,27,MEM,55,54,1542,223,488,0.457,43,127,0.339,180,361,0.499,80,111,0.721,147,317,464,79,32,25,76,153,569
2018,Jared Dudley,PF,32,PHO,48,0,686,48,122,0.393,29,80,0.363,19,42,0.452,27,35,0.771,8,86,94,78,24,11,28,85,152
2018,Jarell Eddie,SF,26,TOT,3,0,9,0,2,0,0,2,0,0,0,,0,0,,0,1,1,0,1,0,0,0,0
2018,Jarell Eddie,SF,26,BOS,2,0,6,0,1,0,0,1,0,0,0,,0,0,,0,1,1,0,1,0,0,0,0
2018,Jarell Eddie,SF,26,CHI,1,0,3,0,1,0,0,1,0,0,0,,0,0,,0,0,0,0,0,0,0,0,0
2018,Jarell Martin,PF,23,MEM,73,36,1661,221,496,0.446,34,98,0.347,187,398,0.47,89,116,0.767,97,221,318,73,39,49,86,211,565
2018,Jarrett Allen,C,19,BRK,72,31,1441,234,397,0.589,5,15,0.333,229,382,0.599,114,147,0.776,144,244,388,49,28,88,82,147,587
2018,Jarrett Jack,PG,34,NYK,62,56,1548,189,443,0.427,25,86,0.291,164,357,0.459,63,75,0.84,22,169,191,348,35,4,115,98,466
2018,Jason Smith,C,31,WAS,33,2,285,45,115,0.391,4,32,0.125,41,83,0.494,19,21,0.905,18,35,53,14,3,13,16,44,113
2018,Jason Terry,SG,40,MIL,51,4,814,59,154,0.383,40,115,0.348,19,39,0.487,8,9,0.889,5,43,48,59,42,13,25,52,166
2018,JaVale McGee,C,30,GSW,65,17,615,136,219,0.621,0,6,0,136,213,0.638,38,52,0.731,59,110,169,33,21,57,27,91,310
2018,Jawun Evans,PG,21,LAC,48,4,778,89,253,0.352,15,54,0.278,74,199,0.372,38,49,0.776,9,75,84,100,36,6,44,97,231
2018,Jaylen Brown,SG,21,BOS,70,70,2152,373,803,0.465,121,306,0.395,252,497,0.507,150,233,0.644,66,280,346,114,70,26,124,181,1017
2018,Jaylen Morris,SG,22,ATL,6,0,98,13,32,0.406,2,10,0.2,11,22,0.5,0,0,,2,14,16,7,2,1,6,2,28
2018,Jayson Tatum,SF,19,BOS,80,80,2443,397,835,0.475,105,242,0.434,292,593,0.492,213,258,0.826,50,352,402,128,83,58,114,170,1112
2018,Jeff Green,PF,31,CLE,78,13,1828,295,618,0.477,53,170,0.312,242,448,0.54,203,234,0.868,60,186,246,99,41,34,75,149,846
2018,Jeff Teague,PG,29,MIN,70,70,2311,354,794,0.446,84,228,0.368,270,566,0.477,202,239,0.845,24,185,209,492,102,23,177,171,994
2018,Jeff Withey,C,27,DAL,9,0,39,6,16,0.375,2,10,0.2,4,6,0.667,1,2,0.5,1,9,10,0,0,3,2,3,15
2018,Jerami Grant,PF,23,OKC,81,1,1647,244,456,0.535,32,110,0.291,212,346,0.613,162,240,0.675,86,233,319,57,31,77,54,155,682
2018,Jeremy Evans,SF,30,ATL,1,0,5,1,1,1,0,0,,1,1,1,0,0,,1,0,1,0,0,0,1,1,2
2018,Jeremy Lamb,SG,25,CHO,80,18,1967,380,832,0.457,94,254,0.37,286,578,0.495,179,208,0.861,49,275,324,186,61,32,93,138,1033
2018,Jeremy Lin,PG,29,BRK,1,1,25,5,12,0.417,1,2,0.5,4,10,0.4,7,7,1,0,0,0,4,0,0,3,3,18
2018,Jerian Grant,PG,25,CHI,74,26,1686,209,503,0.416,61,187,0.326,148,316,0.468,140,188,0.745,31,141,172,342,63,8,89,132,619
2018,Jerryd Bayless,SG,29,PHI,39,11,925,109,262,0.416,54,146,0.37,55,116,0.474,35,44,0.795,15,65,80,54,23,6,46,91,307
2018,Jimmy Butler,SG,28,MIN,59,59,2164,437,921,0.474,70,200,0.35,367,721,0.509,363,425,0.854,79,235,314,288,116,24,108,78,1307
2018,Joakim Noah,C,32,NYK,7,0,40,5,10,0.5,0,0,,5,10,0.5,2,4,0.5,6,8,14,4,2,2,4,5,12
2018,Jodie Meeks,SG,30,WAS,77,0,1119,157,393,0.399,72,210,0.343,85,183,0.464,101,117,0.863,15,111,126,70,29,4,37,55,487
2018,Joe Harris,SG,26,BRK,78,14,1975,305,621,0.491,150,358,0.419,155,263,0.589,86,104,0.827,51,209,260,128,35,20,91,153,846
2018,Joe Ingles,SF,30,UTA,82,81,2578,335,718,0.467,204,464,0.44,131,254,0.516,66,83,0.795,24,320,344,392,90,20,159,178,940
2018,Joe Johnson,SF,36,TOT,55,4,1205,146,360,0.406,40,145,0.276,106,215,0.493,40,45,0.889,14,158,172,83,18,7,49,67,372
2018,Joe Johnson,SF,36,UTA,32,3,700,95,226,0.42,23,84,0.274,72,142,0.507,20,24,0.833,12,95,107,45,12,6,31,32,233
2018,Joe Johnson,SF,36,HOU,23,1,505,51,134,0.381,17,61,0.279,34,73,0.466,20,21,0.952,2,63,65,38,6,1,18,35,139
2018,Joe Young,PG,25,IND,53,1,558,80,186,0.43,25,66,0.379,55,120,0.458,22,29,0.759,12,51,63,39,14,1,26,39,207
2018,Joel Bolomboy,PF,24,MIL,6,0,38,3,6,0.5,0,1,0,3,5,0.6,3,6,0.5,6,4,10,0,2,0,2,3,9
2018,Joel Embiid,C,23,PHI,63,63,1912,510,1056,0.483,66,214,0.308,444,842,0.527,359,467,0.769,143,547,690,199,40,111,234,209,1445
2018,Joffrey Lauvergne,C,26,SAS,55,1,534,98,190,0.516,0,5,0,98,185,0.53,30,47,0.638,63,108,171,41,9,3,33,45,226
2018,John Collins,PF,20,ATL,74,26,1785,314,545,0.576,16,47,0.34,298,498,0.598,133,186,0.715,176,365,541,98,47,80,105,215,777
2018,John Henson,C,27,MIL,76,69,1970,287,502,0.572,1,7,0.143,286,495,0.578,90,158,0.57,150,363,513,114,45,109,84,202,665
2018,John Holland,SF,29,CLE,24,0,174,17,59,0.288,11,36,0.306,6,23,0.261,9,13,0.692,6,18,24,5,7,2,8,10,54
2018,John Wall,PG,27,WAS,41,41,1410,280,667,0.42,62,167,0.371,218,500,0.436,175,241,0.726,22,128,150,393,57,45,158,80,797
2018,Johnathan Motley,PF,22,DAL,11,4,176,40,75,0.533,1,6,0.167,39,69,0.565,15,28,0.536,14,35,49,7,3,2,9,18,96
2018,Johnny O'Bryant,PF,24,CHO,36,0,379,68,171,0.398,14,43,0.326,54,128,0.422,21,25,0.84,29,64,93,14,9,6,15,45,171
2018,Jon Leuer,PF,28,DET,8,0,136,15,36,0.417,0,3,0,15,33,0.455,13,15,0.867,7,25,32,5,1,3,7,16,43
2018,Jonas Jerebko,PF,30,UTA,74,19,1134,159,341,0.466,65,157,0.414,94,184,0.511,46,57,0.807,53,193,246,42,24,12,27,127,429
2018,Jonas Valančiūnas,C,25,TOR,77,77,1727,390,687,0.568,30,74,0.405,360,613,0.587,170,211,0.806,183,477,660,81,29,69,115,192,980
2018,Jonathan Gibson,PG,30,BOS,4,0,40,14,23,0.609,6,12,0.5,8,11,0.727,0,0,,0,3,3,4,0,0,3,5,34
2018,Jonathan Isaac,PF,20,ORL,27,10,536,55,145,0.379,16,46,0.348,39,99,0.394,19,25,0.76,16,83,99,18,33,30,27,48,145
2018,Jonathon Simmons,SG,28,ORL,69,50,2029,354,761,0.465,69,204,0.338,285,557,0.512,185,241,0.768,61,178,239,171,58,16,146,175,962
2018,Jordan Bell,C,23,GSW,57,13,809,116,185,0.627,0,4,0,116,181,0.641,30,44,0.682,60,147,207,102,35,56,51,92,262
2018,Jordan Clarkson,SG,25,TOT,81,2,1888,430,954,0.451,112,318,0.352,318,636,0.5,152,190,0.8,57,160,217,221,58,6,127,107,1124
2018,Jordan Clarkson,SG,25,LAL,53,2,1256,299,667,0.448,68,210,0.324,231,457,0.505,105,132,0.795,44,115,159,173,39,3,95,63,771
2018,Jordan Clarkson,SG,25,CLE,28,0,632,131,287,0.456,44,108,0.407,87,179,0.486,47,58,0.81,13,45,58,48,19,3,32,44,353
2018,Jordan Crawford,SG,29,NOP,5,0,53,12,27,0.444,8,14,0.571,4,13,0.308,1,1,1,2,2,4,13,1,1,5,7,33
2018,Jordan Mickey,PF,23,MIA,23,3,284,39,82,0.476,2,16,0.125,37,66,0.561,13,19,0.684,18,63,81,9,6,10,18,36,93
2018,José Calderón,PG,36,CLE,57,32,914,93,185,0.503,45,97,0.464,48,88,0.545,24,30,0.8,14,70,84,117,27,2,41,81,255
2018,Josh Gray,PG,24,PHO,5,0,86,11,41,0.268,3,13,0.231,8,28,0.286,7,11,0.636,2,8,10,12,8,2,7,8,32
2018,Josh Hart,SG,22,LAL,63,23,1461,176,375,0.469,78,197,0.396,98,178,0.551,66,94,0.702,42,221,263,80,47,16,47,107,496
2018,Josh Huestis,PF,26,OKC,69,10,982,60,182,0.33,33,115,0.287,27,67,0.403,6,20,0.3,42,119,161,20,15,43,26,82,159
2018,Josh Jackson,SF,20,PHO,77,35,1959,389,932,0.417,57,217,0.263,332,715,0.464,177,279,0.634,95,256,351,119,80,35,146,218,1012
2018,Josh Magette,PG,28,ATL,18,0,216,15,46,0.326,8,22,0.364,7,24,0.292,8,8,1,2,17,19,57,8,1,9,16,46
2018,Josh McRoberts,PF,30,DAL,2,0,6,0,1,0,0,1,0,0,0,,0,0,,0,0,0,0,0,0,0,2,0
2018,Josh Richardson,SF,24,MIA,81,81,2689,399,885,0.451,127,336,0.378,272,549,0.495,120,142,0.845,69,216,285,231,121,75,140,199,1045
2018,Josh Smith,PF,32,NOP,3,0,12,1,4,0.25,0,0,,1,4,0.25,0,0,,3,1,4,0,0,0,0,3,2
2018,Jrue Holiday,SG,27,NOP,81,81,2927,615,1244,0.494,120,356,0.337,495,888,0.557,187,238,0.786,62,303,365,486,123,64,213,201,1537
2018,Juancho Hernangómez,PF,22,DEN,25,3,277,29,75,0.387,14,50,0.28,15,25,0.6,10,12,0.833,18,36,54,12,6,3,9,25,82
2018,Julius Randle,C,23,LAL,82,49,2190,504,904,0.558,10,45,0.222,494,859,0.575,305,425,0.718,181,473,654,210,43,45,213,274,1323
2018,Julyan Stone,SG,29,CHO,23,0,175,6,13,0.462,6,13,0.462,0,0,,1,2,0.5,1,28,29,26,4,2,7,21,19
2018,Justin Anderson,SF,24,PHI,38,0,519,87,202,0.431,34,103,0.33,53,99,0.535,28,38,0.737,25,68,93,25,15,7,16,54,236
2018,Justin Holiday,SG,28,CHI,72,72,2265,290,782,0.371,161,449,0.359,129,333,0.387,135,164,0.823,31,260,291,153,80,31,93,134,876
2018,Justin Jackson,SF,22,SAC,68,41,1506,185,419,0.442,57,185,0.308,128,234,0.547,26,36,0.722,27,160,187,74,28,13,40,81,453
2018,Justin Patton,C,20,MIN,1,0,4,1,2,0.5,0,0,,1,2,0.5,0,0,,0,0,0,0,1,0,0,1,2
2018,Justise Winslow,PF,21,MIA,68,25,1680,207,488,0.424,49,129,0.38,158,359,0.44,66,104,0.635,64,306,370,148,54,33,77,140,529
2018,Jusuf Nurkić,C,23,POR,79,79,2088,480,951,0.505,0,7,0,480,944,0.508,172,273,0.63,189,519,708,143,64,111,183,247,1132
2018,Kadeem Allen,PG,25,BOS,18,1,107,6,22,0.273,0,11,0,6,11,0.545,7,9,0.778,4,7,11,12,3,2,9,15,19
2018,Karl-Anthony Towns,C,22,MIN,82,82,2918,639,1172,0.545,120,285,0.421,519,887,0.585,345,402,0.858,238,774,1012,199,64,115,159,285,1743
2018,Kawhi Leonard,SF,26,SAS,9,9,210,52,111,0.468,11,35,0.314,41,76,0.539,31,38,0.816,6,36,42,21,18,9,16,9,146
2018,Kay Felder,PG,22,TOT,16,0,140,21,70,0.3,4,19,0.211,17,51,0.333,11,12,0.917,3,15,18,20,3,1,16,11,57
2018,Kay Felder,PG,22,CHI,14,0,134,20,66,0.303,4,18,0.222,16,48,0.333,11,12,0.917,1,13,14,20,3,1,15,11,55
2018,Kay Felder,PG,22,DET,2,0,6,1,4,0.25,0,1,0,1,3,0.333,0,0,,2,2,4,0,0,0,1,0,2
2018,Kelly Olynyk,PF,26,MIA,76,22,1779,316,636,0.497,106,280,0.379,210,356,0.59,134,174,0.77,89,342,431,207,62,35,147,222,872
2018,Kelly Oubre Jr.,SF,22,WAS,81,11,2231,318,790,0.403,126,369,0.341,192,421,0.456,191,233,0.82,59,304,363,98,80,35,90,234,953
2018,Kemba Walker,PG,27,CHO,80,80,2736,588,1363,0.431,231,601,0.384,357,762,0.469,363,420,0.864,32,216,248,444,91,24,179,98,1770
2018,Kendrick Perkins,C,33,CLE,1,0,15,1,2,0.5,0,0,,1,2,0.5,1,2,0.5,0,1,1,2,1,0,1,1,3
2018,Kenneth Faried,PF,28,DEN,32,7,461,76,148,0.514,0,1,0,76,147,0.517,36,51,0.706,68,85,153,18,12,13,23,51,188
2018,Kent Bazemore,SG,28,ATL,65,65,1789,284,676,0.42,108,274,0.394,176,402,0.438,160,201,0.796,25,223,248,228,100,45,157,147,836
2018,Kentavious Caldwell-Pope,SG,24,LAL,74,74,2458,340,798,0.426,159,415,0.383,181,383,0.473,153,194,0.789,60,327,387,162,106,16,97,145,992
2018,Kevin Durant,SF,29,GSW,68,68,2325,630,1222,0.516,173,413,0.419,457,809,0.565,359,404,0.889,31,433,464,366,50,119,207,133,1792
2018,Kevin Love,C,29,CLE,59,59,1651,334,729,0.458,137,330,0.415,197,399,0.494,234,266,0.88,101,445,546,103,43,24,90,120,1039
2018,Kevon Looney,C,21,GSW,66,4,910,112,193,0.58,1,5,0.2,111,188,0.59,42,77,0.545,83,132,215,42,34,56,31,106,267
2018,Khem Birch,C,25,ORL,42,0,578,68,126,0.54,0,0,,68,126,0.54,42,61,0.689,70,110,180,34,15,21,21,56,178
2018,Khris Middleton,SF,26,MIL,82,82,2982,593,1272,0.466,146,407,0.359,447,865,0.517,320,362,0.884,45,384,429,328,119,21,191,270,1652
2018,Klay Thompson,SG,27,GSW,73,73,2506,575,1179,0.488,229,521,0.44,346,658,0.526,82,98,0.837,31,246,277,185,55,34,128,117,1461
2018,Kobi Simmons,PG,20,MEM,32,12,643,80,189,0.423,11,39,0.282,69,150,0.46,25,25,1,14,36,50,68,18,5,44,61,196
2018,Kosta Koufos,C,28,SAC,71,13,1391,222,389,0.571,0,0,,222,389,0.571,33,74,0.446,149,323,472,87,47,32,49,146,477
2018,Kris Dunn,PG,23,CHI,52,43,1525,286,666,0.429,43,134,0.321,243,532,0.457,84,114,0.737,24,197,221,310,104,27,150,174,699
2018,Kristaps Porziņģis,PF,22,NYK,48,48,1553,390,889,0.439,90,228,0.395,300,661,0.454,218,275,0.793,62,254,316,57,36,115,93,141,1088
2018,Kyle Anderson,SF,24,SAS,74,67,1978,231,438,0.527,19,57,0.333,212,381,0.556,104,146,0.712,84,312,396,202,115,60,94,114,585
2018,Kyle Collinsworth,SF,26,DAL,32,2,480,38,99,0.384,4,17,0.235,34,82,0.415,21,40,0.525,32,75,107,56,17,9,24,44,101
2018,Kyle Korver,SG,36,CLE,73,4,1574,222,484,0.459,164,376,0.436,58,108,0.537,64,72,0.889,9,156,165,88,31,27,55,130,672
2018,Kyle Kuzma,PF,22,LAL,77,37,2401,468,1039,0.45,159,434,0.366,309,605,0.511,147,208,0.707,88,395,483,141,49,34,140,160,1242
2018,Kyle Lowry,PG,31,TOR,78,78,2510,403,944,0.427,238,596,0.399,165,348,0.474,223,261,0.854,66,368,434,537,85,19,183,192,1267
2018,Kyle O'Quinn,C,27,NYK,77,10,1387,224,384,0.583,4,17,0.235,220,367,0.599,98,127,0.772,121,349,470,158,36,98,100,192,550
2018,Kyle Singler,SF,29,OKC,12,0,59,7,21,0.333,2,5,0.4,5,16,0.313,7,13,0.538,1,9,10,2,1,0,3,4,23
2018,Kyrie Irving,PG,25,BOS,60,60,1931,534,1087,0.491,166,407,0.408,368,680,0.541,232,261,0.889,33,194,227,306,65,17,140,122,1466
2018,LaMarcus Aldridge,C,32,SAS,75,75,2509,687,1347,0.51,27,92,0.293,660,1255,0.526,334,399,0.837,246,389,635,152,43,90,111,161,1735
2018,Lance Stephenson,SG,27,IND,82,7,1850,303,709,0.427,67,232,0.289,236,477,0.495,84,127,0.661,62,362,424,235,46,17,131,177,757
2018,Lance Thomas,PF,29,NYK,73,31,1353,102,267,0.382,50,124,0.403,52,143,0.364,44,53,0.83,44,131,175,44,30,14,40,134,298
2018,Langston Galloway,SG,26,DET,58,2,863,126,340,0.371,75,218,0.344,51,122,0.418,33,41,0.805,13,79,92,58,35,5,18,39,360
2018,Larry Drew II,PG,27,TOT,10,0,70,7,24,0.292,3,9,0.333,4,15,0.267,0,0,,3,0,3,10,0,0,3,6,17
2018,Larry Drew II,PG,27,PHI,3,0,15,1,7,0.143,0,3,0,1,4,0.25,0,0,,1,0,1,2,0,0,1,2,2
2018,Larry Drew II,PG,27,NOP,7,0,55,6,17,0.353,3,6,0.5,3,11,0.273,0,0,,2,0,2,8,0,0,2,4,15
2018,Larry Nance Jr.,C,25,TOT,66,27,1421,240,413,0.581,2,12,0.167,238,401,0.594,91,137,0.664,161,291,452,82,88,38,51,172,573
2018,Larry Nance Jr.,C,25,LAL,42,17,922,152,253,0.601,1,4,0.25,151,249,0.606,55,87,0.632,108,176,284,57,59,20,41,113,360
2018,Larry Nance Jr.,C,25,CLE,24,10,499,88,160,0.55,1,8,0.125,87,152,0.572,36,50,0.72,53,115,168,25,29,18,10,59,213
2018,Lauri Markkanen,PF,20,CHI,68,68,2020,374,862,0.434,145,401,0.362,229,461,0.497,140,166,0.843,79,429,508,79,39,40,83,103,1033
2018,LeBron James,PF,33,CLE,82,82,3026,857,1580,0.542,149,406,0.367,708,1174,0.603,388,531,0.731,97,612,709,747,116,71,347,136,2251
2018,London Perrantes,PG,23,CLE,14,0,66,2,13,0.154,0,3,0,2,10,0.2,3,5,0.6,1,3,4,5,2,1,1,6,7
2018,Lonzo Ball,PG,20,LAL,52,50,1780,203,564,0.36,90,295,0.305,113,269,0.42,32,71,0.451,69,291,360,376,88,43,136,117,528
2018,Lorenzo Brown,PG,27,TOR,14,0,139,14,34,0.412,2,12,0.167,12,22,0.545,2,2,1,1,14,15,13,5,0,3,7,32
2018,Lou Williams,SG,31,LAC,79,19,2589,582,1337,0.435,186,518,0.359,396,819,0.484,432,491,0.88,40,158,198,417,85,19,234,106,1782
2018,Luc Mbah a Moute,PF,31,HOU,61,15,1564,166,345,0.481,63,173,0.364,103,172,0.599,65,95,0.684,22,164,186,55,72,25,68,100,460
2018,Lucas Nogueira,C,25,TOR,49,3,418,49,80,0.613,5,19,0.263,44,61,0.721,19,28,0.679,18,69,87,22,23,43,16,49,122
2018,Luis Montero,SG,24,DET,2,0,8,0,1,0,0,0,,0,1,0,0,0,,0,2,2,0,0,0,2,0,0
2018,Luke Babbitt,SF,28,TOT,50,14,715,91,215,0.423,60,156,0.385,31,59,0.525,17,22,0.773,7,89,96,31,8,7,19,54,259
2018,Luke Babbitt,SF,28,ATL,37,9,570,80,168,0.476,49,111,0.441,31,57,0.544,17,22,0.773,5,76,81,26,7,5,15,47,226
2018,Luke Babbitt,SF,28,MIA,13,5,145,11,47,0.234,11,45,0.244,0,2,0,0,0,,2,13,15,5,1,2,4,7,33
2018,Luke Kennard,SG,21,DET,73,9,1463,206,465,0.443,81,195,0.415,125,270,0.463,65,76,0.855,21,155,176,124,44,13,69,86,558
2018,Luke Kornet,PF,22,NYK,20,1,326,49,125,0.392,28,79,0.354,21,46,0.457,8,11,0.727,11,53,64,26,6,16,12,28,134
2018,Luol Deng,SF,32,LAL,1,1,13,1,2,0.5,0,0,,1,2,0.5,0,0,,0,0,0,1,1,0,1,0,2
2018,Malachi Richardson,SG,22,TOT,26,4,324,30,90,0.333,12,40,0.3,18,50,0.36,17,22,0.773,5,29,34,13,10,1,10,27,89
2018,Malachi Richardson,SG,22,SAC,25,4,319,29,88,0.33,12,39,0.308,17,49,0.347,17,22,0.773,5,28,33,13,10,1,10,27,87
2018,Malachi Richardson,SG,22,TOR,1,0,5,1,2,0.5,0,1,0,1,1,1,0,0,,0,1,1,0,0,0,0,0,2
2018,Malcolm Brogdon,PG,25,MIL,48,20,1436,244,503,0.485,62,161,0.385,182,342,0.532,75,85,0.882,23,133,156,152,41,13,66,128,625
2018,Malcolm Delaney,PG,28,ATL,54,3,1014,109,285,0.382,46,124,0.371,63,161,0.391,74,92,0.804,9,91,100,163,35,6,66,82,338
2018,Malcolm Miller,SF,24,TOR,15,4,126,13,28,0.464,8,21,0.381,5,7,0.714,4,4,1,4,11,15,3,1,2,5,10,38
2018,Malik Beasley,SG,21,DEN,62,0,583,73,178,0.41,28,82,0.341,45,96,0.469,22,33,0.667,14,57,71,31,15,7,24,36,196
2018,Malik Monk,SG,19,CHO,63,0,854,153,425,0.36,83,243,0.342,70,182,0.385,32,38,0.842,8,58,66,91,20,9,49,60,421
2018,Mangok Mathiang,C,25,CHO,4,0,20,4,7,0.571,0,0,,4,7,0.571,0,1,0,3,7,10,0,1,0,0,5,8
2018,Manu Ginóbili*,SG,40,SAS,65,0,1299,201,463,0.434,64,192,0.333,137,271,0.506,110,131,0.84,19,123,142,163,43,16,105,126,576
2018,Marc Gasol,C,33,MEM,73,73,2408,434,1033,0.42,109,320,0.341,325,713,0.456,281,337,0.834,78,514,592,305,54,101,194,185,1258
2018,Marcin Gortat,C,33,WAS,82,82,2075,290,560,0.518,0,0,,290,560,0.518,110,163,0.675,181,442,623,151,40,61,99,175,690
2018,Marco Belinelli,SG,31,TOT,80,2,1947,337,764,0.441,149,395,0.377,188,369,0.509,148,163,0.908,20,131,151,148,66,12,94,91,971
2018,Marco Belinelli,SG,31,ATL,52,1,1210,199,485,0.41,92,247,0.372,107,238,0.45,101,109,0.927,14,86,100,103,46,3,54,41,591
2018,Marco Belinelli,SG,31,PHI,28,1,737,138,279,0.495,57,148,0.385,81,131,0.618,47,54,0.87,6,45,51,45,20,9,40,50,380
2018,Marcus Georges-Hunt,SG,23,MIN,42,0,224,21,48,0.438,4,15,0.267,17,33,0.515,13,21,0.619,7,9,16,7,6,0,3,32,59
2018,Marcus Morris,PF,28,BOS,54,21,1442,262,611,0.429,86,234,0.368,176,377,0.467,124,154,0.805,43,246,289,72,35,12,65,100,734
2018,Marcus Paige,PG,24,CHO,5,0,28,4,14,0.286,2,8,0.25,2,6,0.333,2,2,1,0,4,4,3,0,0,0,0,12
2018,Marcus Smart,SG,23,BOS,54,11,1614,189,515,0.367,75,249,0.301,114,266,0.429,97,133,0.729,43,146,189,259,71,23,129,133,550
2018,Mario Chalmers,PG,31,MEM,66,10,1421,168,443,0.379,53,191,0.277,115,252,0.456,118,138,0.855,13,144,157,197,79,14,117,179,507
2018,Mario Hezonja,SF,22,ORL,75,30,1657,273,617,0.442,90,267,0.337,183,350,0.523,86,105,0.819,41,240,281,106,81,31,86,134,722
2018,Markel Brown,SG,26,HOU,4,0,31,2,7,0.286,1,5,0.2,1,2,0.5,0,0,,1,4,5,2,0,0,2,6,5
2018,Markelle Fultz,SG,19,PHI,14,0,253,45,111,0.405,0,1,0,45,110,0.409,10,21,0.476,11,32,43,53,12,4,17,22,100
2018,Markieff Morris,PF,28,WAS,73,73,1968,330,687,0.48,76,207,0.367,254,480,0.529,105,128,0.82,75,334,409,142,56,38,127,216,841
2018,Marquese Chriss,PF,20,PHO,72,49,1527,202,477,0.423,56,190,0.295,146,287,0.509,96,158,0.608,76,319,395,83,51,70,107,205,556
2018,Marquis Teague,PG,24,MEM,3,0,74,4,16,0.25,1,4,0.25,3,12,0.25,2,5,0.4,1,5,6,13,4,0,3,5,11
2018,Marreese Speights,C,30,ORL,52,3,675,138,349,0.395,86,233,0.369,52,116,0.448,40,55,0.727,21,112,133,40,8,22,40,106,402
2018,Marshall Plumlee,C,25,MIL,8,0,52,1,3,0.333,0,0,,1,3,0.333,12,16,0.75,4,13,17,2,0,1,3,10,14
2018,MarShon Brooks,SG,29,MEM,7,1,193,51,102,0.5,19,32,0.594,32,70,0.457,20,23,0.87,8,13,21,25,11,3,16,6,141
2018,Marvin Williams,PF,31,CHO,78,78,2006,258,563,0.458,126,305,0.413,132,258,0.512,102,123,0.829,74,296,370,96,56,38,66,116,744
2018,Mason Plumlee,C,27,DEN,74,26,1439,221,368,0.601,0,1,0,221,367,0.602,82,179,0.458,132,268,400,142,49,81,103,184,524
2018,Matt Costello,C,24,SAS,4,0,32,2,4,0.5,0,0,,2,4,0.5,0,0,,1,8,9,2,2,2,1,7,4
2018,Matt Williams,SG,24,MIA,3,0,11,2,6,0.333,1,5,0.2,1,1,1,0,0,,0,1,1,0,0,0,1,1,5
2018,Matthew Dellavedova,PG,27,MIL,38,3,712,55,152,0.362,29,78,0.372,26,74,0.351,25,27,0.926,14,50,64,145,14,0,49,67,164
2018,Maurice Harkless,SF,24,POR,59,36,1264,147,297,0.495,49,118,0.415,98,179,0.547,42,59,0.712,46,116,162,53,48,43,40,103,385
2018,Maxi Kleber,PF,26,DAL,72,36,1206,151,309,0.489,40,128,0.313,111,181,0.613,44,59,0.746,71,163,234,51,26,47,30,114,386
2018,Meyers Leonard,C,25,POR,33,2,254,46,78,0.59,11,26,0.423,35,52,0.673,9,11,0.818,12,58,70,17,7,0,10,36,112
2018,Michael Beasley,PF,29,NYK,74,30,1653,409,807,0.507,34,86,0.395,375,721,0.52,124,159,0.78,97,317,414,123,36,43,143,145,976
2018,Michael Carter-Williams,PG,26,CHO,52,2,835,76,229,0.332,14,59,0.237,62,170,0.365,73,89,0.82,37,101,138,116,44,23,52,99,239
2018,Michael Kidd-Gilchrist,SF,24,CHO,74,74,1850,282,560,0.504,0,2,0,282,558,0.505,117,171,0.684,84,218,302,71,51,32,53,143,681
2018,Mike Conley,PG,30,MEM,12,12,373,64,168,0.381,24,77,0.312,40,91,0.44,53,66,0.803,0,27,27,49,12,3,18,24,205
2018,Mike James,PG,27,TOT,36,10,687,123,321,0.383,26,98,0.265,97,223,0.435,64,84,0.762,13,77,90,126,28,7,49,48,336
2018,Mike James,PG,27,PHO,32,10,669,121,312,0.388,26,97,0.268,95,215,0.442,64,84,0.762,12,77,89,120,27,7,48,45,332
2018,Mike James,PG,27,NOP,4,0,18,2,9,0.222,0,1,0,2,8,0.25,0,0,,1,0,1,6,1,0,1,3,4
2018,Mike Muscala,C,26,ATL,53,7,1060,143,312,0.458,62,167,0.371,81,145,0.559,57,62,0.919,56,174,230,51,31,27,42,80,405
2018,Mike Scott,PF,29,WAS,76,1,1406,276,524,0.527,66,163,0.405,210,361,0.582,50,76,0.658,50,197,247,80,23,10,79,148,668
2018,Miles Plumlee,C,29,ATL,55,35,918,105,180,0.583,0,0,,105,180,0.583,27,60,0.45,77,151,228,45,17,30,63,79,237
2018,Miloš Teodosić,PG,30,LAC,45,36,1134,151,360,0.419,88,232,0.379,63,128,0.492,39,46,0.848,16,110,126,209,23,5,97,103,429
2018,Milton Doyle,SG,24,BRK,10,0,125,13,47,0.277,4,23,0.174,9,24,0.375,4,8,0.5,3,15,18,10,6,2,2,13,34
2018,Mindaugas Kuzminskas,SF,28,NYK,1,0,2,0,2,0,0,0,,0,2,0,0,0,,0,0,0,0,0,0,0,0,0
2018,Mirza Teletović,PF,32,MIL,10,0,159,25,57,0.439,21,45,0.467,4,12,0.333,0,0,,3,20,23,10,4,1,7,14,71
2018,Monte Morris,PG,22,DEN,3,0,25,4,6,0.667,0,1,0,4,5,0.8,2,2,1,0,2,2,7,3,0,1,1,10
2018,Montrezl Harrell,C,24,LAC,76,3,1293,348,548,0.635,1,7,0.143,347,541,0.641,139,222,0.626,103,203,306,74,36,52,68,143,836
2018,Myke Henry,SF,25,MEM,20,0,378,41,109,0.376,19,58,0.328,22,51,0.431,6,10,0.6,10,28,38,22,31,6,19,28,107
2018,Myles Turner,C,21,IND,65,62,1836,306,639,0.479,56,157,0.357,250,482,0.519,160,206,0.777,93,324,417,87,38,118,96,186,828
2018,Nate Wolters,PG,26,UTA,5,0,19,1,6,0.167,0,0,,1,6,0.167,0,0,,1,1,2,1,0,0,0,1,2
2018,Naz Mitrou-Long,SG,24,UTA,1,0,1,1,1,1,1,1,1,0,0,,0,0,,0,0,0,0,0,0,0,0,3
2018,Nemanja Bjelica,PF,29,MIN,67,21,1371,171,371,0.461,76,183,0.415,95,188,0.505,36,45,0.8,53,221,274,86,50,16,52,141,454
2018,Nenê,C,35,HOU,52,4,758,136,239,0.569,0,2,0,136,237,0.574,68,107,0.636,54,122,176,45,28,14,38,123,340
2018,Nerlens Noel,C,23,DAL,30,6,472,55,105,0.524,0,1,0,55,104,0.529,21,28,0.75,48,120,168,20,31,22,26,59,131
2018,Nick Collison,PF,37,OKC,15,0,75,13,19,0.684,0,0,,13,19,0.684,5,13,0.385,7,13,20,4,0,0,7,7,31
2018,Nick Young,SG,32,GSW,80,8,1393,201,488,0.412,123,326,0.377,78,162,0.481,56,65,0.862,20,105,125,36,38,7,39,100,581
2018,Nicolas Batum,SG,29,CHO,64,64,1981,270,650,0.415,92,274,0.336,178,376,0.473,108,130,0.831,57,249,306,349,65,23,131,72,740
2018,Nicolás Brussino,SF,24,ATL,4,0,10,0,2,0,0,2,0,0,0,,0,0,,0,3,3,0,0,0,0,0,0
2018,Nigel Hayes,SF,23,TOT,9,0,122,11,33,0.333,4,16,0.25,7,17,0.412,1,3,0.333,4,18,22,6,2,3,2,8,27
2018,Nigel Hayes,SF,23,LAL,2,0,11,1,3,0.333,0,2,0,1,1,1,1,1,1,0,0,0,2,0,0,0,0,3
2018,Nigel Hayes,SF,23,TOR,2,0,6,2,2,1,2,2,1,0,0,,0,0,,0,0,0,0,0,0,1,0,6
2018,Nigel Hayes,SF,23,SAC,5,0,105,8,28,0.286,2,12,0.167,6,16,0.375,0,2,0,4,18,22,4,2,3,1,8,18
2018,Nik Stauskas,SG,24,TOT,41,0,523,60,154,0.39,40,100,0.4,20,54,0.37,21,29,0.724,4,60,64,39,9,4,26,24,181
2018,Nik Stauskas,SG,24,PHI,6,0,45,1,4,0.25,0,1,0,1,3,0.333,2,2,1,0,1,1,1,4,0,4,3,4
2018,Nik Stauskas,SG,24,BRK,35,0,478,59,150,0.393,40,99,0.404,19,51,0.373,19,27,0.704,4,59,63,38,5,4,22,21,177
2018,Nikola Jokić,C,22,DEN,75,73,2443,504,1010,0.499,111,280,0.396,393,730,0.538,266,313,0.85,195,608,803,458,90,61,210,212,1385
2018,Nikola Mirotić,PF,26,TOT,55,14,1494,306,684,0.447,135,358,0.377,171,326,0.525,112,137,0.818,59,346,405,80,44,39,62,108,859
2018,Nikola Mirotić,PF,26,CHI,25,3,622,143,302,0.474,69,161,0.429,74,141,0.525,65,79,0.823,18,141,159,39,15,13,31,45,420
2018,Nikola Mirotić,PF,26,NOP,30,11,872,163,382,0.427,66,197,0.335,97,185,0.524,47,58,0.81,41,205,246,41,29,26,31,63,439
2018,Nikola Vučević,C,27,ORL,57,57,1683,399,840,0.475,64,204,0.314,335,636,0.527,77,94,0.819,101,422,523,191,56,62,109,144,939
2018,Noah Vonleh,PF,22,TOT,54,16,875,104,234,0.444,20,66,0.303,84,168,0.5,36,58,0.621,70,241,311,34,19,17,31,68,264
2018,Noah Vonleh,PF,22,POR,33,12,476,47,96,0.49,2,6,0.333,45,90,0.5,23,31,0.742,35,132,167,13,6,11,15,42,119
2018,Noah Vonleh,PF,22,CHI,21,4,399,57,138,0.413,18,60,0.3,39,78,0.5,13,27,0.481,35,109,144,21,13,6,16,26,145
2018,Norman Powell,SG,24,TOR,70,18,1062,150,374,0.401,53,186,0.285,97,188,0.516,32,39,0.821,14,105,119,89,37,16,66,111,385
2018,OG Anunoby,SF,20,TOR,74,62,1481,163,346,0.471,73,197,0.371,90,149,0.604,39,62,0.629,44,140,184,55,52,14,45,130,438
2018,Okaro White,PF,25,MIA,6,4,80,7,16,0.438,4,11,0.364,3,5,0.6,2,3,0.667,3,8,11,2,1,1,1,6,20
2018,Omari Johnson,PF,28,MEM,4,0,75,9,21,0.429,4,12,0.333,5,9,0.556,0,0,,4,7,11,7,2,0,3,6,22
2018,Ömer Aşık,C,31,TOT,18,0,182,9,22,0.409,0,0,,9,22,0.409,4,13,0.308,9,38,47,3,2,4,9,20,22
2018,Ömer Aşık,C,31,NOP,14,0,121,7,16,0.438,0,0,,7,16,0.438,4,12,0.333,7,30,37,2,1,2,5,14,18
2018,Ömer Aşık,C,31,CHI,4,0,61,2,6,0.333,0,0,,2,6,0.333,0,1,0,2,8,10,1,1,2,4,6,4
2018,Omri Casspi,SF,29,GSW,53,7,740,120,207,0.58,10,22,0.455,110,185,0.595,50,69,0.725,30,170,200,51,18,19,37,71,300
2018,Otto Porter Jr.,SF,24,WAS,77,77,2432,445,885,0.503,138,313,0.441,307,572,0.537,106,128,0.828,103,389,492,157,116,41,75,151,1134
2018,P.J. Tucker,PF,32,HOU,82,34,2281,172,441,0.39,115,310,0.371,57,131,0.435,43,60,0.717,93,364,457,77,78,26,74,205,502
2018,Pascal Siakam,PF,23,TOR,81,5,1679,253,498,0.508,29,132,0.22,224,366,0.612,54,87,0.621,79,285,364,159,62,42,67,166,589
2018,Pat Connaughton,SG,25,POR,82,5,1488,165,390,0.423,74,210,0.352,91,180,0.506,37,44,0.841,36,125,161,91,23,22,43,120,441
2018,Patrick Beverley,SG,29,LAC,11,11,334,48,119,0.403,24,60,0.4,24,59,0.407,14,17,0.824,16,29,45,32,19,5,25,34,134
2018,Patrick McCaw,SG,22,GSW,57,10,961,92,225,0.409,19,80,0.238,73,145,0.503,26,34,0.765,16,66,82,81,43,10,41,67,229
2018,Patrick Patterson,PF,28,OKC,82,3,1270,106,266,0.398,66,171,0.386,40,95,0.421,40,46,0.87,32,161,193,57,48,23,33,87,318
2018,Patty Mills,PG,29,SAS,82,36,2107,280,682,0.411,154,414,0.372,126,268,0.47,105,118,0.89,26,128,154,229,55,11,106,128,819
2018,Pau Gasol,C,37,SAS,77,63,1812,287,627,0.458,43,120,0.358,244,507,0.481,158,209,0.756,129,490,619,238,24,79,108,121,775
2018,Paul George,SF,27,OKC,79,79,2891,576,1340,0.43,244,609,0.401,332,731,0.454,338,411,0.822,72,375,447,263,161,39,212,233,1734
2018,Paul Millsap,PF,32,DEN,38,37,1143,202,435,0.464,39,113,0.345,163,322,0.506,112,161,0.696,65,180,245,105,39,44,73,99,555
2018,Paul Zipser,SF,23,CHI,54,12,824,81,234,0.346,37,110,0.336,44,124,0.355,19,25,0.76,13,118,131,46,20,15,43,86,218
2018,PJ Dozier,PG,21,OKC,2,0,3,1,2,0.5,0,0,,1,2,0.5,0,0,,0,1,1,0,0,0,1,1,2
2018,Quincy Acy,PF,27,BRK,70,8,1359,130,365,0.356,102,292,0.349,28,73,0.384,49,60,0.817,40,217,257,57,33,29,60,149,411
2018,Quincy Pondexter,SF,29,CHI,23,1,196,14,49,0.286,3,22,0.136,11,27,0.407,14,17,0.824,8,19,27,9,8,2,11,24,45
2018,Quinn Cook,PG,24,GSW,33,18,740,122,252,0.484,46,104,0.442,76,148,0.514,22,25,0.88,10,72,82,89,12,1,32,59,312
2018,R.J. Hunter,SG,24,HOU,5,1,45,7,20,0.35,3,14,0.214,4,6,0.667,2,2,1,0,5,5,3,3,0,2,7,19
2018,Rajon Rondo,PG,31,NOP,65,63,1705,231,494,0.468,50,150,0.333,181,344,0.526,25,46,0.543,31,232,263,533,70,10,151,119,537
2018,Ramon Sessions,PG,31,TOT,28,3,392,42,117,0.359,8,26,0.308,34,91,0.374,44,57,0.772,6,32,38,77,14,2,30,29,136
2018,Ramon Sessions,PG,31,NYK,13,3,167,17,53,0.321,2,11,0.182,15,42,0.357,12,15,0.8,1,17,18,27,7,1,15,14,48
2018,Ramon Sessions,PG,31,WAS,15,0,225,25,64,0.391,6,15,0.4,19,49,0.388,32,42,0.762,5,15,20,50,7,1,15,15,88
2018,Rashad Vaughn,SG,21,TOT,28,0,212,23,56,0.411,14,37,0.378,9,19,0.474,4,6,0.667,3,18,21,13,5,3,6,15,64
2018,Rashad Vaughn,SG,21,MIL,22,0,173,21,50,0.42,13,35,0.371,8,15,0.533,4,6,0.667,2,15,17,12,4,3,4,12,59
2018,Rashad Vaughn,SG,21,BRK,1,0,4,0,0,,0,0,,0,0,,0,0,,0,0,0,1,0,0,0,1,0
2018,Rashad Vaughn,SG,21,ORL,5,0,35,2,6,0.333,1,2,0.5,1,4,0.25,0,0,,1,3,4,0,1,0,2,2,5
2018,Raul Neto,PG,25,UTA,41,0,498,69,151,0.457,19,47,0.404,50,104,0.481,26,35,0.743,7,42,49,75,13,4,36,38,183
2018,Raymond Felton,PG,33,OKC,82,2,1365,224,552,0.406,81,230,0.352,143,322,0.444,36,44,0.818,25,131,156,203,49,16,76,91,565
2018,Reggie Bullock,SF,26,DET,62,52,1732,267,546,0.489,125,281,0.445,142,265,0.536,39,49,0.796,27,127,154,95,47,13,47,70,698
2018,Reggie Hearn,SG,26,DET,3,0,7,1,2,0.5,1,2,0.5,0,0,,0,0,,0,0,0,0,0,0,0,0,3
2018,Reggie Jackson,PG,27,DET,45,45,1201,246,577,0.426,52,169,0.308,194,408,0.475,112,134,0.836,29,96,125,238,27,4,99,87,656
2018,Richard Jefferson,SF,37,DEN,20,0,163,12,27,0.444,2,7,0.286,10,20,0.5,4,7,0.571,2,15,17,15,2,1,5,11,30
2018,Richaun Holmes,C,24,PHI,48,2,746,135,241,0.56,4,31,0.129,131,210,0.624,37,56,0.661,57,154,211,61,20,29,25,97,311
2018,Ricky Rubio,PG,27,UTA,77,77,2254,346,827,0.418,96,273,0.352,250,554,0.451,220,254,0.866,44,307,351,410,121,11,207,206,1008
2018,Robert Covington,SF,27,PHI,80,80,2532,345,836,0.413,203,550,0.369,142,286,0.497,116,136,0.853,55,378,433,156,137,72,126,238,1009
2018,Robin Lopez,C,29,CHI,64,64,1690,342,645,0.53,4,14,0.286,338,631,0.536,68,90,0.756,134,156,290,124,14,53,107,109,756
2018,Rodney Hood,SG,25,TOT,60,23,1616,322,751,0.429,127,333,0.381,195,418,0.467,111,129,0.86,22,143,165,95,45,12,70,105,882
2018,Rodney Hood,SG,25,UTA,39,12,1084,234,552,0.424,102,262,0.389,132,290,0.455,85,97,0.876,14,97,111,65,30,7,63,64,655
2018,Rodney Hood,SG,25,CLE,21,11,532,88,199,0.442,25,71,0.352,63,128,0.492,26,32,0.813,8,46,54,30,15,5,7,41,227
2018,Rodney McGruder,SG,26,MIA,18,2,299,36,73,0.493,15,35,0.429,21,38,0.553,4,8,0.5,11,22,33,17,8,3,4,21,91
2018,Rodney Purvis,SG,23,ORL,16,2,290,35,107,0.327,13,52,0.25,22,55,0.4,13,15,0.867,1,26,27,17,3,3,10,26,96
2018,Ron Baker,SG,24,NYK,29,1,385,20,59,0.339,11,33,0.333,9,26,0.346,20,26,0.769,5,25,30,47,26,6,18,33,71
2018,Rondae Hollis-Jefferson,SF,23,BRK,68,59,1920,342,724,0.472,13,54,0.241,329,670,0.491,249,316,0.788,101,358,459,167,65,48,121,145,946
2018,Royce O'Neale,SF,24,UTA,69,4,1150,120,284,0.423,42,118,0.356,78,166,0.47,61,76,0.803,25,211,236,95,36,16,55,105,343
2018,Rudy Gay,PF,31,SAS,57,6,1231,253,537,0.471,37,118,0.314,216,419,0.516,112,145,0.772,76,215,291,73,46,38,78,98,655
2018,Rudy Gobert,C,25,UTA,56,56,1816,276,444,0.622,0,0,,276,444,0.622,204,299,0.682,165,436,601,80,44,129,107,153,756
2018,Russell Westbrook,PG,29,OKC,80,80,2914,757,1687,0.449,97,326,0.298,660,1361,0.485,417,566,0.737,152,652,804,820,147,20,381,200,2028
2018,Ryan Anderson,PF,29,HOU,66,50,1725,207,480,0.431,131,339,0.386,76,141,0.539,72,93,0.774,94,237,331,60,24,21,42,126,617
2018,Ryan Arcidiacono,PG,23,CHI,24,0,304,17,41,0.415,9,31,0.29,8,10,0.8,5,6,0.833,1,24,25,35,13,0,13,18,48
2018,Salah Mejri,C,31,DAL,61,1,729,88,137,0.642,0,3,0,88,134,0.657,38,66,0.576,85,161,246,35,22,67,39,121,214
2018,Sam Dekker,PF,23,LAC,73,1,883,128,259,0.494,10,60,0.167,118,199,0.593,37,56,0.661,44,130,174,38,24,9,33,71,303
2018,Scotty Hopson,SG,28,DAL,1,0,8,0,1,0,0,0,,0,1,0,1,2,0.5,0,0,0,1,0,0,1,0,1
2018,Sean Kilpatrick,SG,28,TOT,52,1,640,110,294,0.374,46,144,0.319,64,150,0.427,64,72,0.889,5,82,87,46,13,5,38,33,330
2018,Sean Kilpatrick,SG,28,BRK,16,0,183,25,87,0.287,11,43,0.256,14,44,0.318,18,19,0.947,1,34,35,15,2,1,16,8,79
2018,Sean Kilpatrick,SG,28,MIL,23,0,205,31,82,0.378,13,46,0.283,18,36,0.5,18,19,0.947,1,24,25,15,5,1,9,15,93
2018,Sean Kilpatrick,SG,28,LAC,4,0,38,7,18,0.389,3,7,0.429,4,11,0.364,2,2,1,0,2,2,3,0,0,1,2,19
2018,Sean Kilpatrick,SG,28,CHI,9,1,214,47,107,0.439,19,48,0.396,28,59,0.475,26,32,0.813,3,22,25,13,6,3,12,8,139
2018,Semi Ojeleye,PF,23,BOS,73,0,1150,65,188,0.346,40,125,0.32,25,63,0.397,25,41,0.61,37,124,161,20,21,4,25,91,195
2018,Serge Ibaka,PF,28,TOR,76,76,2093,379,784,0.483,107,297,0.36,272,487,0.559,94,118,0.797,78,400,478,62,29,99,90,209,959
2018,Shabazz Muhammad,SF-SG,25,TOT,43,2,418,84,188,0.447,7,27,0.259,77,161,0.478,39,50,0.78,23,53,76,14,9,3,6,30,214
2018,Shabazz Muhammad,SF,25,MIN,32,2,301,47,121,0.388,4,19,0.211,43,102,0.422,22,31,0.71,15,30,45,7,5,2,5,23,120
2018,Shabazz Muhammad,SG,25,MIL,11,0,117,37,67,0.552,3,8,0.375,34,59,0.576,17,19,0.895,8,23,31,7,4,1,1,7,94
2018,Shabazz Napier,PG,26,POR,74,10,1535,223,531,0.42,82,218,0.376,141,313,0.45,116,138,0.841,26,144,170,150,81,14,90,84,644
2018,Shane Larkin,PG,25,BOS,54,2,775,84,219,0.384,31,86,0.36,53,133,0.398,32,37,0.865,15,77,92,98,29,2,33,58,231
2018,Shaquille Harrison,PG,24,PHO,23,2,384,59,124,0.476,6,26,0.231,53,98,0.541,28,38,0.737,9,52,61,55,26,7,22,42,152
2018,Shaun Livingston,PG,32,GSW,71,7,1129,172,343,0.501,0,5,0,172,338,0.509,50,61,0.82,32,99,131,140,35,21,58,117,394
2018,Shelvin Mack,PG,27,ORL,69,3,1365,178,414,0.43,48,139,0.345,130,275,0.473,69,97,0.711,23,143,166,272,54,8,89,91,473
2018,Sindarius Thornwell,SG,23,LAC,73,17,1156,100,233,0.429,23,61,0.377,77,172,0.448,59,88,0.67,33,107,140,68,48,25,53,125,282
2018,Skal Labissière,PF,21,SAC,60,28,1240,205,458,0.448,18,51,0.353,187,407,0.459,95,118,0.805,99,189,288,72,25,49,73,132,523
2018,Solomon Hill,SF,26,NOP,12,1,187,11,41,0.268,4,21,0.19,7,20,0.35,3,6,0.5,9,27,36,22,7,1,9,22,29
2018,Spencer Dinwiddie,PG,24,BRK,80,58,2306,324,838,0.387,141,433,0.326,183,405,0.452,218,268,0.813,40,219,259,524,68,23,128,186,1007
2018,Stanley Johnson,SF,21,DET,69,50,1894,210,560,0.375,67,234,0.286,143,326,0.439,112,145,0.772,33,219,252,112,95,14,77,169,599
2018,Stephen Curry,PG,29,GSW,51,51,1631,428,864,0.495,212,501,0.423,216,363,0.595,278,302,0.921,36,225,261,310,80,8,153,114,1346
2018,Sterling Brown,SG,22,MIL,54,4,776,82,205,0.4,32,91,0.352,50,114,0.439,21,24,0.875,27,116,143,25,31,13,25,80,217
2018,Steven Adams,C,24,OKC,76,76,2487,448,712,0.629,0,2,0,448,710,0.631,160,286,0.559,384,301,685,88,92,78,128,215,1056
2018,T.J. Leaf,PF,20,IND,53,0,459,64,136,0.471,18,42,0.429,46,94,0.489,10,16,0.625,29,53,82,9,5,4,10,45,156
2018,T.J. McConnell,PG,25,PHI,76,1,1706,210,421,0.499,27,62,0.435,183,359,0.51,31,39,0.795,37,189,226,303,92,13,112,122,478
2018,T.J. Warren,SF,24,PHO,65,65,2142,529,1063,0.498,20,90,0.222,509,973,0.523,193,255,0.757,125,208,333,85,65,41,85,149,1271
2018,Taj Gibson,PF,32,MIN,82,82,2726,425,737,0.577,7,35,0.2,418,702,0.595,142,185,0.768,194,390,584,99,62,59,89,218,999
2018,Tarik Black,C,26,HOU,51,2,536,75,127,0.591,1,11,0.091,74,116,0.638,29,63,0.46,63,100,163,13,21,30,35,107,180
2018,Taurean Prince,SF,23,ATL,82,82,2464,415,975,0.426,176,457,0.385,239,518,0.461,152,180,0.844,50,339,389,214,85,42,191,168,1158
2018,Terrance Ferguson,SG,19,OKC,61,12,763,70,169,0.414,40,120,0.333,30,49,0.612,9,10,0.9,19,28,47,19,24,10,11,83,189
2018,Terrence Ross,SG,26,ORL,24,20,600,76,191,0.398,30,93,0.323,46,98,0.469,27,36,0.75,10,63,73,38,27,11,29,45,209
2018,Terry Rozier,PG,23,BOS,80,16,2068,316,800,0.395,153,402,0.381,163,398,0.41,115,149,0.772,63,313,376,232,80,19,80,123,900
2018,Thabo Sefolosha,SF,33,UTA,38,6,806,118,240,0.492,32,84,0.381,86,156,0.551,44,54,0.815,29,132,161,33,52,12,30,59,312
2018,Thaddeus Young,PF,29,IND,81,81,2607,421,864,0.487,58,181,0.32,363,683,0.531,55,92,0.598,184,328,512,152,135,36,105,175,955
2018,Thomas Bryant,C,20,LAL,15,0,72,8,21,0.381,1,10,0.1,7,11,0.636,5,9,0.556,3,14,17,6,1,2,2,6,22
2018,Thon Maker,C,20,MIL,74,12,1238,130,316,0.411,31,104,0.298,99,212,0.467,65,93,0.699,75,150,225,46,38,53,44,162,356
2018,Tim Frazier,PG,27,WAS,59,11,838,68,172,0.395,17,56,0.304,51,116,0.44,23,30,0.767,18,97,115,194,47,7,57,97,176
2018,Tim Hardaway Jr.,SG,25,NYK,57,54,1885,360,856,0.421,130,410,0.317,230,446,0.516,146,179,0.816,32,192,224,155,62,10,92,123,996
2018,Tim Quarterman,SG,23,HOU,3,0,13,1,3,0.333,0,2,0,1,1,1,2,2,1,0,3,3,1,0,0,2,1,4
2018,Timofey Mozgov,C,31,BRK,31,13,359,52,93,0.559,4,18,0.222,48,75,0.64,23,30,0.767,32,66,98,11,5,13,33,39,131
2018,Timothé Luwawu-Cabarrot,SF,22,PHI,52,7,807,100,267,0.375,53,158,0.335,47,109,0.431,46,58,0.793,14,58,72,54,12,5,38,97,299
2018,Tobias Harris,PF,25,TOT,80,80,2668,562,1221,0.46,183,445,0.411,379,776,0.488,179,216,0.829,58,379,437,192,71,35,105,164,1486
2018,Tobias Harris,PF,25,DET,48,48,1563,320,709,0.451,113,276,0.409,207,433,0.478,115,136,0.846,36,208,244,94,34,15,51,91,868
2018,Tobias Harris,PF,25,LAC,32,32,1105,242,512,0.473,70,169,0.414,172,343,0.501,64,80,0.8,22,171,193,98,37,20,54,73,618
2018,Tomáš Satoranský,SG,26,WAS,73,30,1643,201,384,0.523,47,101,0.465,154,283,0.544,75,96,0.781,72,161,233,286,52,15,83,131,524
2018,Tony Allen,SF,36,NOP,22,0,273,44,91,0.484,4,12,0.333,40,79,0.506,11,21,0.524,20,27,47,9,11,3,19,49,103
2018,Tony Bradley,C,20,UTA,9,0,29,3,11,0.273,0,1,0,3,10,0.3,2,2,1,4,7,11,1,0,0,0,1,8
2018,Tony Parker,PG,35,SAS,55,21,1071,178,388,0.459,10,37,0.27,168,351,0.479,55,78,0.705,7,88,95,195,28,1,68,52,421
2018,Tony Snell,SG,26,MIL,75,59,2053,185,425,0.435,108,268,0.403,77,157,0.49,38,48,0.792,9,132,141,98,47,28,36,115,516
2018,Torrey Craig,SF,27,DEN,39,5,629,62,137,0.453,17,58,0.293,45,79,0.57,22,35,0.629,40,87,127,25,12,15,20,63,163
2018,Travis Wear,SF,27,LAL,17,0,228,25,72,0.347,17,47,0.362,8,25,0.32,8,8,1,0,38,38,7,4,5,6,30,75
2018,Treveon Graham,SG,24,CHO,63,2,1050,96,221,0.434,40,97,0.412,56,124,0.452,41,59,0.695,42,79,121,59,33,2,27,109,273
2018,Trevor Ariza,SF,32,HOU,67,67,2269,268,651,0.412,170,462,0.368,98,189,0.519,76,89,0.854,33,261,294,105,98,13,52,132,782
2018,Trevor Booker,PF,30,TOT,68,7,1158,177,343,0.516,8,33,0.242,169,310,0.545,66,93,0.71,117,201,318,82,28,21,59,119,428
2018,Trevor Booker,PF,30,BRK,18,6,395,77,150,0.513,3,12,0.25,74,138,0.536,24,43,0.558,38,81,119,38,8,5,30,43,181
2018,Trevor Booker,PF,30,PHI,33,0,494,61,109,0.56,2,7,0.286,59,102,0.578,32,39,0.821,47,75,122,27,16,11,20,50,156
2018,Trevor Booker,PF,30,IND,17,1,269,39,84,0.464,3,14,0.214,36,70,0.514,10,11,0.909,32,45,77,17,4,5,9,26,91
2018,Trey Burke,PG,25,NYK,36,9,785,193,384,0.503,38,105,0.362,155,279,0.556,37,57,0.649,13,58,71,170,24,4,43,43,461
2018,Trey Lyles,PF,22,DEN,73,2,1391,270,550,0.491,83,218,0.381,187,332,0.563,101,143,0.706,55,292,347,91,30,34,61,111,724
2018,Trey McKinney-Jones,SG,27,IND,1,0,1,0,0,,0,0,,0,0,,0,0,,0,0,0,0,0,0,0,0,0
2018,Tristan Thompson,C,26,CLE,53,22,1072,132,235,0.562,0,0,,132,235,0.562,43,79,0.544,126,226,352,33,16,17,36,102,307
2018,Troy Daniels,SG,26,PHO,79,15,1622,232,575,0.403,183,458,0.4,49,117,0.419,56,64,0.875,12,115,127,48,26,5,56,137,703
2018,Troy Williams,SF,23,TOT,21,1,307,51,109,0.468,11,38,0.289,40,71,0.563,20,30,0.667,22,41,63,16,20,4,19,34,133
2018,Troy Williams,SF,23,HOU,4,0,17,2,9,0.222,0,5,0,2,4,0.5,1,3,0.333,1,3,4,1,1,0,1,2,5
2018,Troy Williams,SF,23,NYK,17,1,290,49,100,0.49,11,33,0.333,38,67,0.567,19,27,0.704,21,38,59,15,19,4,18,32,128
2018,Tyler Cavanaugh,PF,23,ATL,39,1,518,67,152,0.441,32,89,0.36,35,63,0.556,17,21,0.81,45,82,127,27,9,4,14,61,183
2018,Tyler Dorsey,SG,21,ATL,56,5,974,144,382,0.377,72,199,0.362,72,183,0.393,45,63,0.714,17,113,130,79,17,5,37,63,405
2018,Tyler Ennis,PG,23,LAL,54,11,683,94,224,0.42,14,56,0.25,80,168,0.476,22,29,0.759,19,76,95,105,30,10,38,75,224
2018,Tyler Johnson,PG,25,MIA,72,39,2052,309,711,0.435,119,324,0.367,190,387,0.491,106,129,0.822,34,214,248,165,60,34,81,148,843
2018,Tyler Lydon,PF,21,DEN,1,0,2,0,0,,0,0,,0,0,,0,0,,0,0,0,0,0,0,0,0,0
2018,Tyler Ulis,PG,22,PHO,71,43,1658,214,551,0.388,42,146,0.288,172,405,0.425,84,101,0.832,24,104,128,311,70,7,127,120,554
2018,Tyler Zeller,C,28,TOT,66,34,1109,187,334,0.56,10,28,0.357,177,306,0.578,57,79,0.722,110,195,305,47,15,35,47,126,441
2018,Tyler Zeller,C,28,BRK,42,33,703,125,229,0.546,10,26,0.385,115,203,0.567,40,60,0.667,63,131,194,28,8,21,35,78,300
2018,Tyler Zeller,C,28,MIL,24,1,406,62,105,0.59,0,2,0,62,103,0.602,17,19,0.895,47,64,111,19,7,14,12,48,141
2018,Tyreke Evans,PG,28,MEM,52,32,1607,366,809,0.452,114,286,0.399,252,523,0.482,164,209,0.785,44,221,265,269,57,17,117,96,1010
2018,Tyrone Wallace,PG,23,LAC,30,19,851,110,247,0.445,10,40,0.25,100,207,0.483,61,78,0.782,21,84,105,71,27,13,46,83,291
2018,Tyson Chandler,C,35,PHO,46,46,1151,121,187,0.647,0,0,,121,187,0.647,58,93,0.624,134,284,418,53,16,27,59,106,300
2018,Tyus Jones,PG,21,MIN,82,11,1467,150,328,0.457,45,129,0.349,105,199,0.528,71,81,0.877,16,116,132,232,95,6,59,110,416
2018,Udonis Haslem,C,37,MIA,14,0,72,3,15,0.2,1,8,0.125,2,7,0.286,1,2,0.5,3,7,10,5,0,2,2,3,8
2018,Vander Blue,SG,25,LAL,5,0,45,1,5,0.2,0,2,0,1,3,0.333,1,2,0.5,0,1,1,3,1,0,3,2,3
2018,Victor Oladipo,SG,25,IND,75,75,2552,640,1342,0.477,161,434,0.371,479,908,0.528,294,368,0.799,47,343,390,323,177,57,219,175,1735
2018,Vince Carter,SF,41,SAC,58,5,1026,114,283,0.403,57,165,0.345,57,118,0.483,28,37,0.757,18,130,148,69,42,26,36,96,313
2018,Vince Hunter,PF,23,MEM,4,0,7,3,5,0.6,0,0,,3,5,0.6,0,0,,2,1,3,0,0,1,1,0,6
2018,Wade Baldwin,PG,21,POR,7,0,80,14,21,0.667,4,5,0.8,10,16,0.625,6,10,0.6,1,7,8,5,2,1,4,12,38
2018,Walt Lemon Jr.,PG,25,NOP,5,0,35,7,16,0.438,1,1,1,6,15,0.4,2,3,0.667,0,2,2,5,0,1,4,5,17
2018,Wayne Ellington,SG,30,MIA,77,2,2041,285,700,0.407,227,579,0.392,58,121,0.479,67,78,0.859,23,195,218,79,53,8,52,94,864
2018,Wayne Selden,SG,23,MEM,35,9,692,116,269,0.431,49,122,0.402,67,147,0.456,44,59,0.746,16,40,56,66,18,5,54,59,325
2018,Wes Iwundu,SF,23,ORL,62,12,1020,93,218,0.427,9,46,0.196,84,172,0.488,34,47,0.723,36,101,137,57,33,12,30,81,229
2018,Wesley Johnson,SF,30,LAC,74,40,1486,150,368,0.408,60,177,0.339,90,191,0.471,43,58,0.741,29,187,216,61,76,62,55,146,403
2018,Wesley Matthews,SF,31,DAL,63,62,2131,283,697,0.406,153,402,0.381,130,295,0.441,83,101,0.822,28,170,198,172,76,16,83,140,802
2018,Will Barton,SG,27,DEN,81,40,2683,465,1028,0.452,156,422,0.37,309,606,0.51,182,226,0.805,70,339,409,331,82,52,149,168,1268
2018,Willie Cauley-Stein,C,24,SAC,73,58,2044,388,773,0.502,3,12,0.25,385,761,0.506,153,247,0.619,131,379,510,172,77,67,109,185,932
2018,Willie Reed,C,27,TOT,42,5,428,81,121,0.669,1,2,0.5,80,119,0.672,32,55,0.582,35,86,121,10,9,22,19,56,195
2018,Willie Reed,C,27,LAC,39,5,419,80,120,0.667,1,2,0.5,79,118,0.669,32,55,0.582,35,85,120,9,9,22,19,53,193
2018,Willie Reed,C,27,DET,3,0,9,1,1,1,0,0,,1,1,1,0,0,,0,1,1,1,0,0,0,3,2
2018,Willy Hernangómez,C,23,TOT,48,1,495,91,164,0.555,5,12,0.417,86,152,0.566,59,90,0.656,61,122,183,33,18,16,35,64,246
2018,Willy Hernangómez,C,23,NYK,26,0,233,49,81,0.605,1,5,0.2,48,76,0.632,12,28,0.429,22,45,67,21,8,7,26,32,111
2018,Willy Hernangómez,C,23,CHO,22,1,262,42,83,0.506,4,7,0.571,38,76,0.5,47,62,0.758,39,77,116,12,10,9,9,32,135
2018,Wilson Chandler,SF,30,DEN,74,71,2346,281,631,0.445,88,246,0.358,193,385,0.501,88,114,0.772,102,296,398,159,43,39,92,156,738
2018,Xavier Munford,SG,25,MIL,6,0,21,1,6,0.167,0,2,0,1,4,0.25,1,2,0.5,1,0,1,4,1,0,2,4,3
2018,Xavier Rathan-Mayes,SG,23,MEM,5,0,118,12,42,0.286,1,14,0.071,11,28,0.393,4,9,0.444,0,5,5,18,6,3,11,18,29
2018,Xavier Silas,SG,30,BOS,2,0,7,0,3,0,0,2,0,0,1,0,0,0,,1,1,2,0,1,0,0,1,0
2018,Yogi Ferrell,SG,24,DAL,82,21,2282,311,730,0.426,134,359,0.373,177,371,0.477,82,103,0.796,26,223,249,201,64,9,78,153,838
2018,Zach Collins,C,20,POR,66,1,1045,115,289,0.398,35,113,0.31,80,176,0.455,27,42,0.643,45,176,221,52,17,31,58,133,292
2018,Zach LaVine,SG,22,CHI,24,24,656,136,355,0.383,42,123,0.341,94,232,0.405,87,107,0.813,9,85,94,72,24,4,43,55,401
2018,Zach Randolph,PF,36,SAC,59,57,1508,361,763,0.473,51,147,0.347,310,616,0.503,84,107,0.785,97,300,397,127,42,10,116,119,857
2018,Zaza Pachulia,C,33,GSW,69,57,972,149,264,0.564,0,1,0,149,263,0.567,75,93,0.806,89,232,321,109,38,17,72,122,373
2018,Zhou Qi,C,22,HOU,18,0,124,6,32,0.188,2,19,0.105,4,13,0.308,8,12,0.667,6,16,22,2,2,14,10,14,22
2019,Aaron Gordon,PF,23,ORL,78,78,2633,470,1046,0.449,121,347,0.349,349,699,0.499,185,253,0.731,129,445,574,289,57,56,162,172,1246
2019,Aaron Holiday,PG,22,IND,50,0,646,105,262,0.401,43,127,0.339,62,135,0.459,41,50,0.82,5,62,67,87,21,13,40,71,294
2019,Abdel Nader,SF,25,OKC,61,1,694,91,215,0.423,32,100,0.32,59,115,0.513,27,36,0.75,14,102,116,20,20,12,26,68,241
2019,Al Horford,C,32,BOS,68,68,1973,387,723,0.535,73,203,0.36,314,520,0.604,78,95,0.821,120,338,458,283,59,86,102,126,925
2019,Al-Farouq Aminu,PF,28,POR,81,81,2292,257,593,0.433,96,280,0.343,161,313,0.514,150,173,0.867,112,498,610,104,68,33,72,143,760
2019,Alan Williams,PF,26,BRK,5,0,26,8,13,0.615,0,1,0,8,12,0.667,2,4,0.5,4,15,19,3,1,0,1,2,18
2019,Alec Burks,SG,27,TOT,64,24,1375,192,474,0.405,61,168,0.363,131,306,0.428,116,141,0.823,30,205,235,128,39,21,65,91,561
2019,Alec Burks,SG,27,UTA,17,0,269,47,114,0.412,16,43,0.372,31,71,0.437,33,38,0.868,2,25,27,20,6,4,15,22,143
2019,Alec Burks,SG,27,CLE,34,24,979,136,340,0.4,45,119,0.378,91,221,0.412,79,98,0.806,26,160,186,98,25,16,46,62,396
2019,Alec Burks,SG,27,SAC,13,0,127,9,20,0.45,0,6,0,9,14,0.643,4,5,0.8,2,20,22,10,8,1,4,7,22
2019,Álex Abrines,SG,25,OKC,31,2,588,56,157,0.357,41,127,0.323,15,30,0.5,12,13,0.923,5,43,48,20,17,6,14,53,165
2019,Alex Caruso,PG,24,LAL,25,4,531,77,173,0.445,24,50,0.48,53,123,0.431,51,64,0.797,20,47,67,77,24,9,42,54,229
2019,Alex Len,C,25,ATL,77,31,1544,320,648,0.494,74,204,0.363,246,444,0.554,140,216,0.648,158,266,424,86,27,69,97,200,854
2019,Alex Poythress,PF,25,ATL,21,1,305,40,81,0.494,9,23,0.391,31,58,0.534,18,29,0.621,29,47,76,17,4,10,13,47,107
2019,Alfonzo McKinnie,SF,26,GSW,72,5,1003,134,275,0.487,42,118,0.356,92,157,0.586,27,48,0.563,81,166,247,31,18,15,30,134,337
2019,Alize Johnson,PF,22,IND,14,0,64,4,16,0.25,1,2,0.5,3,14,0.214,4,8,0.5,4,15,19,1,1,3,0,7,13
2019,Allen Crabbe,SG,26,BRK,43,20,1133,137,373,0.367,98,259,0.378,39,114,0.342,41,56,0.732,16,132,148,46,23,13,46,102,413
2019,Allonzo Trier,SG,23,NYK,64,3,1459,232,518,0.448,52,132,0.394,180,386,0.466,179,223,0.803,31,166,197,119,28,14,116,117,695
2019,Amile Jefferson,PF,25,ORL,12,0,68,10,16,0.625,0,0,,10,16,0.625,7,8,0.875,6,15,21,3,3,3,1,8,27
2019,Amir Johnson,C,31,PHI,51,6,529,79,157,0.503,12,40,0.3,67,117,0.573,31,41,0.756,47,100,147,60,16,13,45,99,201
2019,Andre Drummond,C,25,DET,79,79,2647,561,1052,0.533,5,38,0.132,556,1014,0.548,243,412,0.59,423,809,1232,112,136,138,175,272,1370
2019,Andre Iguodala,SF,35,GSW,68,13,1578,151,302,0.5,48,144,0.333,103,158,0.652,39,67,0.582,48,204,252,216,61,51,52,95,389
2019,Andre Ingram,SG,33,LAL,4,0,15,0,6,0,0,3,0,0,3,0,0,0,,1,1,2,0,1,0,1,0,0
2019,Andrew Bogut,C,34,GSW,11,5,134,18,36,0.5,0,0,,18,36,0.5,3,3,1,12,43,55,11,3,8,8,22,39
2019,Andrew Harrison,PG,24,TOT,17,0,187,16,53,0.302,5,25,0.2,11,28,0.393,17,18,0.944,6,14,20,24,4,2,12,34,54
2019,Andrew Harrison,PG,24,MEM,1,0,5,1,2,0.5,0,1,0,1,1,1,0,0,,0,0,0,0,0,0,0,1,2
2019,Andrew Harrison,PG,24,CLE,10,0,144,12,39,0.308,3,14,0.214,9,25,0.36,16,16,1,4,11,15,17,4,2,10,26,43
2019,Andrew Harrison,PG,24,NOP,6,0,38,3,12,0.25,2,10,0.2,1,2,0.5,1,2,0.5,2,3,5,7,0,0,2,7,9
2019,Andrew Wiggins,SF,23,MIN,73,73,2543,498,1209,0.412,118,348,0.339,380,861,0.441,207,296,0.699,83,269,352,184,70,48,138,153,1321
2019,Anfernee Simons,SG,19,POR,20,1,141,28,63,0.444,10,29,0.345,18,34,0.529,9,16,0.563,3,10,13,13,1,0,11,9,75
2019,Ángel Delgado,C,24,LAC,2,0,15,1,5,0.2,0,0,,1,5,0.2,1,2,0.5,2,2,4,0,1,0,0,2,3
2019,Ante Žižić,C,22,CLE,59,25,1082,183,331,0.553,0,0,,183,331,0.553,93,132,0.705,108,212,320,53,13,22,61,113,459
2019,Anthony Davis,C,25,NOP,56,56,1850,530,1026,0.517,48,145,0.331,482,881,0.547,344,433,0.794,174,498,672,218,88,135,112,132,1452
2019,Anthony Tolliver,PF,33,MIN,65,0,1079,99,259,0.382,81,215,0.377,18,44,0.409,47,60,0.783,15,162,177,46,17,21,36,91,326
2019,Antonio Blakeney,SG,22,CHI,57,3,829,166,396,0.419,36,91,0.396,130,305,0.426,50,76,0.658,7,99,106,42,12,9,35,41,418
2019,Aron Baynes,C,32,BOS,51,18,821,105,223,0.471,21,61,0.344,84,162,0.519,53,62,0.855,88,152,240,57,12,34,40,125,284
2019,Austin Rivers,SG,26,TOT,76,15,2028,232,572,0.406,104,327,0.318,128,245,0.522,50,95,0.526,25,137,162,167,47,23,68,207,618
2019,Austin Rivers,SG,26,WAS,29,2,683,76,194,0.392,33,106,0.311,43,88,0.489,25,46,0.543,10,61,71,58,18,10,36,72,210
2019,Austin Rivers,SG,26,HOU,47,13,1345,156,378,0.413,71,221,0.321,85,157,0.541,25,49,0.51,15,76,91,109,29,13,32,135,408
2019,Avery Bradley,SG,28,TOT,63,63,1905,248,608,0.408,86,245,0.351,162,363,0.446,43,50,0.86,43,132,175,152,41,16,89,167,625
2019,Avery Bradley,SG,28,LAC,49,49,1463,161,420,0.383,58,172,0.337,103,248,0.415,20,25,0.8,35,96,131,96,27,16,61,133,400
2019,Avery Bradley,SG,28,MEM,14,14,442,87,188,0.463,28,73,0.384,59,115,0.513,23,25,0.92,8,36,44,56,14,0,28,34,225
2019,B.J. Johnson,SF,23,TOT,7,0,49,9,18,0.5,3,7,0.429,6,11,0.545,2,2,1,2,6,8,0,2,0,2,4,23
2019,B.J. Johnson,SF,23,ATL,6,0,43,8,16,0.5,3,6,0.5,5,10,0.5,2,2,1,2,6,8,0,2,0,2,3,21
2019,B.J. Johnson,SF,23,SAC,1,0,6,1,2,0.5,0,1,0,1,1,1,0,0,,0,0,0,0,0,0,0,1,2
2019,Bam Adebayo,C,21,MIA,82,28,1913,280,486,0.576,3,15,0.2,277,471,0.588,166,226,0.735,165,432,597,184,71,65,121,203,729
2019,Ben McLemore,SG,25,SAC,19,0,158,25,64,0.391,17,41,0.415,8,23,0.348,8,12,0.667,3,14,17,4,6,3,5,22,75
2019,Ben Simmons,PG,22,PHI,79,79,2700,540,960,0.563,0,6,0,540,954,0.566,257,428,0.6,172,525,697,610,112,61,274,209,1337
2019,Billy Garrett,SG,24,NYK,4,0,63,11,27,0.407,0,8,0,11,19,0.579,4,4,1,0,3,3,7,1,1,2,3,26
2019,Bismack Biyombo,C,26,CHO,54,32,783,89,156,0.571,0,0,,89,156,0.571,58,91,0.637,81,166,247,33,11,41,34,103,236
2019,Blake Griffin,PF,29,DET,75,75,2622,619,1341,0.462,189,522,0.362,430,819,0.525,414,550,0.753,100,465,565,402,52,28,253,199,1841
2019,Boban Marjanović,C,30,TOT,58,12,681,160,260,0.615,4,10,0.4,156,250,0.624,98,131,0.748,87,178,265,54,16,27,59,90,422
2019,Boban Marjanović,C,30,LAC,36,9,376,85,140,0.607,0,2,0,85,138,0.616,72,95,0.758,55,97,152,22,11,17,37,57,242
2019,Boban Marjanović,C,30,PHI,22,3,305,75,120,0.625,4,8,0.5,71,112,0.634,26,36,0.722,32,81,113,32,5,10,22,33,180
2019,Bobby Portis,PF,23,TOT,50,28,1299,279,628,0.444,75,191,0.393,204,437,0.467,77,97,0.794,109,294,403,72,35,20,74,145,710
2019,Bobby Portis,PF,23,CHI,22,6,531,122,271,0.45,27,72,0.375,95,199,0.477,39,50,0.78,46,115,161,29,11,8,29,61,310
2019,Bobby Portis,PF,23,WAS,28,22,768,157,357,0.44,48,119,0.403,109,238,0.458,38,47,0.809,63,179,242,43,24,12,45,84,400
2019,Bogdan Bogdanović,SG,26,SAC,70,17,1947,361,863,0.418,134,372,0.36,227,491,0.462,134,162,0.827,40,203,243,267,72,15,117,142,990
2019,Bojan Bogdanović,SF,29,IND,81,81,2573,522,1051,0.497,164,386,0.425,358,665,0.538,246,305,0.807,33,300,333,161,69,1,134,138,1454
2019,Bonzie Colson,SF,23,MIL,8,2,98,13,39,0.333,5,21,0.238,8,18,0.444,8,9,0.889,8,22,30,3,5,1,3,3,39
2019,Brad Wanamaker,PG,29,BOS,36,0,343,50,105,0.476,16,39,0.41,34,66,0.515,24,28,0.857,3,38,41,56,12,2,19,34,140
2019,Bradley Beal,SG,25,WAS,82,82,3028,764,1609,0.475,209,596,0.351,555,1013,0.548,362,448,0.808,89,322,411,448,121,58,224,226,2099
2019,Brandon Goodwin,PG,23,DEN,16,0,57,6,23,0.261,2,6,0.333,4,17,0.235,9,11,0.818,1,2,3,14,0,0,3,7,23
2019,Brandon Ingram,SF,21,LAL,52,52,1760,362,729,0.497,31,94,0.33,331,635,0.521,195,289,0.675,41,226,267,154,28,31,129,149,950
2019,Brandon Knight,PG,27,TOT,39,26,736,99,260,0.381,41,129,0.318,58,131,0.443,27,34,0.794,10,49,59,71,21,2,30,62,266
2019,Brandon Knight,PG,27,HOU,12,0,118,11,47,0.234,5,32,0.156,6,15,0.4,9,11,0.818,1,8,9,9,2,0,5,14,36
2019,Brandon Knight,PG,27,CLE,27,26,618,88,213,0.413,36,97,0.371,52,116,0.448,18,23,0.783,9,41,50,62,19,2,25,48,230
2019,Brandon Sampson,SG,21,CHI,14,2,214,28,60,0.467,11,29,0.379,17,31,0.548,4,6,0.667,3,13,16,10,8,3,12,19,71
2019,Brook Lopez,C,30,MIL,81,81,2322,355,786,0.452,187,512,0.365,168,274,0.613,112,133,0.842,33,363,396,98,51,179,82,189,1009
2019,Bruce Brown,SG,22,DET,74,56,1449,125,314,0.398,24,93,0.258,101,221,0.457,45,60,0.75,48,137,185,91,40,36,46,178,319
2019,Bruno Caboclo,PF,23,MEM,34,19,800,96,225,0.427,48,130,0.369,48,95,0.505,42,50,0.84,42,116,158,50,14,33,38,81,282
2019,Bryn Forbes,SG,25,SAS,82,81,2293,361,791,0.456,176,413,0.426,185,378,0.489,69,78,0.885,18,221,239,175,45,4,80,159,967
2019,Buddy Hield,SG,26,SAC,82,82,2615,623,1360,0.458,278,651,0.427,345,709,0.487,171,193,0.886,106,306,412,205,58,33,146,202,1695
2019,C.J. Miles,SF,31,TOT,53,1,856,112,311,0.36,67,203,0.33,45,108,0.417,48,58,0.828,13,82,95,36,26,15,30,79,339
2019,C.J. Miles,SF,31,TOR,40,1,562,70,206,0.34,43,137,0.314,27,69,0.391,35,44,0.795,12,56,68,22,18,10,21,62,218
2019,C.J. Miles,SF,31,MEM,13,0,294,42,105,0.4,24,66,0.364,18,39,0.462,13,14,0.929,1,26,27,14,8,5,9,17,121
2019,C.J. Williams,SG,28,MIN,15,0,128,17,35,0.486,5,16,0.313,12,19,0.632,0,1,0,1,7,8,12,6,0,5,16,39
2019,Caleb Swanigan,PF,21,TOT,21,0,178,18,53,0.34,1,7,0.143,17,46,0.37,6,9,0.667,17,47,64,11,6,1,18,28,43
2019,Caleb Swanigan,PF,21,POR,18,0,145,14,44,0.318,1,5,0.2,13,39,0.333,6,7,0.857,13,39,52,7,4,0,16,22,35
2019,Caleb Swanigan,PF,21,SAC,3,0,33,4,9,0.444,0,2,0,4,7,0.571,0,2,0,4,8,12,4,2,1,2,6,8
2019,Cameron Payne,PG,24,TOT,40,13,712,96,223,0.43,25,84,0.298,71,139,0.511,33,41,0.805,13,59,72,106,28,9,45,64,250
2019,Cameron Payne,PG,24,CHI,31,12,536,69,168,0.411,16,59,0.271,53,109,0.486,22,25,0.88,10,43,53,83,20,6,34,49,176
2019,Cameron Payne,PG,24,CLE,9,1,176,27,55,0.491,9,25,0.36,18,30,0.6,11,16,0.688,3,16,19,23,8,3,11,15,74
2019,Cameron Reynolds,SG,23,MIN,19,0,259,33,78,0.423,21,51,0.412,12,27,0.444,8,9,0.889,4,27,31,13,6,2,5,26,95
2019,Caris LeVert,SF,24,BRK,40,25,1063,207,483,0.429,48,154,0.312,159,329,0.483,85,123,0.691,35,116,151,156,42,14,69,77,547
2019,Carmelo Anthony,PF,34,HOU,10,2,294,49,121,0.405,21,64,0.328,28,57,0.491,15,22,0.682,9,45,54,5,4,7,8,32,134
2019,Cedi Osman,SF,23,CLE,76,75,2444,360,844,0.427,130,374,0.348,230,470,0.489,141,181,0.779,45,312,357,195,60,11,114,195,991
2019,Chandler Hutchison,SF,22,CHI,44,14,895,96,209,0.459,14,50,0.28,82,159,0.516,23,38,0.605,31,154,185,34,23,6,25,59,229
2019,Chandler Parsons,SF,30,MEM,25,3,496,68,182,0.374,29,94,0.309,39,88,0.443,22,25,0.88,4,66,70,43,19,5,32,45,187
2019,Channing Frye,C,35,CLE,36,6,341,43,117,0.368,32,79,0.405,11,38,0.289,11,14,0.786,4,48,52,20,6,5,13,44,129
2019,Chasson Randle,PG,25,WAS,49,2,743,91,217,0.419,46,115,0.4,45,102,0.441,43,62,0.694,10,46,56,97,25,3,43,91,271
2019,Cheick Diallo,PF,22,NOP,64,1,896,168,271,0.62,1,4,0.25,167,267,0.625,50,67,0.746,75,257,332,33,29,33,49,113,387
2019,Chimezie Metu,PF,21,SAS,29,0,145,19,58,0.328,0,2,0,19,56,0.339,13,17,0.765,9,27,36,13,6,2,15,14,51
2019,Chris Boucher,PF,26,TOR,28,0,163,34,76,0.447,12,37,0.324,22,39,0.564,13,15,0.867,16,40,56,2,6,24,7,31,93
2019,Chris Chiozza,PG,23,HOU,7,0,33,2,8,0.25,2,5,0.4,0,3,0,0,0,,1,3,4,4,1,1,1,2,6
2019,Chris Paul,PG,33,HOU,58,58,1857,302,720,0.419,127,355,0.358,175,365,0.479,175,203,0.862,36,229,265,473,114,18,152,146,906
2019,Christian Wood,PF,23,TOT,21,2,251,61,117,0.521,9,26,0.346,52,91,0.571,41,56,0.732,17,66,83,8,7,10,17,17,172
2019,Christian Wood,PF,23,MIL,13,0,62,12,25,0.48,3,5,0.6,9,20,0.45,10,15,0.667,4,16,20,2,0,0,3,3,37
2019,Christian Wood,PF,23,NOP,8,2,189,49,92,0.533,6,21,0.286,43,71,0.606,31,41,0.756,13,50,63,6,7,10,14,14,135
2019,CJ McCollum,SG,27,POR,70,70,2375,571,1243,0.459,167,445,0.375,404,798,0.506,159,192,0.828,62,220,282,207,55,28,106,172,1468
2019,Clint Capela,C,24,HOU,67,67,2249,474,732,0.648,0,0,,474,732,0.648,166,261,0.636,298,550,848,96,44,102,94,168,1114
2019,Cody Zeller,C,26,CHO,49,47,1243,190,345,0.551,6,22,0.273,184,323,0.57,111,141,0.787,110,223,333,102,38,41,62,164,497
2019,Collin Sexton,PG,20,CLE,82,72,2605,519,1206,0.43,119,296,0.402,400,910,0.44,214,255,0.839,57,179,236,243,44,6,185,186,1371
2019,Corey Brewer,SF,32,TOT,31,3,492,53,123,0.431,14,44,0.318,39,79,0.494,31,43,0.721,26,50,76,39,32,7,19,63,151
2019,Corey Brewer,SF,32,PHI,7,3,140,20,49,0.408,4,14,0.286,16,35,0.457,9,13,0.692,4,13,17,10,12,2,8,16,53
2019,Corey Brewer,SF,32,SAC,24,0,352,33,74,0.446,10,30,0.333,23,44,0.523,22,30,0.733,22,37,59,29,20,5,11,47,98
2019,Cory Joseph,PG,27,IND,82,9,2063,226,548,0.412,55,171,0.322,171,377,0.454,30,43,0.698,39,240,279,321,94,22,80,131,537
2019,Courtney Lee,SG,33,TOT,34,6,428,53,129,0.411,16,55,0.291,37,74,0.5,14,21,0.667,9,45,54,37,21,3,14,32,136
2019,Courtney Lee,SG,33,NYK,12,2,160,21,47,0.447,5,16,0.313,16,31,0.516,9,14,0.643,6,21,27,16,8,2,5,13,56
2019,Courtney Lee,SG,33,DAL,22,4,268,32,82,0.39,11,39,0.282,21,43,0.488,5,7,0.714,3,24,27,21,13,1,9,19,80
2019,Cristiano Felício,C,26,CHI,60,0,746,95,179,0.531,0,4,0,95,175,0.543,50,73,0.685,79,139,218,37,11,7,33,69,240
2019,D.J. Augustin,PG,31,ORL,81,81,2269,318,677,0.47,131,311,0.421,187,366,0.511,181,209,0.866,41,162,203,426,52,4,128,115,948
2019,D.J. Stephens,SG,28,MEM,1,0,7,1,2,0.5,0,0,,1,2,0.5,0,0,,0,0,0,0,1,0,1,0,2
2019,D.J. Wilson,PF,22,MIL,48,3,882,104,251,0.414,46,127,0.362,58,124,0.468,26,47,0.553,45,177,222,52,18,20,32,85,280
2019,D'Angelo Russell,PG,22,BRK,81,81,2448,659,1517,0.434,234,635,0.369,425,882,0.482,160,205,0.78,53,262,315,563,100,20,253,141,1712
2019,Dairis Bertāns,SG,29,NOP,12,0,167,12,47,0.255,10,34,0.294,2,13,0.154,0,0,,2,7,9,10,1,0,2,7,34
2019,Damian Jones,C,23,GSW,24,22,410,53,74,0.716,0,0,,53,74,0.716,24,37,0.649,31,44,75,28,12,25,16,63,130
2019,Damian Lillard,PG,28,POR,80,80,2838,681,1533,0.444,237,643,0.369,444,890,0.499,468,513,0.912,68,303,371,551,88,34,212,148,2067
2019,Damion Lee,SG,26,GSW,32,0,375,56,127,0.441,27,68,0.397,29,59,0.492,19,22,0.864,8,56,64,13,13,0,11,28,158
2019,Damyean Dotson,SG,24,NYK,73,40,2004,290,698,0.415,126,342,0.368,164,356,0.461,73,98,0.745,34,228,262,135,58,10,71,135,779
2019,Daniel Hamilton,SG,23,ATL,19,3,204,23,60,0.383,8,23,0.348,15,37,0.405,3,6,0.5,10,37,47,22,6,1,16,19,57
2019,Daniel Theis,C,26,BOS,66,2,908,146,266,0.549,26,67,0.388,120,199,0.603,56,76,0.737,87,138,225,68,21,42,33,161,374
2019,Danilo Gallinari,SF,30,LAC,68,68,2059,409,884,0.463,161,372,0.433,248,512,0.484,367,406,0.904,54,363,417,178,49,23,99,129,1346
2019,Danny Green,SG,31,TOR,80,80,2216,293,630,0.465,198,435,0.455,95,195,0.487,37,44,0.841,60,257,317,126,73,53,75,171,821
2019,Dante Cunningham,PF,31,SAS,64,21,928,75,158,0.475,30,65,0.462,45,93,0.484,14,18,0.778,48,140,188,50,27,13,22,71,194
2019,Dante Exum,PG,23,UTA,42,1,664,101,241,0.419,18,62,0.29,83,179,0.464,68,86,0.791,16,52,68,110,14,5,52,69,288
2019,Danuel House Jr.,SF,25,HOU,39,13,979,118,252,0.468,74,178,0.416,44,74,0.595,56,71,0.789,25,115,140,40,21,11,35,80,366
2019,Dario Šarić,PF,24,TOT,81,41,2023,304,696,0.437,118,323,0.365,186,373,0.499,132,150,0.88,126,331,457,127,45,9,97,182,858
2019,Dario Šarić,PF,24,PHI,13,13,396,48,132,0.364,21,70,0.3,27,62,0.435,27,30,0.9,21,65,86,26,4,3,25,39,144
2019,Dario Šarić,PF,24,MIN,68,28,1627,256,564,0.454,97,253,0.383,159,311,0.511,105,120,0.875,105,266,371,101,41,6,72,143,714
2019,Darius Miller,SF,28,NOP,69,15,1757,189,484,0.39,133,364,0.365,56,120,0.467,56,71,0.789,14,114,128,146,40,23,59,165,567
2019,Darren Collison,PG,31,IND,76,76,2143,308,659,0.467,79,194,0.407,229,465,0.492,158,190,0.832,36,196,232,459,110,9,125,138,853
2019,Daryl Macon,SG,23,DAL,8,0,90,10,27,0.37,5,11,0.455,5,16,0.313,4,7,0.571,2,10,12,7,1,0,6,8,29
2019,David Nwaba,SF,26,CLE,51,14,984,126,262,0.481,24,75,0.32,102,187,0.545,58,85,0.682,41,122,163,54,36,17,29,106,334
2019,Dāvis Bertāns,PF,26,SAS,76,12,1632,204,453,0.45,145,338,0.429,59,115,0.513,53,60,0.883,23,241,264,100,35,33,43,133,606
2019,Davon Reed,SG,23,IND,10,0,47,5,12,0.417,2,4,0.5,3,8,0.375,0,0,,2,4,6,3,1,0,1,3,12
2019,De'Aaron Fox,PG,21,SAC,81,81,2546,505,1102,0.458,86,232,0.371,419,870,0.482,303,417,0.727,43,261,304,590,133,45,227,204,1399
2019,De'Anthony Melton,PG,20,PHO,50,31,984,100,256,0.391,29,95,0.305,71,161,0.441,21,28,0.75,25,109,134,159,68,23,75,113,250
2019,Deandre Ayton,C,20,PHO,71,70,2183,509,870,0.585,0,4,0,509,866,0.588,141,189,0.746,223,506,729,125,61,67,126,209,1159
2019,DeAndre Jordan,C,30,TOT,69,69,2047,286,446,0.641,0,0,,286,446,0.641,186,264,0.705,225,677,902,156,42,73,153,167,758
2019,DeAndre Jordan,C,30,DAL,50,50,1554,208,323,0.644,0,0,,208,323,0.644,135,198,0.682,161,525,686,99,33,53,111,125,551
2019,DeAndre Jordan,C,30,NYK,19,19,493,78,123,0.634,0,0,,78,123,0.634,51,66,0.773,64,152,216,57,9,20,42,42,207
2019,DeAndre' Bembry,SG,24,ATL,82,15,1931,275,616,0.446,50,173,0.289,225,443,0.508,87,136,0.64,54,304,358,202,105,41,142,190,687
2019,Delon Wright,PG,26,TOT,75,13,1699,242,558,0.434,50,168,0.298,192,390,0.492,119,150,0.793,68,198,266,248,88,30,77,103,653
2019,Delon Wright,PG,26,TOR,49,2,897,127,293,0.433,30,90,0.333,97,203,0.478,53,61,0.869,39,86,125,110,46,15,37,53,337
2019,Delon Wright,PG,26,MEM,26,11,802,115,265,0.434,20,78,0.256,95,187,0.508,66,89,0.742,29,112,141,138,42,15,40,50,316
2019,DeMar DeRozan,SG,29,SAS,77,77,2688,631,1313,0.481,7,45,0.156,624,1268,0.492,366,441,0.83,54,408,462,475,86,36,199,177,1635
2019,DeMarcus Cousins,C,28,GSW,30,30,771,178,371,0.48,26,95,0.274,152,276,0.551,106,144,0.736,43,204,247,107,40,44,72,109,488
2019,DeMarre Carroll,PF,32,BRK,67,8,1703,227,575,0.395,106,310,0.342,121,265,0.457,184,242,0.76,68,281,349,85,31,10,73,114,744
2019,Demetrius Jackson,PG,24,PHI,6,0,39,8,15,0.533,2,6,0.333,6,9,0.667,4,4,1,2,1,3,5,2,0,1,4,22
2019,Deng Adel,SF,21,CLE,19,3,194,11,36,0.306,6,23,0.261,5,13,0.385,4,4,1,3,16,19,5,1,4,6,13,32
2019,Dennis Schröder,PG,25,OKC,79,14,2314,457,1104,0.414,124,364,0.341,333,740,0.45,186,227,0.819,38,246,284,323,65,12,172,189,1224
2019,Dennis Smith Jr.,PG,21,TOT,53,50,1508,278,650,0.428,67,208,0.322,211,442,0.477,99,156,0.635,32,123,155,252,67,20,154,129,722
2019,Dennis Smith Jr.,PG,21,DAL,32,32,908,157,357,0.44,43,125,0.344,114,232,0.491,57,82,0.695,18,79,97,138,40,11,100,82,414
2019,Dennis Smith Jr.,PG,21,NYK,21,18,600,121,293,0.413,24,83,0.289,97,210,0.462,42,74,0.568,14,44,58,114,27,9,54,47,308
2019,Deonte Burton,SG,25,OKC,32,0,240,33,82,0.402,8,27,0.296,25,55,0.455,8,12,0.667,4,24,28,9,6,8,9,31,82
2019,Derrick Favors,C,27,UTA,76,70,1766,363,619,0.586,17,78,0.218,346,541,0.64,154,228,0.675,207,353,560,89,56,106,84,163,897
2019,Derrick Jones Jr.,SF,21,MIA,60,14,1153,160,324,0.494,28,91,0.308,132,233,0.567,74,122,0.607,96,144,240,37,46,42,43,123,422
2019,Derrick Rose,PG,30,MIN,51,13,1392,363,753,0.482,54,146,0.37,309,607,0.509,137,160,0.856,33,107,140,220,31,12,82,57,917
2019,Derrick White,PG,24,SAS,67,55,1728,260,543,0.479,48,142,0.338,212,401,0.529,95,123,0.772,35,212,247,263,67,47,97,145,663
2019,DeVaughn Akoon-Purcell,SG,25,DEN,7,0,22,3,10,0.3,0,4,0,3,6,0.5,1,2,0.5,1,3,4,6,2,0,2,4,7
2019,Devin Booker,SG,22,PHO,64,64,2242,586,1255,0.467,135,414,0.326,451,841,0.536,393,454,0.866,39,226,265,433,56,13,264,200,1700
2019,Devin Harris,PG,35,DAL,68,2,1071,132,347,0.38,62,200,0.31,70,147,0.476,102,134,0.761,12,100,112,122,35,16,56,133,428
2019,Devin Robinson,SF,23,WAS,7,0,95,19,32,0.594,0,2,0,19,30,0.633,9,14,0.643,6,14,20,6,4,6,2,11,47
2019,Devonte' Graham,PG,23,CHO,46,3,676,74,216,0.343,34,121,0.281,40,95,0.421,35,46,0.761,10,53,63,121,23,2,30,48,217
2019,Dewayne Dedmon,C,29,ATL,64,52,1609,259,526,0.492,83,217,0.382,176,309,0.57,92,113,0.814,105,375,480,90,69,71,84,214,693
2019,Deyonta Davis,C,22,ATL,9,0,118,15,22,0.682,0,1,0,15,21,0.714,6,10,0.6,10,26,36,5,3,5,3,12,36
2019,Dillon Brooks,SF,23,MEM,18,0,330,49,122,0.402,15,40,0.375,34,82,0.415,22,30,0.733,9,22,31,16,10,4,19,50,135
2019,Dion Waiters,SG,27,MIA,44,28,1138,198,478,0.414,109,289,0.377,89,189,0.471,22,44,0.5,7,109,116,121,29,9,64,72,527
2019,Dirk Nowitzki,PF,40,DAL,51,20,795,135,376,0.359,64,205,0.312,71,171,0.415,39,50,0.78,5,153,158,35,9,18,18,76,373
2019,Domantas Sabonis,C,22,IND,74,5,1838,413,700,0.59,9,17,0.529,404,683,0.592,208,291,0.715,186,504,690,212,48,30,160,239,1043
2019,Donatas Motiejūnas,PF,28,SAS,3,0,13,3,6,0.5,0,0,,3,6,0.5,0,2,0,2,1,3,1,0,1,3,6,6
2019,Donovan Mitchell,SG,22,UTA,77,77,2598,661,1530,0.432,188,519,0.362,473,1011,0.468,319,396,0.806,59,257,316,322,106,31,218,208,1829
2019,Donte DiVincenzo,SG,22,MIL,27,0,411,50,124,0.403,22,83,0.265,28,41,0.683,9,12,0.75,16,49,65,31,13,6,19,38,131
2019,Donte Grantham,SF,23,OKC,3,0,2,0,2,0,0,2,0,0,0,,0,0,,0,0,0,0,0,0,0,0,0
2019,Dorian Finney-Smith,SF,25,DAL,81,26,1985,228,528,0.432,79,254,0.311,149,274,0.544,73,103,0.709,138,251,389,95,69,36,74,186,608
2019,Doug McDermott,SF,27,IND,77,1,1340,207,422,0.491,84,206,0.408,123,216,0.569,66,79,0.835,17,92,109,67,18,8,42,104,564
2019,Dragan Bender,PF,21,PHO,46,27,826,88,197,0.447,22,101,0.218,66,96,0.688,32,54,0.593,34,149,183,56,18,22,37,90,230
2019,Draymond Green,PF,28,GSW,66,66,2065,188,422,0.445,47,165,0.285,141,257,0.549,63,91,0.692,60,421,481,454,95,70,169,197,486
2019,Drew Eubanks,PF,21,SAS,23,0,113,15,26,0.577,0,0,,15,26,0.577,11,13,0.846,6,28,34,7,2,5,8,11,41
2019,Duncan Robinson,SF,24,MIA,15,1,161,18,46,0.391,10,35,0.286,8,11,0.727,4,6,0.667,2,17,19,5,5,0,4,11,50
2019,Dusty Hannahs,SG,25,MEM,2,0,26,3,12,0.25,0,5,0,3,7,0.429,2,2,1,0,1,1,5,1,0,1,1,8
2019,Dwayne Bacon,SG,23,CHO,43,13,759,122,257,0.475,38,87,0.437,84,170,0.494,34,46,0.739,8,81,89,47,12,5,18,72,316
2019,Dwight Howard,C,33,WAS,9,9,230,43,69,0.623,0,0,,43,69,0.623,29,48,0.604,24,59,83,4,7,4,16,34,115
2019,Dwight Powell,C,27,DAL,77,22,1662,290,486,0.597,39,127,0.307,251,359,0.699,196,254,0.772,140,271,411,112,44,50,67,201,815
2019,Dwyane Wade,SG,37,MIA,72,2,1885,416,960,0.433,86,261,0.33,330,699,0.472,165,233,0.708,69,216,285,301,59,38,166,118,1083
2019,Džanan Musa,SG,19,BRK,9,0,39,9,22,0.409,1,10,0.1,8,12,0.667,0,2,0,1,4,5,2,2,0,4,1,19
2019,E'Twaun Moore,SG,29,NOP,53,36,1463,256,532,0.481,76,176,0.432,180,356,0.506,45,59,0.763,35,92,127,102,40,8,59,112,633
2019,Ed Davis,C,29,BRK,81,1,1446,186,302,0.616,0,2,0,186,300,0.62,100,162,0.617,216,478,694,61,35,33,64,226,472
2019,Edmond Sumner,PG,23,IND,23,2,210,22,64,0.344,7,27,0.259,15,37,0.405,15,24,0.625,9,15,24,10,12,5,10,26,66
2019,Ekpe Udoh,C,31,UTA,51,1,320,50,72,0.694,0,0,,50,72,0.694,19,30,0.633,27,63,90,28,10,31,13,36,119
2019,Elfrid Payton,PG,24,NOP,42,42,1250,179,412,0.434,33,105,0.314,146,307,0.476,55,74,0.743,49,171,220,320,44,17,112,81,446
2019,Elie Okobo,PG,21,PHO,53,16,958,114,290,0.393,39,132,0.295,75,158,0.475,37,47,0.787,12,86,98,127,32,7,69,109,304
2019,Emanuel Terry,PF,22,TOT,3,0,23,4,7,0.571,0,0,,4,7,0.571,2,4,0.5,3,4,7,2,3,0,2,4,10
2019,Emanuel Terry,PF,22,PHO,2,0,20,4,6,0.667,0,0,,4,6,0.667,1,2,0.5,2,4,6,1,3,0,2,4,9
2019,Emanuel Terry,PF,22,MIA,1,0,3,0,1,0,0,0,,0,1,0,1,2,0.5,1,0,1,1,0,0,0,0,1
2019,Emmanuel Mudiay,PG,22,NYK,59,42,1607,330,740,0.446,69,210,0.329,261,530,0.492,144,186,0.774,33,163,196,228,43,19,140,103,873
2019,Enes Freedom,C,26,TOT,67,31,1640,375,683,0.549,10,34,0.294,365,649,0.562,155,197,0.787,257,402,659,116,32,26,118,167,915
2019,Enes Freedom,C,26,NYK,44,23,1128,251,468,0.536,7,22,0.318,244,446,0.547,105,129,0.814,171,290,461,84,18,17,79,106,614
2019,Enes Freedom,C,26,POR,23,8,512,124,215,0.577,3,12,0.25,121,203,0.596,50,68,0.735,86,112,198,32,14,9,39,61,301
2019,Eric Bledsoe,PG,29,MIL,78,78,2272,470,971,0.484,124,377,0.329,346,594,0.582,177,236,0.75,82,280,362,430,116,29,165,156,1241
2019,Eric Gordon,SG,30,HOU,68,53,2158,384,938,0.409,216,600,0.36,168,338,0.497,119,152,0.783,17,131,148,129,41,27,90,143,1103
2019,Eric Moreland,PF,27,TOT,5,0,43,3,7,0.429,1,1,1,2,6,0.333,0,0,,4,16,20,4,1,1,5,9,7
2019,Eric Moreland,PF,27,PHO,1,0,5,0,0,,0,0,,0,0,,0,0,,0,3,3,0,0,0,0,1,0
2019,Eric Moreland,PF,27,TOR,4,0,38,3,7,0.429,1,1,1,2,6,0.333,0,0,,4,13,17,4,1,1,5,8,7
2019,Ersan İlyasova,PF,31,MIL,67,7,1231,167,381,0.438,58,160,0.363,109,221,0.493,61,74,0.824,94,208,302,52,32,20,48,172,453
2019,Evan Fournier,SG,26,ORL,81,81,2553,468,1069,0.438,153,450,0.34,315,619,0.509,137,170,0.806,38,220,258,295,71,12,154,225,1226
2019,Evan Turner,PG,30,POR,73,2,1605,204,443,0.46,11,52,0.212,193,391,0.494,75,106,0.708,37,291,328,283,33,18,114,110,494
2019,Frank Jackson,PG,20,NOP,61,16,1169,194,447,0.434,53,169,0.314,141,278,0.507,54,73,0.74,25,109,134,69,25,2,48,92,495
2019,Frank Kaminsky,C,25,CHO,47,0,755,138,298,0.463,50,139,0.36,88,159,0.553,79,107,0.738,39,124,163,63,12,12,41,68,405
2019,Frank Mason III,PG,24,SAC,38,0,435,71,169,0.42,14,64,0.219,57,105,0.543,39,57,0.684,6,37,43,84,16,4,36,34,195
2019,Frank Ntilikina,PG,20,NYK,43,16,904,95,282,0.337,33,115,0.287,62,167,0.371,23,30,0.767,12,75,87,121,30,14,56,104,246
2019,Fred VanVleet,PG,24,TOR,64,28,1760,246,600,0.41,112,296,0.378,134,304,0.441,97,115,0.843,21,146,167,307,57,20,82,110,701
2019,Furkan Korkmaz,SG,21,PHI,48,7,679,98,245,0.4,47,144,0.326,51,101,0.505,36,44,0.818,16,91,107,52,29,2,25,62,279
2019,Garrett Temple,SG,32,TOT,75,55,2040,208,493,0.422,90,264,0.341,118,229,0.515,80,107,0.748,28,188,216,106,76,30,70,204,586
2019,Garrett Temple,SG,32,MEM,49,49,1530,166,387,0.429,74,210,0.352,92,177,0.52,57,76,0.75,18,134,152,69,50,25,54,134,463
2019,Garrett Temple,SG,32,LAC,26,6,510,42,106,0.396,16,54,0.296,26,52,0.5,23,31,0.742,10,54,64,37,26,5,16,70,123
2019,Gary Clark,PF,24,HOU,51,2,641,50,151,0.331,41,138,0.297,9,13,0.692,7,7,1,24,92,116,18,20,26,7,47,148
2019,Gary Harris,SG,24,DEN,57,48,1639,270,637,0.424,82,242,0.339,188,395,0.476,115,144,0.799,41,119,160,127,55,19,68,113,737
2019,Gary Payton II,PG,26,WAS,3,0,16,5,8,0.625,1,2,0.5,4,6,0.667,0,0,,1,1,2,4,3,1,1,2,11
2019,Gary Trent Jr.,SG,20,POR,15,1,111,16,50,0.32,5,21,0.238,11,29,0.379,3,7,0.429,1,10,11,5,1,2,4,4,40
2019,George Hill,PG,32,TOT,60,13,1302,170,376,0.452,48,153,0.314,122,223,0.547,70,85,0.824,39,109,148,135,52,8,51,102,458
2019,George Hill,PG,32,CLE,13,13,344,55,107,0.514,13,28,0.464,42,79,0.532,17,20,0.85,12,15,27,36,12,1,20,35,140
2019,George Hill,PG,32,MIL,47,0,958,115,269,0.428,35,125,0.28,80,144,0.556,53,65,0.815,27,94,121,99,40,7,31,67,318
2019,George King,SF,25,PHO,1,0,6,0,0,,0,0,,0,0,,0,0,,0,1,1,0,0,0,0,0,0
2019,Georges Niang,PF,25,UTA,59,0,516,86,181,0.475,43,105,0.41,43,76,0.566,20,24,0.833,11,76,87,35,10,6,23,57,235
2019,Gerald Green,SG,33,HOU,73,0,1473,231,578,0.4,156,441,0.354,75,137,0.547,57,68,0.838,30,152,182,40,33,27,55,126,675
2019,Giannis Antetokounmpo,PF,24,MIL,72,72,2358,721,1247,0.578,52,203,0.256,669,1044,0.641,500,686,0.729,159,739,898,424,92,110,268,232,1994
2019,Glenn Robinson III,SF,25,DET,47,18,610,74,176,0.42,18,62,0.29,56,114,0.491,32,40,0.8,17,54,71,21,14,8,18,45,198
2019,Goran Dragić,PG,32,MIA,36,22,991,179,433,0.413,57,164,0.348,122,269,0.454,79,101,0.782,20,91,111,174,30,5,71,81,494
2019,Gordon Hayward,PF,28,BOS,72,18,1863,296,635,0.466,77,231,0.333,219,404,0.542,156,187,0.834,51,271,322,244,62,23,105,104,825
2019,Gorgui Dieng,C,29,MIN,76,2,1031,189,377,0.501,19,56,0.339,170,321,0.53,88,106,0.83,81,230,311,72,48,41,57,134,485
2019,Grayson Allen,SG,23,UTA,38,2,416,67,178,0.376,32,99,0.323,35,79,0.443,45,60,0.75,3,20,23,25,6,6,33,47,211
2019,Greg Monroe,C,28,TOT,43,2,480,92,189,0.487,1,5,0.2,91,184,0.495,45,72,0.625,67,105,172,24,14,8,32,66,230
2019,Greg Monroe,C,28,TOR,38,2,423,74,161,0.46,0,4,0,74,157,0.471,35,61,0.574,60,96,156,16,13,8,31,61,183
2019,Greg Monroe,C,28,BOS,2,0,5,3,5,0.6,0,0,,3,5,0.6,0,0,,3,0,3,1,0,0,0,0,6
2019,Greg Monroe,C,28,PHI,3,0,52,15,23,0.652,1,1,1,14,22,0.636,10,11,0.909,4,9,13,7,1,0,1,5,41
2019,Guerschon Yabusele,PF,23,BOS,41,1,251,35,77,0.455,9,28,0.321,26,49,0.531,15,22,0.682,23,30,53,15,8,7,15,32,94
2019,Hamidou Diallo,SG,20,OKC,51,3,526,75,165,0.455,4,24,0.167,71,141,0.504,36,59,0.61,38,59,97,17,21,10,23,77,190
2019,Harrison Barnes,PF-SF,26,TOT,77,77,2533,431,1027,0.42,174,441,0.395,257,586,0.439,229,278,0.824,57,304,361,115,50,13,98,122,1265
2019,Harrison Barnes,PF,26,DAL,49,49,1584,290,717,0.404,121,311,0.389,169,406,0.416,165,198,0.833,36,171,207,62,33,11,68,79,866
2019,Harrison Barnes,SF,26,SAC,28,28,949,141,310,0.455,53,130,0.408,88,180,0.489,64,80,0.8,21,133,154,53,17,2,30,43,399
2019,Harry Giles,PF,20,SAC,58,0,820,175,348,0.503,0,6,0,175,342,0.512,58,91,0.637,66,156,222,85,31,22,73,150,408
2019,Hassan Whiteside,C,29,MIA,72,53,1674,388,680,0.571,2,16,0.125,386,664,0.581,109,243,0.449,257,560,817,56,46,136,97,192,887
2019,Haywood Highsmith,SF,22,PHI,5,0,40,4,10,0.4,1,5,0.2,3,5,0.6,0,2,0,0,5,5,2,1,0,1,1,9
2019,Henry Ellenson,PF,22,TOT,19,0,259,39,95,0.411,17,38,0.447,22,57,0.386,19,25,0.76,5,61,66,16,7,2,9,27,114
2019,Henry Ellenson,PF,22,DET,2,0,25,4,10,0.4,2,4,0.5,2,6,0.333,2,2,1,0,9,9,1,0,0,0,2,12
2019,Henry Ellenson,PF,22,NYK,17,0,234,35,85,0.412,15,34,0.441,20,51,0.392,17,23,0.739,5,52,57,15,7,2,9,25,102
2019,Ian Clark,SG,27,NOP,60,6,973,151,383,0.394,66,202,0.327,85,181,0.47,33,37,0.892,13,76,89,94,22,8,58,95,401
2019,Ian Mahinmi,C,32,WAS,34,6,498,47,104,0.452,3,16,0.188,44,88,0.5,42,61,0.689,48,80,128,25,25,16,21,84,139
2019,Ike Anigbogu,C,20,IND,3,0,6,0,3,0,0,0,,0,3,0,0,0,,1,2,3,1,0,1,1,0,0
2019,Iman Shumpert,SG,28,TOT,62,41,1481,167,446,0.374,95,273,0.348,72,173,0.416,36,45,0.8,27,156,183,112,59,24,50,127,465
2019,Iman Shumpert,SG,28,SAC,42,40,1099,133,348,0.382,74,202,0.366,59,146,0.404,34,41,0.829,19,110,129,91,47,20,38,92,374
2019,Iman Shumpert,SG,28,HOU,20,1,382,34,98,0.347,21,71,0.296,13,27,0.481,2,4,0.5,8,46,54,21,12,4,12,35,91
2019,Isaac Bonga,PG,19,LAL,22,0,120,5,33,0.152,0,8,0,5,25,0.2,9,15,0.6,9,16,25,15,9,4,6,9,19
2019,Isaac Humphries,C,21,ATL,5,1,56,6,21,0.286,3,11,0.273,3,10,0.3,0,0,,4,7,11,0,1,0,0,7,15
2019,Isaiah Briscoe,PG,22,ORL,39,0,559,55,138,0.399,11,34,0.324,44,104,0.423,15,26,0.577,5,69,74,87,11,2,31,66,136
2019,Isaiah Canaan,PG,27,TOT,30,16,629,64,164,0.39,34,96,0.354,30,68,0.441,19,24,0.792,6,52,58,84,14,2,35,52,181
2019,Isaiah Canaan,PG,27,PHO,19,15,503,51,129,0.395,25,72,0.347,26,57,0.456,15,20,0.75,5,44,49,62,12,0,29,46,142
2019,Isaiah Canaan,PG,27,MIN,7,1,95,11,29,0.379,7,19,0.368,4,10,0.4,4,4,1,0,5,5,19,2,1,4,4,33
2019,Isaiah Canaan,PG,27,MIL,4,0,31,2,6,0.333,2,5,0.4,0,1,0,0,0,,1,3,4,3,0,1,2,2,6
2019,Isaiah Hartenstein,PF,20,HOU,28,0,221,20,41,0.488,2,6,0.333,18,35,0.514,11,14,0.786,21,26,47,15,7,12,13,56,53
2019,Isaiah Hicks,PF,24,NYK,3,0,32,4,8,0.5,0,0,,4,8,0.5,4,5,0.8,2,5,7,2,1,3,1,5,12
2019,Isaiah Thomas,SG,29,DEN,12,0,181,34,99,0.343,12,43,0.279,22,56,0.393,17,27,0.63,5,8,13,23,5,1,18,17,97
2019,Ish Smith,PG,30,DET,56,0,1251,205,489,0.419,44,135,0.326,161,354,0.455,47,62,0.758,23,122,145,203,28,11,61,109,501
2019,Ivan Rabb,PF,21,MEM,49,13,721,116,212,0.547,3,15,0.2,113,197,0.574,49,69,0.71,70,136,206,54,17,14,35,90,284
2019,Ivica Zubac,C,21,TOT,59,37,1040,212,379,0.559,0,0,,212,379,0.559,101,126,0.802,115,247,362,63,14,51,70,137,525
2019,Ivica Zubac,C,21,LAL,33,12,516,112,193,0.58,0,0,,112,193,0.58,57,66,0.864,54,108,162,25,4,27,33,73,281
2019,Ivica Zubac,C,21,LAC,26,25,524,100,186,0.538,0,0,,100,186,0.538,44,60,0.733,61,139,200,38,10,24,37,64,244
2019,J.J. Barea,PG,34,DAL,38,0,752,161,385,0.418,38,128,0.297,123,257,0.479,55,78,0.705,13,82,95,211,22,1,72,50,415
2019,J.J. Redick,SG,34,PHI,76,63,2379,452,1027,0.44,240,605,0.397,212,422,0.502,228,255,0.894,20,166,186,206,32,17,101,129,1372
2019,J.P. Macura,SG,23,CHO,2,0,17,3,9,0.333,0,4,0,3,5,0.6,0,0,,0,3,3,2,0,0,0,0,6
2019,J.R. Smith,SG,33,CLE,11,4,222,27,79,0.342,12,39,0.308,15,40,0.375,8,10,0.8,0,18,18,21,11,3,11,19,74
2019,Jabari Parker,PF,23,TOT,64,17,1724,369,749,0.493,61,195,0.313,308,554,0.556,131,184,0.712,79,342,421,152,46,30,151,145,930
2019,Jabari Parker,PF,23,CHI,39,17,1042,220,464,0.474,37,114,0.325,183,350,0.523,79,108,0.731,41,200,241,84,23,14,84,87,556
2019,Jabari Parker,PF,23,WAS,25,0,682,149,285,0.523,24,81,0.296,125,204,0.613,52,76,0.684,38,142,180,68,23,16,67,58,374
2019,Jacob Evans,SG,21,GSW,30,1,204,18,53,0.34,4,15,0.267,14,38,0.368,0,1,0,6,19,25,23,5,3,11,28,40
2019,Jae Crowder,SF,28,UTA,80,11,2166,318,797,0.399,173,522,0.331,145,275,0.527,142,197,0.721,60,324,384,133,64,31,85,170,951
2019,Jahlil Okafor,C,23,NOP,59,24,935,212,362,0.586,1,5,0.2,211,357,0.591,59,89,0.663,82,196,278,40,15,40,52,96,484
2019,JaKarr Sampson,SF,25,CHI,4,0,127,29,54,0.537,5,14,0.357,24,40,0.6,17,21,0.81,5,27,32,4,4,3,4,8,80
2019,Jake Layman,SF,24,POR,71,33,1327,216,424,0.509,59,181,0.326,157,243,0.646,50,71,0.704,56,161,217,53,31,30,46,116,541
2019,Jakob Poeltl,C,23,SAS,77,24,1273,187,290,0.645,0,0,,187,290,0.645,49,92,0.533,178,232,410,93,29,68,48,124,423
2019,Jalen Brunson,PG,22,DAL,73,38,1591,264,565,0.467,63,181,0.348,201,384,0.523,87,120,0.725,25,144,169,230,37,4,88,127,678
2019,Jalen Jones,SF,25,CLE,16,0,214,26,62,0.419,10,28,0.357,16,34,0.471,19,27,0.704,11,23,34,7,9,2,8,27,81
2019,Jamal Crawford,SG,38,PHO,64,0,1211,174,438,0.397,67,202,0.332,107,236,0.453,93,110,0.845,8,77,85,229,33,12,99,75,508
2019,Jamal Murray,PG,21,DEN,75,74,2447,513,1173,0.437,152,414,0.367,361,759,0.476,189,223,0.848,65,252,317,363,67,27,158,153,1367
2019,James Ennis III,SF,28,TOT,58,27,1230,138,294,0.469,55,156,0.353,83,138,0.601,58,81,0.716,60,122,182,41,41,23,34,150,389
2019,James Ennis III,SF,28,HOU,40,25,949,104,211,0.493,44,120,0.367,60,91,0.659,42,58,0.724,37,80,117,27,38,16,23,111,294
2019,James Ennis III,SF,28,PHI,18,2,281,34,83,0.41,11,36,0.306,23,47,0.489,16,23,0.696,23,42,65,14,3,7,11,39,95
2019,James Harden,PG,29,HOU,78,78,2867,843,1909,0.442,378,1028,0.368,465,881,0.528,754,858,0.879,66,452,518,586,158,58,387,244,2818
2019,James Johnson,PF,31,MIA,55,33,1164,164,379,0.433,50,149,0.336,114,230,0.496,50,70,0.714,22,154,176,135,35,27,74,114,428
2019,James Nunnally,SF,28,TOT,15,0,102,12,34,0.353,8,25,0.32,4,9,0.444,4,4,1,0,5,5,7,1,0,1,10,36
2019,James Nunnally,SF,28,MIN,13,0,64,9,21,0.429,5,13,0.385,4,8,0.5,4,4,1,0,4,4,5,1,0,1,4,27
2019,James Nunnally,SF,28,HOU,2,0,38,3,13,0.231,3,12,0.25,0,1,0,0,0,,0,1,1,2,0,0,0,6,9
2019,JaMychal Green,PF,28,TOT,65,6,1371,230,476,0.483,71,176,0.403,159,300,0.53,80,101,0.792,104,305,409,50,45,34,87,193,611
2019,JaMychal Green,PF,28,MEM,41,4,900,151,312,0.484,38,96,0.396,113,216,0.523,63,80,0.788,72,180,252,36,33,26,64,123,403
2019,JaMychal Green,PF,28,LAC,24,2,471,79,164,0.482,33,80,0.413,46,84,0.548,17,21,0.81,32,125,157,14,12,8,23,70,208
2019,Jared Dudley,PF,33,BRK,59,25,1220,101,239,0.423,53,151,0.351,48,88,0.545,32,46,0.696,34,121,155,83,36,16,43,131,287
2019,Jared Terrell,SG,23,MIN,14,0,111,12,39,0.308,4,17,0.235,8,22,0.364,3,6,0.5,1,5,6,12,3,2,10,16,31
2019,Jarell Martin,PF,24,ORL,42,1,328,43,104,0.413,20,57,0.351,23,47,0.489,9,11,0.818,11,62,73,18,3,8,11,51,115
2019,Jaren Jackson Jr.,PF,19,MEM,58,56,1515,298,589,0.506,51,142,0.359,247,447,0.553,151,197,0.766,73,199,272,64,52,82,98,220,798
2019,Jaron Blossomgame,SF,25,CLE,27,4,439,47,106,0.443,10,39,0.256,37,67,0.552,10,13,0.769,26,72,98,13,7,8,11,20,114
2019,Jarred Vanderbilt,PF,19,DEN,17,0,69,9,19,0.474,0,1,0,9,18,0.5,6,10,0.6,7,16,23,3,6,1,8,8,24
2019,Jarrett Allen,C,20,BRK,80,80,2096,335,568,0.59,6,45,0.133,329,523,0.629,197,278,0.709,191,481,672,110,43,120,103,184,873
2019,Jason Smith,PF-C,32,TOT,20,1,190,21,59,0.356,9,26,0.346,12,33,0.364,14,16,0.875,16,36,52,14,3,7,13,30,65
2019,Jason Smith,C,32,WAS,12,1,130,15,37,0.405,4,10,0.4,11,27,0.407,10,12,0.833,11,26,37,12,1,5,7,21,44
2019,Jason Smith,PF,32,MIL,6,0,40,4,13,0.308,3,9,0.333,1,4,0.25,2,2,1,3,8,11,1,2,2,5,6,13
2019,Jason Smith,C,32,NOP,2,0,20,2,9,0.222,2,7,0.286,0,2,0,2,2,1,2,2,4,1,0,0,1,3,8
2019,JaVale McGee,C,31,LAL,75,62,1671,400,641,0.624,1,12,0.083,399,629,0.634,96,152,0.632,195,371,566,52,47,148,108,208,897
2019,Jawun Evans,PG,22,TOT,8,0,65,3,14,0.214,0,3,0,3,11,0.273,0,0,,1,11,12,10,3,0,6,8,6
2019,Jawun Evans,PG,22,PHO,7,0,64,3,13,0.231,0,2,0,3,11,0.273,0,0,,1,11,12,10,3,0,6,8,6
2019,Jawun Evans,PG,22,OKC,1,0,1,0,1,0,0,1,0,0,0,,0,0,,0,0,0,0,0,0,0,0,0
2019,Jaylen Adams,PG,22,ATL,34,1,428,38,110,0.345,25,74,0.338,13,36,0.361,7,9,0.778,11,49,60,65,14,5,28,45,108
2019,Jaylen Brown,SG,22,BOS,74,25,1913,368,792,0.465,95,276,0.344,273,516,0.529,133,202,0.658,65,248,313,100,69,32,99,186,964
2019,Jaylen Morris,SG,23,MIL,4,0,29,4,10,0.4,1,3,0.333,3,7,0.429,1,2,0.5,0,5,5,4,2,0,1,1,10
2019,Jayson Tatum,SF,20,BOS,79,79,2455,466,1036,0.45,116,311,0.373,350,725,0.483,195,228,0.855,70,407,477,168,84,57,122,168,1243
2019,Jeff Green,PF,32,WAS,77,44,2097,326,687,0.475,111,320,0.347,215,367,0.586,183,206,0.888,57,252,309,137,43,39,101,160,946
2019,Jeff Teague,PG,30,MIN,42,41,1264,176,416,0.423,35,105,0.333,141,311,0.453,123,153,0.804,16,90,106,343,43,18,97,90,510
2019,Jemerrio Jones,SF,23,LAL,6,2,143,12,33,0.364,2,10,0.2,10,23,0.435,1,2,0.5,16,33,49,13,7,5,5,10,27
2019,Jerami Grant,PF,24,OKC,80,77,2612,409,823,0.497,115,293,0.392,294,530,0.555,157,221,0.71,96,321,417,79,61,100,67,214,1090
2019,Jeremy Lamb,SG,26,CHO,79,55,2250,431,979,0.44,115,330,0.348,316,649,0.487,231,260,0.888,65,369,434,172,88,32,80,140,1208
2019,Jeremy Lin,PG,30,TOT,74,4,1436,238,541,0.44,55,187,0.294,183,354,0.517,176,210,0.838,22,157,179,231,47,13,124,144,707
2019,Jeremy Lin,PG,30,ATL,51,1,1003,180,386,0.466,44,132,0.333,136,254,0.535,142,168,0.845,16,103,119,181,38,7,98,96,546
2019,Jeremy Lin,PG,30,TOR,23,3,433,58,155,0.374,11,55,0.2,47,100,0.47,34,42,0.81,6,54,60,50,9,6,26,48,161
2019,Jerian Grant,PG,26,ORL,60,1,939,92,220,0.418,40,110,0.364,52,110,0.473,26,40,0.65,19,79,98,156,44,6,51,78,250
2019,Jerome Robinson,SG,21,LAC,33,0,320,44,110,0.4,18,57,0.316,26,53,0.491,6,9,0.667,3,38,41,19,11,3,13,46,112
2019,Jerryd Bayless,PG,30,MIN,34,6,657,82,230,0.357,29,98,0.296,53,132,0.402,16,28,0.571,11,51,62,119,18,2,32,56,209
2019,Jevon Carter,PG,23,MEM,39,3,577,56,185,0.303,34,102,0.333,22,83,0.265,26,32,0.813,14,52,66,69,26,11,33,55,172
2019,Jimmer Fredette,SG,29,PHO,6,0,65,8,29,0.276,0,13,0,8,16,0.5,6,6,1,1,6,7,8,3,0,5,5,22
2019,Jimmy Butler,SF-SG,29,TOT,65,65,2185,418,904,0.462,67,193,0.347,351,711,0.494,312,365,0.855,121,221,342,263,123,39,95,111,1215
2019,Jimmy Butler,SG,29,MIN,10,10,361,74,157,0.471,17,45,0.378,57,112,0.509,48,61,0.787,16,36,52,43,24,10,14,18,213
2019,Jimmy Butler,SF,29,PHI,55,55,1824,344,747,0.461,50,148,0.338,294,599,0.491,264,304,0.868,105,185,290,220,99,29,81,93,1002
2019,Joakim Noah,C,33,MEM,42,1,693,110,213,0.516,0,1,0,110,212,0.519,78,109,0.716,58,180,238,89,20,31,50,96,298
2019,Jodie Meeks,SG,31,TOR,8,0,104,21,39,0.538,8,18,0.444,13,21,0.619,1,1,1,1,11,12,8,1,1,2,5,51
2019,Joe Chealey,PG,23,CHO,1,0,8,1,3,0.333,0,0,,1,3,0.333,0,0,,0,0,0,1,0,0,0,1,2
2019,Joe Harris,SG,27,BRK,76,76,2293,374,748,0.5,183,386,0.474,191,362,0.528,110,133,0.827,52,239,291,181,38,17,121,182,1041
2019,Joe Ingles,PF,31,UTA,82,82,2568,359,802,0.448,189,483,0.391,170,319,0.533,87,123,0.707,35,295,330,469,98,20,193,180,994
2019,Joel Embiid,C,24,PHI,64,64,2154,580,1199,0.484,79,263,0.3,501,936,0.535,522,649,0.804,160,711,871,234,46,122,226,211,1761
2019,John Collins,PF,21,ATL,61,59,1829,465,831,0.56,55,158,0.348,410,673,0.609,203,266,0.763,219,376,595,121,22,39,120,199,1188
2019,John Henson,C,28,MIL,14,0,188,31,67,0.463,11,31,0.355,20,36,0.556,6,10,0.6,16,55,71,14,7,11,12,16,79
2019,John Holland,SF,30,CLE,1,0,1,0,0,,0,0,,0,0,,0,0,,0,0,0,0,0,0,0,0,0
2019,John Jenkins,SG,27,TOT,26,0,333,42,105,0.4,22,58,0.379,20,47,0.426,15,18,0.833,6,31,37,22,0,2,9,10,121
2019,John Jenkins,SG,27,WAS,4,0,14,2,2,1,2,2,1,0,0,,0,0,,0,1,1,1,0,0,0,0,6
2019,John Jenkins,SG,27,NYK,22,0,319,40,103,0.388,20,56,0.357,20,47,0.426,15,18,0.833,6,30,36,21,0,2,9,10,115
2019,John Wall,PG,28,WAS,32,32,1104,245,552,0.444,51,169,0.302,194,383,0.507,122,175,0.697,15,101,116,279,49,29,121,71,663
2019,Johnathan Motley,PF,23,LAC,22,0,156,39,73,0.534,0,3,0,39,70,0.557,24,40,0.6,18,33,51,11,5,3,16,27,102
2019,Johnathan Williams,C,23,LAL,24,0,372,65,110,0.591,0,2,0,65,108,0.602,27,48,0.563,48,51,99,13,8,7,16,62,157
2019,Jon Leuer,PF,29,DET,41,1,402,66,113,0.584,1,11,0.091,65,102,0.637,23,31,0.742,27,70,97,14,12,4,23,60,156
2019,Jonah Bolden,PF,23,PHI,44,10,639,80,162,0.494,34,96,0.354,46,66,0.697,13,27,0.481,47,118,165,40,17,39,36,99,207
2019,Jonas Jerebko,PF,31,GSW,73,6,1218,163,355,0.459,69,188,0.367,94,167,0.563,64,80,0.8,72,216,288,96,27,18,43,137,459
2019,Jonas Valančiūnas,C,26,TOT,49,27,1091,301,538,0.559,14,48,0.292,287,490,0.586,147,185,0.795,106,313,419,70,19,53,90,146,763
2019,Jonas Valančiūnas,C,26,TOR,30,10,564,149,259,0.575,9,30,0.3,140,229,0.611,77,94,0.819,54,162,216,29,13,23,39,82,384
2019,Jonas Valančiūnas,C,26,MEM,19,17,527,152,279,0.545,5,18,0.278,147,261,0.563,70,91,0.769,52,151,203,41,6,30,51,64,379
2019,Jonathan Isaac,PF,21,ORL,75,64,1996,262,611,0.429,86,266,0.323,176,345,0.51,110,135,0.815,99,312,411,80,59,98,75,143,720
2019,Jonathon Simmons,SG-SF,29,TOT,56,9,1064,133,350,0.38,28,104,0.269,105,246,0.427,72,97,0.742,27,99,126,128,29,15,68,89,366
2019,Jonathon Simmons,SG,29,ORL,41,9,845,104,286,0.364,19,83,0.229,85,203,0.419,56,72,0.778,23,77,100,95,18,14,56,68,283
2019,Jonathon Simmons,SF,29,PHI,15,0,219,29,64,0.453,9,21,0.429,20,43,0.465,16,25,0.64,4,22,26,33,11,1,12,21,83
2019,Jordan Bell,C,24,GSW,68,3,788,99,192,0.516,0,2,0,99,190,0.521,25,41,0.61,55,129,184,76,20,51,42,80,223
2019,Jordan Clarkson,SG,26,CLE,81,0,2214,529,1180,0.448,144,445,0.324,385,735,0.524,162,192,0.844,82,188,270,196,57,13,135,112,1364
2019,Jordan Loyd,PG,25,TOR,12,0,55,8,18,0.444,4,8,0.5,4,10,0.4,9,11,0.818,1,8,9,6,0,0,2,5,29
2019,Jordan McRae,SG,27,WAS,27,0,333,61,130,0.469,10,35,0.286,51,95,0.537,28,35,0.8,6,34,40,30,13,7,15,26,160
2019,Jordan Sibert,SG,26,ATL,1,0,4,1,1,1,1,1,1,0,0,,0,0,,0,0,0,0,0,0,0,0,3
2019,José Calderón,PG,37,DET,49,0,632,45,120,0.375,14,57,0.246,31,63,0.492,9,11,0.818,11,49,60,115,16,3,35,64,113
2019,Josh Hart,SG,23,LAL,67,22,1715,189,464,0.407,92,274,0.336,97,190,0.511,55,80,0.688,35,213,248,93,64,40,58,147,525
2019,Josh Jackson,SG,21,PHO,79,29,1988,347,841,0.413,73,225,0.324,274,616,0.445,143,213,0.671,66,281,347,183,74,56,173,209,910
2019,Josh Okogie,SG,20,MIN,74,52,1757,196,508,0.386,60,215,0.279,136,293,0.464,118,162,0.728,41,177,218,91,88,33,63,166,570
2019,Josh Richardson,SG,25,MIA,73,73,2539,423,1026,0.412,164,460,0.357,259,566,0.458,199,231,0.861,54,209,263,298,79,34,113,200,1209
2019,Jrue Holiday,SG,28,NOP,67,67,2402,547,1159,0.472,118,363,0.325,429,796,0.539,208,271,0.768,75,259,334,518,109,54,210,148,1420
2019,Juancho Hernangómez,PF,23,DEN,70,25,1358,138,314,0.439,66,181,0.365,72,133,0.541,66,86,0.767,64,201,265,55,27,24,37,94,408
2019,Julian Washburn,SF,27,MEM,18,3,254,16,48,0.333,5,24,0.208,11,24,0.458,3,4,0.75,8,33,41,14,13,2,7,16,40
2019,Julius Randle,PF,24,NOP,73,49,2232,571,1089,0.524,67,195,0.344,504,894,0.564,356,487,0.731,162,472,634,229,52,45,208,246,1565
2019,Justin Anderson,SF,25,ATL,48,4,463,64,157,0.408,24,77,0.312,40,80,0.5,26,35,0.743,24,60,84,23,22,13,23,48,178
2019,Justin Holiday,SG,29,TOT,82,77,2607,300,777,0.386,162,465,0.348,138,312,0.442,95,106,0.896,46,277,323,146,121,36,104,164,857
2019,Justin Holiday,SG,29,CHI,38,38,1325,151,394,0.383,97,270,0.359,54,124,0.435,41,46,0.891,19,150,169,85,67,21,47,79,440
2019,Justin Holiday,SG,29,MEM,44,39,1282,149,383,0.389,65,195,0.333,84,188,0.447,54,60,0.9,27,127,154,61,54,15,57,85,417
2019,Justin Jackson,SF,23,TOT,81,14,1614,217,485,0.447,87,245,0.355,130,240,0.542,62,79,0.785,44,168,212,96,32,14,29,99,583
2019,Justin Jackson,SF,23,SAC,52,3,1083,125,295,0.424,55,159,0.346,70,136,0.515,41,50,0.82,25,121,146,68,23,13,22,67,346
2019,Justin Jackson,SF,23,DAL,29,11,531,92,190,0.484,32,86,0.372,60,104,0.577,21,29,0.724,19,47,66,28,9,1,7,32,237
2019,Justin Patton,C,21,PHI,3,0,21,2,7,0.286,0,2,0,2,5,0.4,1,2,0.5,2,4,6,3,2,0,0,5,5
2019,Justise Winslow,SF,22,MIA,66,52,1959,324,749,0.433,96,256,0.375,228,493,0.462,86,137,0.628,63,292,355,282,72,19,142,177,830
2019,Jusuf Nurkić,C,24,POR,72,72,1974,420,826,0.508,3,29,0.103,417,797,0.523,282,365,0.773,243,505,748,233,71,103,168,250,1125
2019,Kadeem Allen,PG,26,NYK,19,1,416,65,141,0.461,17,36,0.472,48,105,0.457,42,54,0.778,8,43,51,76,16,4,26,46,189
2019,Kalin Lucas,PG,29,DET,1,0,6,0,1,0,0,1,0,0,0,,2,2,1,0,3,3,1,0,0,0,1,2
2019,Karl-Anthony Towns,C,23,MIN,77,77,2545,681,1314,0.518,142,355,0.4,539,959,0.562,376,450,0.836,263,691,954,259,67,125,240,292,1880
2019,Kawhi Leonard,SF,27,TOR,60,60,2040,560,1129,0.496,112,302,0.371,448,827,0.542,364,426,0.854,78,361,439,199,106,24,121,87,1596
2019,Keita Bates-Diop,SF,23,MIN,30,3,503,60,142,0.423,13,52,0.25,47,90,0.522,18,28,0.643,16,67,83,17,18,14,14,29,151
2019,Kelly Olynyk,PF,27,MIA,79,36,1812,261,564,0.463,113,319,0.354,148,245,0.604,152,185,0.822,72,303,375,140,53,37,114,183,787
2019,Kelly Oubre Jr.,SF,23,TOT,69,19,1935,375,842,0.445,108,338,0.32,267,504,0.53,189,244,0.775,71,254,325,84,84,59,103,181,1047
2019,Kelly Oubre Jr.,SF,23,WAS,29,7,755,132,305,0.433,41,132,0.311,91,173,0.526,68,85,0.8,24,105,129,20,27,20,30,71,373
2019,Kelly Oubre Jr.,SF,23,PHO,40,12,1180,243,537,0.453,67,206,0.325,176,331,0.532,121,159,0.761,47,149,196,64,57,39,73,110,674
2019,Kemba Walker,PG,28,CHO,82,82,2863,731,1684,0.434,260,731,0.356,471,953,0.494,380,450,0.844,52,309,361,484,102,34,211,131,2102
2019,Kenneth Faried,C,29,TOT,37,13,728,156,265,0.589,8,25,0.32,148,240,0.617,64,99,0.646,97,153,250,20,17,23,33,82,384
2019,Kenneth Faried,C,29,BRK,12,0,118,25,42,0.595,1,5,0.2,24,37,0.649,10,16,0.625,15,29,44,2,2,4,6,8,61
2019,Kenneth Faried,C,29,HOU,25,13,610,131,223,0.587,7,20,0.35,124,203,0.611,54,83,0.651,82,124,206,18,15,19,27,74,323
2019,Kenrich Williams,SF,24,NOP,46,29,1079,107,279,0.384,52,156,0.333,55,123,0.447,13,19,0.684,55,164,219,83,45,19,36,95,279
2019,Kent Bazemore,SG,29,ATL,67,35,1643,278,691,0.402,96,300,0.32,182,391,0.465,127,175,0.726,37,224,261,152,89,42,121,170,779
2019,Kentavious Caldwell-Pope,SG,25,LAL,82,23,2035,325,756,0.43,151,435,0.347,174,321,0.542,137,158,0.867,48,190,238,110,73,13,65,137,938
2019,Kevin Durant,SF,30,GSW,78,78,2702,721,1383,0.521,137,388,0.353,584,995,0.587,448,506,0.885,33,464,497,457,58,84,225,155,2027
2019,Kevin Huerter,SG,20,ATL,75,59,2048,275,657,0.419,136,353,0.385,139,304,0.457,41,56,0.732,60,185,245,214,65,25,109,155,727
2019,Kevin Knox,PF,19,NYK,75,57,2158,338,914,0.37,125,364,0.343,213,550,0.387,162,226,0.717,61,274,335,82,43,24,114,175,963
2019,Kevin Love,PF,30,CLE,22,21,598,109,283,0.385,53,147,0.361,56,136,0.412,103,114,0.904,33,206,239,48,6,5,42,54,374
2019,Kevon Looney,C,22,GSW,80,24,1481,217,347,0.625,1,10,0.1,216,337,0.641,65,105,0.619,194,223,417,123,46,53,51,211,500
2019,Khem Birch,C,26,ORL,50,1,643,91,151,0.603,0,1,0,91,150,0.607,58,83,0.699,79,111,190,38,18,29,20,72,240
2019,Khris Middleton,SF,27,MIL,77,77,2393,506,1148,0.441,179,474,0.378,327,674,0.485,216,258,0.837,50,411,461,331,80,7,174,172,1407
2019,Khyri Thomas,SG,22,DET,26,0,195,22,69,0.319,10,35,0.286,12,34,0.353,7,11,0.636,4,16,20,8,7,5,4,22,61
2019,Klay Thompson,SG,28,GSW,78,78,2652,655,1402,0.467,241,599,0.402,414,803,0.516,129,158,0.816,37,262,299,186,84,47,115,157,1680
2019,Kobi Simmons,PG,21,CLE,1,0,2,0,0,,0,0,,0,0,,0,0,,0,0,0,0,0,0,0,0,0
2019,Kosta Koufos,C,29,SAC,42,1,502,73,153,0.477,0,0,,73,153,0.477,10,24,0.417,52,125,177,36,15,18,27,68,156
2019,Kostas Antetokounmpo,PF,21,DAL,2,0,11,0,3,0,0,0,,0,3,0,2,4,0.5,0,1,1,0,2,0,1,0,2
2019,Kris Dunn,PG,24,CHI,46,44,1389,215,506,0.425,34,96,0.354,181,410,0.441,55,69,0.797,19,168,187,277,68,21,104,166,519
2019,Kyle Anderson,SF,25,MEM,43,40,1281,150,276,0.543,9,34,0.265,141,242,0.583,37,64,0.578,48,203,251,128,54,37,58,112,346
2019,Kyle Korver,SG-PF,37,TOT,70,0,1334,201,483,0.416,138,348,0.397,63,135,0.467,60,73,0.822,9,153,162,81,25,12,59,106,600
2019,Kyle Korver,PF,37,CLE,16,0,251,35,76,0.461,25,54,0.463,10,22,0.455,13,16,0.813,0,29,29,17,3,2,17,22,108
2019,Kyle Korver,SG,37,UTA,54,0,1083,166,407,0.408,113,294,0.384,53,113,0.469,47,57,0.825,9,124,133,64,22,10,42,84,492
2019,Kyle Kuzma,PF,23,LAL,70,68,2314,496,1087,0.456,128,422,0.303,368,665,0.553,188,250,0.752,60,322,382,178,41,26,133,170,1308
2019,Kyle Lowry,PG,32,TOR,65,65,2213,304,739,0.411,157,453,0.347,147,286,0.514,161,194,0.83,41,271,312,564,91,31,182,166,926
2019,Kyle O'Quinn,C,28,IND,45,3,371,69,136,0.507,1,12,0.083,68,124,0.548,17,21,0.81,29,90,119,56,9,25,31,68,156
2019,Kyrie Irving,PG,26,BOS,67,67,2214,604,1241,0.487,174,434,0.401,430,807,0.533,214,245,0.873,71,264,335,464,103,34,172,167,1596
2019,LaMarcus Aldridge,C,33,SAS,81,81,2687,684,1319,0.519,10,42,0.238,674,1277,0.528,349,412,0.847,251,493,744,194,43,107,144,179,1727
2019,Lance Stephenson,SG,28,LAL,68,3,1123,184,432,0.426,73,197,0.371,111,235,0.472,50,73,0.685,32,183,215,140,41,7,86,111,491
2019,Lance Thomas,PF,30,NYK,46,17,783,78,197,0.396,22,79,0.278,56,118,0.475,27,36,0.75,21,96,117,27,17,7,24,83,205
2019,Landry Shamet,SG,21,TOT,79,27,1802,240,557,0.431,167,396,0.422,73,161,0.453,75,93,0.806,21,113,134,117,37,10,45,155,722
2019,Landry Shamet,SG,21,PHI,54,4,1108,153,347,0.441,99,245,0.404,54,102,0.529,44,54,0.815,14,64,78,59,24,8,26,106,449
2019,Landry Shamet,SG,21,LAC,25,23,694,87,210,0.414,68,151,0.45,19,59,0.322,31,39,0.795,7,49,56,58,13,2,19,49,273
2019,Langston Galloway,SG,27,DET,80,4,1745,228,587,0.388,135,380,0.355,93,207,0.449,81,96,0.844,49,122,171,85,37,8,24,135,672
2019,Larry Nance Jr.,C,26,CLE,67,30,1795,249,479,0.52,33,98,0.337,216,381,0.567,96,134,0.716,168,384,552,214,100,40,97,192,627
2019,Lauri Markkanen,PF,21,CHI,52,51,1682,342,795,0.43,120,332,0.361,222,463,0.479,170,195,0.872,74,396,470,75,37,33,85,122,974
2019,LeBron James,SF,34,LAL,55,55,1937,558,1095,0.51,111,327,0.339,447,768,0.582,278,418,0.665,57,408,465,454,72,33,197,94,1505
2019,Lonnie Walker IV,SG,20,SAS,17,0,118,16,46,0.348,5,13,0.385,11,33,0.333,8,10,0.8,0,17,17,9,7,3,4,7,45
2019,Lonzo Ball,PG,21,LAL,47,45,1423,185,456,0.406,75,228,0.329,110,228,0.482,20,48,0.417,54,197,251,255,69,19,103,114,465
2019,Lorenzo Brown,PG,28,TOR,26,0,212,23,71,0.324,6,28,0.214,17,43,0.395,3,3,1,5,26,31,28,12,5,16,22,55
2019,Lou Williams,SG,32,LAC,75,1,1993,484,1138,0.425,105,291,0.361,379,847,0.447,425,485,0.876,40,182,222,402,57,11,181,80,1498
2019,Luc Mbah a Moute,PF,32,LAC,4,0,61,8,18,0.444,2,6,0.333,6,12,0.5,2,5,0.4,2,5,7,2,1,1,2,8,20
2019,Luka Dončić,SG,19,DAL,72,72,2318,506,1186,0.427,168,514,0.327,338,672,0.503,346,485,0.713,86,477,563,429,77,25,247,137,1526
2019,Luke Kennard,SG,22,DET,63,10,1437,228,520,0.438,106,269,0.394,122,251,0.486,51,61,0.836,12,171,183,114,26,10,57,92,613
2019,Luke Kornet,PF,23,NYK,46,18,784,107,283,0.378,70,193,0.363,37,90,0.411,38,46,0.826,28,107,135,54,27,42,25,41,322
2019,Luol Deng,SF,33,MIN,22,2,392,59,118,0.5,14,44,0.318,45,74,0.608,25,35,0.714,20,53,73,18,15,8,14,24,157
2019,Malachi Richardson,SG,23,TOR,22,0,103,9,29,0.31,8,25,0.32,1,4,0.25,4,5,0.8,2,11,13,0,1,0,8,13,30
2019,Malcolm Brogdon,SG,26,MIL,64,64,1832,378,748,0.505,104,244,0.426,274,504,0.544,141,152,0.928,65,223,288,205,46,13,91,102,1001
2019,Malcolm Miller,SF,25,TOR,10,0,67,11,26,0.423,10,21,0.476,1,5,0.2,3,4,0.75,1,4,5,1,1,1,1,5,35
2019,Malik Beasley,SG,22,DEN,81,18,1879,349,737,0.474,163,405,0.402,186,332,0.56,56,66,0.848,35,165,200,97,55,10,55,116,917
2019,Malik Monk,SG,20,CHO,73,0,1258,227,586,0.387,109,330,0.33,118,256,0.461,90,102,0.882,16,121,137,117,37,19,86,106,653
2019,Marc Gasol,C,34,TOT,79,72,2436,390,870,0.448,99,273,0.363,291,597,0.487,192,253,0.759,80,547,627,349,84,86,155,217,1071
2019,Marc Gasol,C,34,MEM,53,53,1788,303,683,0.444,76,221,0.344,227,462,0.491,152,201,0.756,56,399,455,248,60,63,119,147,834
2019,Marc Gasol,C,34,TOR,26,19,648,87,187,0.465,23,52,0.442,64,135,0.474,40,52,0.769,24,148,172,101,24,23,36,70,237
2019,Marcin Gortat,C,34,LAC,47,43,751,99,186,0.532,0,0,,99,186,0.532,35,48,0.729,67,194,261,65,6,24,50,92,233
2019,Marco Belinelli,SG,32,SAS,79,1,1815,285,690,0.413,147,395,0.372,138,295,0.468,112,124,0.903,16,182,198,132,35,8,72,121,829
2019,Marcus Derrickson,PF,22,GSW,11,0,67,16,33,0.485,10,20,0.5,6,13,0.462,4,5,0.8,8,5,13,1,0,1,3,9,46
2019,Marcus Morris,PF,29,BOS,75,53,2091,377,844,0.447,146,389,0.375,231,455,0.508,146,173,0.844,76,382,458,109,43,25,92,181,1046
2019,Marcus Smart,SG,24,BOS,80,60,2200,239,567,0.422,126,346,0.364,113,221,0.511,104,129,0.806,57,177,234,321,143,28,123,201,708
2019,Mario Hezonja,SF,23,NYK,58,24,1206,191,464,0.412,42,152,0.276,149,312,0.478,87,114,0.763,28,211,239,88,57,8,88,110,511
2019,Markelle Fultz,SG,20,PHI,19,15,427,65,155,0.419,4,14,0.286,61,141,0.433,21,37,0.568,26,44,70,59,17,5,25,52,155
2019,Markieff Morris,PF,29,TOT,58,16,1270,204,484,0.421,68,203,0.335,136,281,0.484,71,92,0.772,61,204,265,79,36,22,54,175,547
2019,Markieff Morris,PF,29,WAS,34,15,883,143,328,0.436,48,144,0.333,95,184,0.516,57,73,0.781,41,133,174,60,25,20,47,117,391
2019,Markieff Morris,PF,29,OKC,24,1,387,61,156,0.391,20,59,0.339,41,97,0.423,14,19,0.737,20,71,91,19,11,2,7,58,156
2019,Marquese Chriss,PF,21,TOT,43,2,499,67,180,0.372,16,72,0.222,51,108,0.472,32,45,0.711,40,102,142,22,17,11,36,81,182
2019,Marquese Chriss,PF,21,HOU,16,0,104,11,34,0.324,1,15,0.067,10,19,0.526,6,7,0.857,7,21,28,6,2,4,12,17,29
2019,Marquese Chriss,PF,21,CLE,27,2,395,56,146,0.384,15,57,0.263,41,89,0.461,26,38,0.684,33,81,114,16,15,7,24,64,153
2019,MarShon Brooks,SG,30,MEM,29,0,387,76,169,0.45,15,54,0.278,61,115,0.53,23,33,0.697,12,33,45,25,9,4,21,33,190
2019,Marvin Bagley III,PF,19,SAC,62,4,1567,356,706,0.504,30,96,0.313,326,610,0.534,181,262,0.691,162,309,471,62,33,59,98,120,923
2019,Marvin Williams,PF,32,CHO,75,75,2133,275,652,0.422,140,382,0.366,135,270,0.5,66,86,0.767,76,331,407,92,71,61,47,156,756
2019,Mason Plumlee,C,28,DEN,82,17,1731,262,442,0.593,2,10,0.2,260,432,0.602,111,198,0.561,165,359,524,243,66,76,126,252,637
2019,Matthew Dellavedova,PG,28,TOT,48,0,812,98,242,0.405,44,130,0.338,54,112,0.482,42,52,0.808,6,71,77,181,14,2,68,75,282
2019,Matthew Dellavedova,PG,28,MIL,12,0,97,6,19,0.316,4,11,0.364,2,8,0.25,4,4,1,0,10,10,29,2,0,11,9,20
2019,Matthew Dellavedova,PG,28,CLE,36,0,715,92,223,0.413,40,119,0.336,52,104,0.5,38,48,0.792,6,61,67,152,12,2,57,66,262
2019,Maurice Harkless,SF,25,POR,60,53,1415,189,388,0.487,33,120,0.275,156,268,0.582,49,73,0.671,77,192,269,74,67,53,45,163,460
2019,Maxi Kleber,PF,27,DAL,71,18,1502,175,386,0.453,77,218,0.353,98,168,0.583,58,74,0.784,90,239,329,70,36,78,54,143,485
2019,Melvin Frazier,SG,22,ORL,10,0,44,7,21,0.333,0,6,0,7,15,0.467,1,4,0.25,3,2,5,1,1,0,1,6,15
2019,Meyers Leonard,C,26,POR,61,2,878,132,242,0.545,50,111,0.45,82,131,0.626,43,51,0.843,49,184,233,75,13,9,43,105,357
2019,Michael Beasley,PF,30,LAL,26,2,277,75,153,0.49,3,17,0.176,72,136,0.529,28,39,0.718,13,47,60,25,9,10,27,42,181
2019,Michael Carter-Williams,PG,27,TOT,28,1,372,46,123,0.374,10,38,0.263,36,85,0.424,32,53,0.604,19,51,70,70,20,15,20,48,134
2019,Michael Carter-Williams,PG,27,HOU,16,1,145,25,61,0.41,7,19,0.368,18,42,0.429,12,26,0.462,3,10,13,21,9,6,10,27,69
2019,Michael Carter-Williams,PG,27,ORL,12,0,227,21,62,0.339,3,19,0.158,18,43,0.419,20,27,0.741,16,41,57,49,11,9,10,21,65
2019,Michael Kidd-Gilchrist,PF,25,CHO,64,3,1179,158,332,0.476,16,47,0.34,142,285,0.498,95,123,0.772,88,158,246,61,32,39,43,156,427
2019,Mikal Bridges,SF,22,PHO,82,56,2417,242,563,0.43,105,313,0.335,137,250,0.548,95,118,0.805,56,208,264,173,129,38,70,201,684
2019,Mike Conley,PG,31,MEM,70,70,2342,490,1120,0.438,155,426,0.364,335,694,0.483,343,406,0.845,40,199,239,449,94,22,130,123,1478
2019,Mike Muscala,PF,27,TOT,64,10,1306,145,361,0.402,89,256,0.348,56,105,0.533,70,85,0.824,57,187,244,76,22,38,48,130,449
2019,Mike Muscala,PF,27,PHI,47,6,1041,109,278,0.392,68,199,0.342,41,79,0.519,63,77,0.818,51,149,200,62,18,27,43,112,349
2019,Mike Muscala,PF,27,LAL,17,4,265,36,83,0.434,21,57,0.368,15,26,0.577,7,8,0.875,6,38,44,14,4,11,5,18,100
2019,Mike Scott,PF,30,TOT,79,3,1395,168,420,0.4,101,252,0.401,67,168,0.399,22,33,0.667,43,233,276,66,26,13,44,156,459
2019,Mike Scott,PF,30,LAC,52,0,748,92,230,0.4,52,133,0.391,40,97,0.412,12,18,0.667,24,150,174,44,17,8,27,88,248
2019,Mike Scott,PF,30,PHI,27,3,647,76,190,0.4,49,119,0.412,27,71,0.38,10,15,0.667,19,83,102,22,9,5,17,68,211
2019,Miles Bridges,SF,20,CHO,80,25,1696,237,511,0.464,65,200,0.325,172,311,0.553,58,77,0.753,67,256,323,95,55,49,50,111,597
2019,Miles Plumlee,C,30,ATL,18,0,173,32,48,0.667,0,0,,32,48,0.667,16,30,0.533,16,23,39,17,6,4,10,14,80
2019,Miloš Teodosić,PG,31,LAC,15,0,150,17,40,0.425,10,27,0.37,7,13,0.538,4,7,0.571,3,13,16,32,3,1,21,27,48
2019,Mitch Creek,SF,26,TOT,5,0,48,8,16,0.5,0,2,0,8,14,0.571,5,7,0.714,6,6,12,6,2,0,1,3,21
2019,Mitch Creek,SF,26,BRK,4,0,36,5,10,0.5,0,1,0,5,9,0.556,5,7,0.714,5,5,10,5,1,0,0,3,15
2019,Mitch Creek,SF,26,MIN,1,0,12,3,6,0.5,0,1,0,3,5,0.6,0,0,,1,1,2,1,1,0,1,0,6
2019,Mitchell Robinson,C,20,NYK,66,19,1360,202,291,0.694,0,0,,202,291,0.694,81,135,0.6,177,246,423,37,52,161,35,217,485
2019,Mo Bamba,C,20,ORL,47,1,766,117,243,0.481,21,70,0.3,96,173,0.555,37,63,0.587,64,169,233,39,13,64,43,102,292
2019,Monte Morris,PG,23,DEN,82,6,1970,346,702,0.493,94,227,0.414,252,475,0.531,65,81,0.802,35,159,194,297,73,4,52,102,851
2019,Montrezl Harrell,C,25,LAC,82,5,2158,546,888,0.615,3,17,0.176,543,871,0.623,266,414,0.643,184,351,535,162,71,110,132,255,1361
2019,Moritz Wagner,C,21,LAL,43,5,446,71,171,0.415,22,77,0.286,49,94,0.521,43,53,0.811,17,68,85,24,11,13,39,57,207
2019,Myles Turner,C,22,IND,74,74,2119,380,780,0.487,76,196,0.388,304,584,0.521,148,201,0.736,101,430,531,115,60,199,100,195,984
2019,Naz Mitrou-Long,SG,25,UTA,14,0,84,6,20,0.3,2,11,0.182,4,9,0.444,2,2,1,1,5,6,15,1,1,8,10,16
2019,Nemanja Bjelica,PF,30,SAC,77,70,1788,284,593,0.479,103,257,0.401,181,336,0.539,70,92,0.761,125,319,444,147,54,56,82,197,741
2019,Nenê,C,36,HOU,42,2,546,60,116,0.517,0,3,0,60,113,0.531,31,47,0.66,34,89,123,26,18,15,11,87,151
2019,Nerlens Noel,C,24,OKC,77,2,1055,162,276,0.587,0,0,,162,276,0.587,54,79,0.684,127,198,325,45,66,96,48,166,378
2019,Nick Young,SG,33,DEN,4,0,37,3,9,0.333,3,8,0.375,0,1,0,0,0,,0,1,1,2,0,1,2,4,9
2019,Nicolas Batum,SF,30,CHO,75,72,2354,253,562,0.45,116,298,0.389,137,264,0.519,77,89,0.865,71,319,390,247,71,43,117,140,699
2019,Nik Stauskas,SG,25,TOT,68,0,1015,136,338,0.402,70,188,0.372,66,150,0.44,57,64,0.891,18,109,127,81,21,7,51,50,399
2019,Nik Stauskas,SG,25,POR,44,0,673,96,229,0.419,43,125,0.344,53,104,0.51,32,36,0.889,10,70,80,62,14,4,40,31,267
2019,Nik Stauskas,SG,25,CLE,24,0,342,40,109,0.367,27,63,0.429,13,46,0.283,25,28,0.893,8,39,47,19,7,3,11,19,132
2019,Nikola Jokić,C,23,DEN,80,80,2504,616,1206,0.511,83,270,0.307,533,936,0.569,289,352,0.821,228,637,865,580,108,55,248,228,1604
2019,Nikola Mirotić,PF,27,TOT,46,25,1245,238,542,0.439,116,318,0.365,122,224,0.545,105,124,0.847,60,279,339,55,31,34,48,107,697
2019,Nikola Mirotić,PF,27,NOP,32,22,925,182,407,0.447,85,231,0.368,97,176,0.551,85,101,0.842,46,218,264,35,21,25,37,86,534
2019,Nikola Mirotić,PF,27,MIL,14,3,320,56,135,0.415,31,87,0.356,25,48,0.521,20,23,0.87,14,61,75,20,10,9,11,21,163
2019,Nikola Vučević,C,28,ORL,80,80,2510,701,1354,0.518,84,231,0.364,617,1123,0.549,179,227,0.789,224,736,960,307,81,89,159,157,1665
2019,Noah Vonleh,PF,23,NYK,68,57,1722,207,440,0.47,46,137,0.336,161,303,0.531,111,156,0.712,113,415,528,129,46,51,88,174,571
2019,Norman Powell,SG,25,TOR,60,3,1126,193,400,0.483,68,170,0.4,125,230,0.543,62,75,0.827,16,123,139,91,39,13,65,96,516
2019,OG Anunoby,SF,21,TOR,67,6,1352,183,404,0.453,67,202,0.332,116,202,0.574,36,62,0.581,58,139,197,47,46,22,55,140,469
2019,Okaro White,PF,26,WAS,3,0,6,0,2,0,0,2,0,0,0,,0,0,,1,1,2,0,0,0,0,0,0
2019,Omari Spellman,PF,21,ATL,46,11,805,98,244,0.402,44,128,0.344,54,116,0.466,32,45,0.711,72,122,194,47,26,25,31,67,272
2019,Omri Casspi,SF,30,MEM,36,0,520,86,161,0.534,15,43,0.349,71,118,0.602,39,58,0.672,17,98,115,26,20,9,23,35,226
2019,Otto Porter Jr.,SF,25,TOT,56,43,1683,299,643,0.465,104,256,0.406,195,387,0.504,78,96,0.813,54,260,314,120,82,31,65,108,780
2019,Otto Porter Jr.,SF,25,WAS,41,28,1191,202,442,0.457,65,176,0.369,137,266,0.515,49,64,0.766,40,191,231,80,64,22,40,79,518
2019,Otto Porter Jr.,SF,25,CHI,15,15,492,97,201,0.483,39,80,0.488,58,121,0.479,29,32,0.906,14,69,83,40,18,9,25,29,262
2019,P.J. Tucker,PF,33,HOU,82,82,2802,207,523,0.396,146,387,0.377,61,136,0.449,41,59,0.695,121,358,479,96,132,39,63,252,601
2019,Pascal Siakam,PF,24,TOR,80,79,2548,519,945,0.549,79,214,0.369,440,731,0.602,237,302,0.785,124,425,549,248,73,52,154,241,1354
2019,Pat Connaughton,SG,26,MIL,61,2,1261,163,350,0.466,66,200,0.33,97,150,0.647,29,40,0.725,61,197,258,122,33,25,33,81,421
2019,Patrick Beverley,PG,30,LAC,78,49,2137,194,477,0.407,112,282,0.397,82,195,0.421,96,123,0.78,76,312,388,300,67,43,85,265,596
2019,Patrick McCaw,SG,23,TOT,29,1,397,26,63,0.413,9,28,0.321,17,35,0.486,13,15,0.867,7,41,48,29,23,2,17,38,74
2019,Patrick McCaw,SG,23,CLE,3,0,53,2,9,0.222,1,4,0.25,1,5,0.2,0,0,,0,3,3,2,2,0,3,1,5
2019,Patrick McCaw,SG,23,TOR,26,1,344,24,54,0.444,8,24,0.333,16,30,0.533,13,15,0.867,7,38,45,27,21,2,14,37,69
2019,Patrick Patterson,PF,29,OKC,63,5,861,82,219,0.374,46,137,0.336,36,82,0.439,19,30,0.633,42,105,147,31,16,13,22,46,229
2019,Patty Mills,PG,30,SAS,82,1,1908,282,663,0.425,159,404,0.394,123,259,0.475,88,103,0.854,24,158,182,245,49,10,93,129,811
2019,Pau Gasol,C,38,TOT,30,6,360,42,94,0.447,6,13,0.462,36,81,0.444,28,40,0.7,22,115,137,52,5,15,16,29,118
2019,Pau Gasol,C,38,SAS,27,6,330,41,88,0.466,5,10,0.5,36,78,0.462,27,38,0.711,22,105,127,50,5,14,14,28,114
2019,Pau Gasol,C,38,MIL,3,0,30,1,6,0.167,1,3,0.333,0,3,0,1,2,0.5,0,10,10,2,0,1,2,1,4
2019,Paul George,SF,28,OKC,77,77,2841,707,1614,0.438,292,757,0.386,415,857,0.484,453,540,0.839,105,523,628,318,170,34,205,214,2159
2019,Paul Millsap,PF,33,DEN,70,65,1895,322,665,0.484,58,159,0.365,264,506,0.522,181,249,0.727,153,352,505,141,83,54,95,183,883
2019,PJ Dozier,SG,22,BOS,6,0,51,8,21,0.381,2,8,0.25,6,13,0.462,1,2,0.5,6,11,17,5,2,0,0,2,19
2019,Quincy Acy,PF,28,PHO,10,0,123,4,18,0.222,2,15,0.133,2,3,0.667,7,10,0.7,3,22,25,8,1,4,4,24,17
2019,Quincy Pondexter,SF,30,SAS,53,0,292,29,58,0.5,6,18,0.333,23,40,0.575,34,42,0.81,8,38,46,24,11,1,13,24,98
2019,Quinn Cook,PG,25,GSW,74,10,1059,204,439,0.465,81,200,0.405,123,239,0.515,20,26,0.769,22,135,157,116,20,3,50,92,509
2019,R.J. Hunter,SG,25,BOS,1,0,26,6,13,0.462,4,10,0.4,2,3,0.667,1,2,0.5,1,2,3,3,1,0,0,3,17
2019,Rajon Rondo,PG,32,LAL,46,29,1369,175,432,0.405,51,142,0.359,124,290,0.428,23,36,0.639,34,209,243,367,57,7,127,100,424
2019,Raul Neto,PG,26,UTA,37,1,474,74,161,0.46,20,60,0.333,54,101,0.535,28,33,0.848,6,56,62,93,14,4,35,49,196
2019,Rawle Alkins,SG,21,CHI,10,1,120,13,39,0.333,3,12,0.25,10,27,0.37,8,12,0.667,11,15,26,13,1,0,8,7,37
2019,Ray Spalding,PF,21,TOT,14,3,148,25,47,0.532,0,3,0,25,44,0.568,4,12,0.333,15,33,48,5,9,8,9,23,54
2019,Ray Spalding,PF,21,DAL,1,0,1,0,0,,0,0,,0,0,,0,0,,0,0,0,0,0,0,0,0,0
2019,Ray Spalding,PF,21,PHO,13,3,147,25,47,0.532,0,3,0,25,44,0.568,4,12,0.333,15,33,48,5,9,8,9,23,54
2019,Raymond Felton,PG,34,OKC,33,0,379,55,135,0.407,20,61,0.328,35,74,0.473,12,13,0.923,4,30,34,52,10,6,14,29,142
2019,Reggie Bullock,SG,27,TOT,63,60,1879,245,594,0.412,148,393,0.377,97,201,0.483,73,85,0.859,22,151,173,129,40,12,65,109,711
2019,Reggie Bullock,SG,27,DET,44,44,1355,182,441,0.413,114,294,0.388,68,147,0.463,56,64,0.875,20,103,123,109,24,5,54,79,534
2019,Reggie Bullock,SG,27,LAL,19,16,524,63,153,0.412,34,99,0.343,29,54,0.537,17,21,0.81,2,48,50,20,16,7,11,30,177
2019,Reggie Jackson,PG,28,DET,82,82,2289,441,1047,0.421,174,471,0.369,267,576,0.464,204,236,0.864,45,171,216,344,55,9,148,208,1260
2019,Richaun Holmes,C,25,PHO,70,4,1184,222,365,0.608,0,0,,222,365,0.608,128,175,0.731,115,216,331,60,42,79,52,194,572
2019,Ricky Rubio,PG,28,UTA,68,67,1899,295,730,0.404,79,254,0.311,216,476,0.454,195,228,0.855,33,210,243,416,91,10,180,180,864
2019,Robert Covington,SF,28,TOT,35,35,1203,156,362,0.431,85,225,0.378,71,137,0.518,68,89,0.764,28,165,193,46,74,47,47,126,465
2019,Robert Covington,SF,28,PHI,13,13,440,50,117,0.427,30,77,0.39,20,40,0.5,17,23,0.739,7,60,67,14,24,23,22,45,147
2019,Robert Covington,SF,28,MIN,22,22,763,106,245,0.433,55,148,0.372,51,97,0.526,51,66,0.773,21,105,126,32,50,24,25,81,318
2019,Robert Williams,C,21,BOS,32,2,283,36,51,0.706,0,0,,36,51,0.706,9,15,0.6,27,54,81,7,9,40,10,36,81
2019,Robin Lopez,C,30,CHI,74,36,1606,304,535,0.568,7,31,0.226,297,504,0.589,89,123,0.724,140,146,286,89,11,78,96,124,704
2019,Rodions Kurucs,SF,20,BRK,63,46,1294,202,449,0.45,58,184,0.315,144,265,0.543,72,92,0.783,56,190,246,52,41,25,77,146,534
2019,Rodney Hood,SG,26,TOT,72,49,1893,292,671,0.435,84,236,0.356,208,435,0.478,137,155,0.884,25,132,157,126,59,12,55,146,805
2019,Rodney Hood,SG,26,CLE,45,45,1234,194,454,0.427,55,152,0.362,139,302,0.46,104,114,0.912,18,94,112,92,38,5,36,101,547
2019,Rodney Hood,SG,26,POR,27,4,659,98,217,0.452,29,84,0.345,69,133,0.519,33,41,0.805,7,38,45,34,21,7,19,45,258
2019,Rodney McGruder,SG,27,MIA,66,45,1550,186,461,0.403,79,225,0.351,107,236,0.453,52,72,0.722,60,178,238,112,36,12,64,115,503
2019,Ron Baker,SG,25,TOT,15,0,152,4,20,0.2,1,13,0.077,3,7,0.429,5,6,0.833,1,10,11,15,6,1,5,18,14
2019,Ron Baker,SG,25,NYK,11,0,107,4,16,0.25,1,9,0.111,3,7,0.429,5,6,0.833,1,6,7,13,5,0,3,16,14
2019,Ron Baker,SG,25,WAS,4,0,45,0,4,0,0,4,0,0,0,,0,0,,0,4,4,2,1,1,2,2,0
2019,Rondae Hollis-Jefferson,SF,24,BRK,59,21,1234,200,487,0.411,9,49,0.184,191,438,0.436,118,183,0.645,83,227,310,96,44,27,68,107,527
2019,Royce O'Neale,SF,25,UTA,82,16,1671,163,343,0.475,68,176,0.386,95,167,0.569,32,42,0.762,22,263,285,124,54,24,70,172,426
2019,Rudy Gay,PF,32,SAS,69,51,1842,376,746,0.504,74,184,0.402,302,562,0.537,120,147,0.816,63,407,470,182,54,34,114,159,946
2019,Rudy Gobert,C,26,UTA,81,80,2577,476,712,0.669,0,0,,476,712,0.669,332,522,0.636,309,732,1041,161,66,187,130,231,1284
2019,Russell Westbrook,PG,30,OKC,73,73,2630,630,1473,0.428,119,411,0.29,511,1062,0.481,296,451,0.656,109,698,807,784,142,33,325,245,1675
2019,Ryan Anderson,PF,30,TOT,25,8,322,21,69,0.304,9,40,0.225,12,29,0.414,12,16,0.75,18,36,54,19,4,1,14,25,63
2019,Ryan Anderson,PF,30,PHO,15,8,278,19,60,0.317,7,34,0.206,12,26,0.462,11,14,0.786,14,31,45,17,3,1,12,23,56
2019,Ryan Anderson,PF,30,MIA,10,0,44,2,9,0.222,2,6,0.333,0,3,0,1,2,0.5,4,5,9,2,1,0,2,2,7
2019,Ryan Arcidiacono,PG,24,CHI,81,32,1961,187,418,0.447,81,217,0.373,106,201,0.527,89,102,0.873,27,192,219,269,65,4,63,171,544
2019,Ryan Broekhoff,SG,28,DAL,42,0,453,57,126,0.452,38,93,0.409,19,33,0.576,15,19,0.789,8,55,63,22,6,4,16,35,167
2019,Salah Mejri,C,32,DAL,36,4,399,55,112,0.491,11,34,0.324,44,78,0.564,20,32,0.625,36,95,131,35,10,26,21,55,141
2019,Sam Dekker,PF,24,TOT,47,5,788,120,256,0.469,19,62,0.306,101,194,0.521,28,46,0.609,53,95,148,46,38,7,24,47,287
2019,Sam Dekker,PF,24,CLE,9,5,169,22,48,0.458,5,13,0.385,17,35,0.486,8,10,0.8,9,24,33,9,11,0,5,13,57
2019,Sam Dekker,PF,24,WAS,38,0,619,98,208,0.471,14,49,0.286,84,159,0.528,20,36,0.556,44,71,115,37,27,7,19,34,230
2019,Scott Machado,PG,28,LAL,4,0,19,4,6,0.667,1,1,1,3,5,0.6,1,1,1,0,0,0,3,1,0,0,2,10
2019,Semi Ojeleye,PF,24,BOS,56,3,594,67,158,0.424,28,89,0.315,39,69,0.565,24,39,0.615,24,62,86,23,10,4,19,43,186
2019,Serge Ibaka,C,29,TOR,74,51,2010,464,877,0.529,49,169,0.29,415,708,0.586,135,177,0.763,156,445,601,99,29,103,114,211,1112
2019,Seth Curry,SG,28,POR,74,2,1399,212,465,0.456,113,251,0.45,99,214,0.463,44,52,0.846,27,93,120,66,36,12,61,97,581
2019,Shabazz Napier,PG,27,BRK,56,2,983,169,435,0.389,76,228,0.333,93,207,0.449,115,138,0.833,18,82,100,143,41,16,66,67,529
2019,Shai Gilgeous-Alexander,PG,20,LAC,82,73,2174,341,716,0.476,51,139,0.367,290,577,0.503,156,195,0.8,57,175,232,270,96,45,141,175,889
2019,Shake Milton,SG,22,PHI,20,0,268,34,87,0.391,14,44,0.318,20,43,0.465,5,7,0.714,9,26,35,18,8,8,6,29,87
2019,Shaquille Harrison,SG,25,CHI,73,11,1430,184,426,0.432,24,89,0.27,160,337,0.475,82,123,0.667,33,189,222,139,89,30,60,124,474
2019,Shaun Livingston,PG,33,GSW,64,0,967,109,210,0.519,0,2,0,109,208,0.524,40,51,0.784,42,75,117,114,31,27,38,74,258
2019,Shelvin Mack,PG,28,TOT,57,3,1246,163,403,0.404,46,130,0.354,117,273,0.429,58,84,0.69,18,86,104,183,47,4,66,84,430
2019,Shelvin Mack,PG,28,MEM,53,3,1204,161,389,0.414,46,128,0.359,115,261,0.441,53,75,0.707,18,84,102,182,45,4,62,81,421
2019,Shelvin Mack,PG,28,CHO,4,0,42,2,14,0.143,0,2,0,2,12,0.167,5,9,0.556,0,2,2,1,2,0,4,3,9
2019,Sindarius Thornwell,SG,24,LAC,64,1,313,17,49,0.347,3,15,0.2,14,34,0.412,25,34,0.735,5,39,44,18,14,7,20,41,62
2019,Skal Labissière,PF,22,TOT,22,1,176,26,49,0.531,6,13,0.462,20,36,0.556,9,17,0.529,9,34,43,11,5,6,11,29,67
2019,Skal Labissière,PF,22,SAC,13,0,113,13,30,0.433,4,11,0.364,9,19,0.474,6,11,0.545,4,20,24,6,2,3,7,21,36
2019,Skal Labissière,PF,22,POR,9,1,63,13,19,0.684,2,2,1,11,17,0.647,3,6,0.5,5,14,19,5,3,3,4,8,31
2019,Solomon Hill,SF,27,NOP,44,15,878,68,178,0.382,32,101,0.317,36,77,0.468,23,32,0.719,34,99,133,55,23,10,31,80,191
2019,Spencer Dinwiddie,PG,25,BRK,68,4,1914,366,828,0.442,124,370,0.335,242,458,0.528,287,356,0.806,26,140,166,311,40,17,152,187,1143
2019,Stanley Johnson,SF,22,TOT,66,7,1208,171,440,0.389,62,215,0.288,109,225,0.484,50,64,0.781,34,183,217,88,60,14,81,114,454
2019,Stanley Johnson,SF,22,DET,48,7,961,133,349,0.381,51,181,0.282,82,168,0.488,41,51,0.804,25,150,175,60,48,13,55,92,358
2019,Stanley Johnson,SF,22,NOP,18,0,247,38,91,0.418,11,34,0.324,27,57,0.474,9,13,0.692,9,33,42,28,12,1,26,22,96
2019,Stephen Curry,PG,30,GSW,69,69,2331,632,1340,0.472,354,810,0.437,278,530,0.525,263,287,0.916,45,324,369,361,92,25,192,166,1881
2019,Sterling Brown,SG,23,MIL,58,7,1034,145,312,0.465,53,147,0.361,92,165,0.558,29,42,0.69,29,155,184,84,25,8,46,88,372
2019,Steven Adams,C,25,OKC,80,80,2669,481,809,0.595,0,2,0,481,807,0.596,146,292,0.5,391,369,760,124,117,76,135,204,1108
2019,Svi Mykhailiuk,SF,21,TOT,42,0,440,46,140,0.329,29,89,0.326,17,51,0.333,12,20,0.6,9,27,36,37,14,1,21,25,133
2019,Svi Mykhailiuk,SF,21,LAL,39,0,420,44,132,0.333,27,85,0.318,17,47,0.362,12,20,0.6,8,26,34,33,13,1,20,25,127
2019,Svi Mykhailiuk,SF,21,DET,3,0,20,2,8,0.25,2,4,0.5,0,4,0,0,0,,1,1,2,4,1,0,1,0,6
2019,T.J. Leaf,PF,21,IND,58,1,522,99,183,0.541,8,31,0.258,91,152,0.599,19,31,0.613,43,82,125,24,9,19,12,35,225
2019,T.J. McConnell,PG,26,PHI,76,3,1470,220,419,0.525,14,42,0.333,206,377,0.546,29,37,0.784,28,146,174,258,79,17,91,105,483
2019,T.J. Warren,SF,25,PHO,43,36,1360,297,611,0.486,77,180,0.428,220,431,0.51,101,124,0.815,31,143,174,64,51,29,52,119,772
2019,Tahjere McCall,SG,24,BRK,1,0,8,2,3,0.667,0,1,0,2,2,1,0,1,0,0,1,1,0,0,0,0,2,4
2019,Taj Gibson,PF,33,MIN,70,57,1686,304,537,0.566,11,34,0.324,293,503,0.583,134,177,0.757,172,286,458,84,53,39,73,186,753
2019,Taurean Prince,SF,24,ATL,55,47,1552,262,594,0.441,123,315,0.39,139,279,0.498,95,116,0.819,22,177,199,118,53,19,100,141,742
2019,Terrance Ferguson,SG,20,OKC,74,74,1931,185,431,0.429,106,290,0.366,79,141,0.56,37,51,0.725,33,108,141,72,40,16,47,231,513
2019,Terrence Jones,PF,27,HOU,2,0,5,1,4,0.25,0,2,0,1,2,0.5,0,1,0,0,4,4,0,0,0,1,1,2
2019,Terrence Ross,SG,27,ORL,81,0,2150,440,1027,0.428,217,566,0.383,223,461,0.484,126,144,0.875,27,253,280,135,72,29,90,119,1223
2019,Terry Rozier,PG,24,BOS,79,14,1791,258,666,0.387,119,337,0.353,139,329,0.422,73,93,0.785,32,275,307,231,68,21,68,101,708
2019,Thabo Sefolosha,SF,34,UTA,50,2,609,71,149,0.477,34,78,0.436,37,71,0.521,14,22,0.636,8,115,123,27,43,5,25,41,190
2019,Thaddeus Young,PF,30,IND,81,81,2489,443,841,0.527,51,146,0.349,392,695,0.564,87,135,0.644,192,331,523,204,123,36,123,194,1024
2019,Theo Pinson,SG,23,BRK,18,0,211,25,73,0.342,12,46,0.261,13,27,0.481,19,22,0.864,4,32,36,21,6,0,18,15,81
2019,Thomas Bryant,C,21,WAS,72,53,1496,309,502,0.616,33,99,0.333,276,403,0.685,107,137,0.781,113,341,454,92,25,67,60,126,758
2019,Thomas Welsh,C,22,DEN,11,0,36,7,13,0.538,3,7,0.429,4,6,0.667,1,2,0.5,0,4,4,5,0,0,1,3,18
2019,Thon Maker,C-PF,21,TOT,64,5,972,109,268,0.407,49,153,0.32,60,115,0.522,56,84,0.667,41,161,202,45,21,51,33,105,323
2019,Thon Maker,C,21,MIL,35,0,409,59,134,0.44,26,78,0.333,33,56,0.589,20,37,0.541,17,79,96,18,10,18,9,55,164
2019,Thon Maker,PF,21,DET,29,5,563,50,134,0.373,23,75,0.307,27,59,0.458,36,47,0.766,24,82,106,27,11,33,24,50,159
2019,Tim Frazier,PG,28,TOT,59,19,1120,116,261,0.444,37,101,0.366,79,160,0.494,41,54,0.759,41,127,168,248,30,5,76,112,310
2019,Tim Frazier,PG,28,NOP,47,17,909,88,195,0.451,27,77,0.351,61,118,0.517,32,41,0.78,32,105,137,206,25,4,60,93,235
2019,Tim Frazier,PG,28,MIL,12,2,211,28,66,0.424,10,24,0.417,18,42,0.429,9,13,0.692,9,22,31,42,5,1,16,19,75
2019,Tim Hardaway Jr.,SG,26,TOT,65,63,2057,390,993,0.393,162,477,0.34,228,516,0.442,232,276,0.841,33,189,222,159,54,8,105,141,1174
2019,Tim Hardaway Jr.,SG,26,NYK,46,46,1499,282,726,0.388,117,337,0.347,165,389,0.424,199,233,0.854,26,135,161,122,42,6,81,106,880
2019,Tim Hardaway Jr.,SG,26,DAL,19,17,558,108,267,0.404,45,140,0.321,63,127,0.496,33,43,0.767,7,54,61,37,12,2,24,35,294
2019,Timothé Luwawu-Cabarrot,SF,23,TOT,50,7,669,82,218,0.376,36,116,0.31,46,102,0.451,31,41,0.756,11,86,97,26,19,8,21,73,231
2019,Timothé Luwawu-Cabarrot,SF,23,OKC,21,1,123,13,43,0.302,5,22,0.227,8,21,0.381,4,6,0.667,4,14,18,4,4,1,5,14,35
2019,Timothé Luwawu-Cabarrot,SF,23,CHI,29,6,546,69,175,0.394,31,94,0.33,38,81,0.469,27,35,0.771,7,72,79,22,15,7,16,59,196
2019,Tobias Harris,PF,26,TOT,82,82,2847,611,1254,0.487,156,393,0.397,455,861,0.528,266,307,0.866,69,576,645,229,51,37,151,184,1644
2019,Tobias Harris,PF,26,LAC,55,55,1903,424,855,0.496,112,258,0.434,312,597,0.523,192,219,0.877,37,395,432,150,40,24,109,123,1152
2019,Tobias Harris,PF,26,PHI,27,27,944,187,399,0.469,44,135,0.326,143,264,0.542,74,88,0.841,32,181,213,79,11,13,42,61,492
2019,Tomáš Satoranský,PG,27,WAS,80,54,2164,257,530,0.485,64,162,0.395,193,368,0.524,131,160,0.819,82,197,279,399,82,13,120,172,709
2019,Tony Bradley,C,21,UTA,3,0,36,8,16,0.5,0,0,,8,16,0.5,1,2,0.5,9,6,15,1,2,2,3,6,17
2019,Tony Parker,PG,36,CHO,56,0,1003,213,463,0.46,13,51,0.255,200,412,0.485,91,124,0.734,14,69,83,207,21,7,75,53,530
2019,Tony Snell,SF,27,MIL,74,12,1304,163,361,0.452,81,204,0.397,82,157,0.522,37,42,0.881,29,128,157,68,26,18,23,90,444
2019,Torrey Craig,SF,28,DEN,75,37,1503,160,362,0.442,61,188,0.324,99,174,0.569,49,70,0.7,89,174,263,72,37,46,44,175,430
2019,Trae Young,PG,20,ATL,81,81,2503,525,1256,0.418,156,482,0.324,369,774,0.477,343,414,0.829,64,237,301,653,72,15,308,140,1549
2019,Treveon Graham,SG,25,BRK,35,21,715,64,191,0.335,38,128,0.297,26,63,0.413,18,22,0.818,23,84,107,34,13,7,17,68,184
2019,Trevon Duval,PG,20,MIL,3,0,6,2,3,0.667,1,1,1,1,2,0.5,0,0,,0,1,1,2,0,0,0,0,5
2019,Trevor Ariza,SF,33,TOT,69,69,2349,294,736,0.399,145,434,0.334,149,302,0.493,130,164,0.793,50,321,371,252,91,21,106,130,863
2019,Trevor Ariza,SF,33,PHO,26,26,884,86,227,0.379,50,139,0.36,36,88,0.409,36,43,0.837,16,129,145,87,38,8,39,44,258
2019,Trevor Ariza,SF,33,WAS,43,43,1465,208,509,0.409,95,295,0.322,113,214,0.528,94,121,0.777,34,192,226,165,53,13,67,86,605
2019,Trey Burke,PG,26,TOT,58,8,1125,236,548,0.431,56,159,0.352,180,389,0.463,103,124,0.831,28,71,99,159,33,7,49,58,631
2019,Trey Burke,PG,26,NYK,33,7,689,148,358,0.413,30,86,0.349,118,272,0.434,62,75,0.827,15,47,62,94,21,5,29,33,388
2019,Trey Burke,PG,26,DAL,25,1,436,88,190,0.463,26,73,0.356,62,117,0.53,41,49,0.837,13,24,37,65,12,2,20,25,243
2019,Trey Lyles,PF,23,DEN,64,2,1120,207,495,0.418,51,200,0.255,156,295,0.529,81,116,0.698,44,202,246,87,30,23,68,93,546
2019,Tristan Thompson,C,27,CLE,43,40,1198,201,380,0.529,0,0,,201,380,0.529,68,106,0.642,173,265,438,86,28,16,59,89,470
2019,Troy Brown Jr.,SF,19,WAS,52,10,730,97,234,0.415,22,69,0.319,75,165,0.455,32,47,0.681,35,110,145,80,21,5,30,56,248
2019,Troy Caupain,PG,23,ORL,4,0,16,4,8,0.5,2,3,0.667,2,5,0.4,0,0,,1,2,3,4,1,0,0,0,10
2019,Troy Daniels,SG,27,PHO,51,1,760,113,275,0.411,74,194,0.381,39,81,0.481,18,23,0.783,13,60,73,26,26,5,27,79,318
2019,Troy Williams,SF,24,SAC,21,0,312,44,98,0.449,14,44,0.318,30,54,0.556,9,15,0.6,12,47,59,11,10,8,9,37,111
2019,Tyler Cavanaugh,PF,24,UTA,11,0,39,3,10,0.3,1,5,0.2,2,5,0.4,2,2,1,3,5,8,1,0,0,1,3,9
2019,Tyler Davis,C,21,OKC,1,0,1,0,1,0,0,0,,0,1,0,0,0,,1,0,1,0,0,0,0,0,0
2019,Tyler Dorsey,SG,22,TOT,48,11,698,107,264,0.405,44,132,0.333,63,132,0.477,38,61,0.623,27,86,113,56,14,2,27,53,296
2019,Tyler Dorsey,SG,22,ATL,27,0,251,32,89,0.36,10,39,0.256,22,50,0.44,16,26,0.615,9,34,43,17,7,1,10,20,90
2019,Tyler Dorsey,SG,22,MEM,21,11,447,75,175,0.429,34,93,0.366,41,82,0.5,22,35,0.629,18,52,70,39,7,1,17,33,206
2019,Tyler Johnson,PG,26,TOT,57,22,1529,217,526,0.413,90,260,0.346,127,266,0.477,95,127,0.748,34,139,173,166,54,27,77,97,619
2019,Tyler Johnson,PG,26,MIA,44,10,1123,171,401,0.426,72,204,0.353,99,197,0.503,61,88,0.693,19,102,121,112,40,21,63,72,475
2019,Tyler Johnson,PG,26,PHO,13,12,406,46,125,0.368,18,56,0.321,28,69,0.406,34,39,0.872,15,37,52,54,14,6,14,25,144
2019,Tyler Lydon,PF,22,DEN,25,0,94,9,18,0.5,4,10,0.4,5,8,0.625,1,3,0.333,7,11,18,6,2,0,4,10,23
2019,Tyler Ulis,PG,23,CHI,1,0,1,0,0,,0,0,,0,0,,0,0,,0,0,0,0,0,0,0,0,0
2019,Tyler Zeller,C,29,TOT,6,1,93,16,30,0.533,0,1,0,16,29,0.552,14,18,0.778,11,13,24,4,1,3,4,20,46
2019,Tyler Zeller,C,29,ATL,2,0,11,0,2,0,0,1,0,0,1,0,0,0,,2,4,6,1,0,0,0,4,0
2019,Tyler Zeller,C,29,MEM,4,1,82,16,28,0.571,0,0,,16,28,0.571,14,18,0.778,9,9,18,3,1,3,4,16,46
2019,Tyreke Evans,SG,29,IND,69,18,1402,257,660,0.389,77,216,0.356,180,444,0.405,115,160,0.719,33,168,201,166,58,18,118,117,706
2019,Tyrone Wallace,PG,24,LAC,62,0,628,92,217,0.424,4,19,0.211,88,198,0.444,30,57,0.526,20,81,101,42,21,7,36,83,218
2019,Tyson Chandler,C,36,TOT,55,6,875,61,99,0.616,0,1,0,61,98,0.622,51,87,0.586,92,215,307,37,21,23,42,110,173
2019,Tyson Chandler,C,36,PHO,7,0,89,8,12,0.667,0,0,,8,12,0.667,10,18,0.556,7,32,39,6,2,1,7,21,26
2019,Tyson Chandler,C,36,LAL,48,6,786,53,87,0.609,0,1,0,53,86,0.616,41,69,0.594,85,183,268,31,19,22,35,89,147
2019,Tyus Jones,PG,22,MIN,68,23,1560,185,446,0.415,40,126,0.317,145,320,0.453,58,69,0.841,23,111,134,327,81,5,47,78,468
2019,Udonis Haslem,C,38,MIA,10,1,74,11,33,0.333,0,12,0,11,21,0.524,3,4,0.75,3,24,27,2,0,0,3,9,25
2019,Victor Oladipo,SG,26,IND,36,36,1147,249,588,0.423,74,216,0.343,175,372,0.47,103,141,0.73,21,181,202,186,60,11,82,72,675
2019,Vince Carter,PF,42,ATL,76,9,1330,196,468,0.419,123,316,0.389,73,152,0.48,47,66,0.712,31,163,194,87,44,27,48,141,562
2019,Vince Edwards,SF,22,HOU,2,0,16,1,4,0.25,1,4,0.25,0,0,,0,0,,1,1,2,0,0,0,0,0,3
2019,Wade Baldwin,PG,22,POR,16,0,94,10,33,0.303,2,9,0.222,8,24,0.333,8,11,0.727,2,13,15,12,1,2,14,11,30
2019,Walt Lemon Jr.,PG,26,CHI,6,3,167,38,87,0.437,2,5,0.4,36,82,0.439,8,11,0.727,4,23,27,30,11,1,10,14,86
2019,Wayne Ellington,SG,31,TOT,53,38,1297,184,457,0.403,138,372,0.371,46,85,0.541,39,49,0.796,14,93,107,72,54,6,40,92,545
2019,Wayne Ellington,SG,31,MIA,25,12,533,69,184,0.375,57,155,0.368,12,29,0.414,14,16,0.875,6,41,47,29,24,3,14,40,209
2019,Wayne Ellington,SG,31,DET,28,26,764,115,273,0.421,81,217,0.373,34,56,0.607,25,33,0.758,8,52,60,43,30,3,26,52,336
2019,Wayne Selden,SG,24,TOT,75,13,1439,196,483,0.406,55,174,0.316,141,309,0.456,67,92,0.728,37,143,180,109,33,13,79,131,514
2019,Wayne Selden,SG,24,MEM,32,0,455,65,161,0.404,20,63,0.317,45,98,0.459,22,29,0.759,16,28,44,36,10,6,23,48,172
2019,Wayne Selden,SG,24,CHI,43,13,984,131,322,0.407,35,111,0.315,96,211,0.455,45,63,0.714,21,115,136,73,23,7,56,83,342
2019,Wendell Carter Jr.,C,19,CHI,44,44,1110,180,371,0.485,6,32,0.188,174,339,0.513,89,112,0.795,87,220,307,78,26,58,65,152,455
2019,Wes Iwundu,SF,24,ORL,68,13,1233,113,274,0.412,29,79,0.367,84,195,0.431,84,103,0.816,37,147,184,73,28,22,44,123,339
2019,Wesley Johnson,SF,31,TOT,38,13,534,45,128,0.352,25,76,0.329,20,52,0.385,13,19,0.684,12,60,72,23,14,12,18,63,128
2019,Wesley Johnson,SF,31,NOP,26,13,377,35,88,0.398,19,50,0.38,16,38,0.421,6,9,0.667,10,44,54,16,12,7,12,45,95
2019,Wesley Johnson,SF,31,WAS,12,0,157,10,40,0.25,6,26,0.231,4,14,0.286,7,10,0.7,2,16,18,7,2,5,6,18,33
2019,Wesley Matthews,SF-SG,32,TOT,69,68,2091,279,698,0.4,150,403,0.372,129,295,0.437,132,163,0.81,32,138,170,160,54,17,91,160,840
2019,Wesley Matthews,SF,32,DAL,44,44,1312,194,469,0.414,100,263,0.38,94,206,0.456,87,110,0.791,20,82,102,100,33,12,58,102,575
2019,Wesley Matthews,SG,32,NYK,2,1,54,4,19,0.211,2,10,0.2,2,9,0.222,4,5,0.8,1,2,3,5,1,1,2,2,14
2019,Wesley Matthews,SG,32,IND,23,23,725,81,210,0.386,48,130,0.369,33,80,0.413,41,48,0.854,11,54,65,55,20,4,31,56,251
2019,Will Barton,SF,28,DEN,43,38,1189,185,460,0.402,67,196,0.342,118,264,0.447,57,74,0.77,32,167,199,124,18,22,65,82,494
2019,Willie Cauley-Stein,C,25,SAC,81,81,2213,412,741,0.556,1,2,0.5,411,739,0.556,140,254,0.551,181,497,678,194,96,51,84,227,965
2019,Willy Hernangómez,C,24,CHO,58,3,812,153,295,0.519,15,39,0.385,138,256,0.539,100,144,0.694,117,194,311,60,16,20,58,98,421
2019,Wilson Chandler,PF-SF,31,TOT,51,33,1177,114,273,0.418,59,158,0.373,55,115,0.478,18,25,0.72,48,167,215,82,25,21,46,123,305
2019,Wilson Chandler,PF,31,PHI,36,32,951,91,207,0.44,46,118,0.39,45,89,0.506,13,18,0.722,44,124,168,72,22,18,39,94,241
2019,Wilson Chandler,SF,31,LAC,15,1,226,23,66,0.348,13,40,0.325,10,26,0.385,5,7,0.714,4,43,47,10,3,3,7,29,64
2019,Yante Maten,PF,22,MIA,2,0,13,1,4,0.25,0,1,0,1,3,0.333,0,0,,1,2,3,0,1,0,0,0,2
2019,Yogi Ferrell,PG,25,SAC,71,3,1067,153,352,0.435,54,149,0.362,99,203,0.488,60,67,0.896,13,96,109,137,36,4,40,64,420
2019,Yuta Watanabe,SF,24,MEM,15,0,174,15,51,0.294,2,16,0.125,13,35,0.371,7,10,0.7,4,27,31,8,4,1,6,11,39
2019,Zach Collins,C,21,POR,77,0,1356,189,400,0.473,40,121,0.331,149,279,0.534,94,126,0.746,109,215,324,71,25,66,77,174,512
2019,Zach LaVine,SG,23,CHI,63,62,2171,530,1135,0.467,120,321,0.374,410,814,0.504,312,375,0.832,40,254,294,283,60,26,215,140,1492
2019,Zach Lofton,SG,26,DET,1,0,4,0,1,0,0,1,0,0,0,,0,0,,0,0,0,0,1,0,1,0,0
2019,Zaza Pachulia,C,34,DET,68,3,878,85,193,0.44,0,4,0,85,189,0.45,97,124,0.782,99,166,265,91,31,17,57,151,267
2019,Zhaire Smith,SG,19,PHI,6,2,111,14,34,0.412,6,16,0.375,8,18,0.444,6,8,0.75,3,10,13,10,2,2,6,8,40
2019,Zhou Qi,PF,23,HOU,1,0,1,1,1,1,0,0,,1,1,1,0,0,,0,0,0,0,0,0,0,0,2
2020,Aaron Gordon,PF,24,ORL,62,62,2017,335,767,0.437,73,237,0.308,262,530,0.494,151,224,0.674,107,368,475,228,51,39,100,125,894
2020,Aaron Holiday,PG,23,IND,66,33,1617,233,563,0.414,87,221,0.394,146,342,0.427,74,87,0.851,22,134,156,225,55,16,88,120,627
2020,Abdel Nader,SF,26,OKC,55,6,867,123,263,0.468,48,128,0.375,75,135,0.556,51,66,0.773,14,86,100,38,23,20,43,78,345
2020,Adam Mokoka,SF,21,CHI,11,0,112,12,28,0.429,6,15,0.4,6,13,0.462,2,4,0.5,7,3,10,4,4,0,2,17,32
2020,Admiral Schofield,PF,22,WAS,33,2,368,35,92,0.38,19,61,0.311,16,31,0.516,10,15,0.667,7,40,47,15,8,4,7,50,99
2020,Al Horford,C,33,PHI,67,61,2025,319,709,0.45,99,283,0.35,220,426,0.516,61,80,0.763,103,353,456,270,52,61,80,142,798
2020,Al-Farouq Aminu,PF,29,ORL,18,2,380,25,86,0.291,9,36,0.25,16,50,0.32,19,29,0.655,24,63,87,21,18,8,17,27,78
2020,Alec Burks,SF-SG,28,TOT,66,19,1754,321,768,0.418,116,301,0.385,205,467,0.439,235,265,0.887,48,234,282,189,62,17,91,128,993
2020,Alec Burks,SF,28,GSW,48,18,1390,244,601,0.406,84,224,0.375,160,377,0.424,201,224,0.897,37,189,226,151,50,17,76,107,773
2020,Alec Burks,SG,28,PHI,18,1,364,77,167,0.461,32,77,0.416,45,90,0.5,34,41,0.829,11,45,56,38,12,0,15,21,220
2020,Alen Smailagić,C,19,GSW,14,0,139,20,40,0.5,3,13,0.231,17,27,0.63,16,19,0.842,10,17,27,13,3,4,11,14,59
2020,Alex Caruso,PG,25,LAL,64,2,1175,120,291,0.412,40,120,0.333,80,171,0.468,69,94,0.734,17,106,123,124,70,18,53,98,349
2020,Alex Len,C,26,TOT,55,12,970,177,319,0.555,16,59,0.271,161,260,0.619,68,105,0.648,100,221,321,50,23,48,55,127,438
2020,Alex Len,C,26,ATL,40,9,745,142,260,0.546,14,56,0.25,128,204,0.627,51,81,0.63,69,161,230,42,20,33,39,93,349
2020,Alex Len,C,26,SAC,15,3,225,35,59,0.593,2,3,0.667,33,56,0.589,17,24,0.708,31,60,91,8,3,15,16,34,89
2020,Alfonzo McKinnie,SF,27,CLE,40,1,593,73,171,0.427,14,65,0.215,59,106,0.557,22,31,0.71,37,76,113,14,23,8,26,72,182
2020,Alize Johnson,PF,23,IND,17,1,118,12,29,0.414,3,8,0.375,9,21,0.429,7,10,0.7,16,32,48,7,3,2,7,12,34
2020,Allen Crabbe,SG-SF,27,TOT,37,1,653,63,177,0.356,36,119,0.303,27,58,0.466,10,14,0.714,11,66,77,33,15,4,17,47,172
2020,Allen Crabbe,SG,27,ATL,28,1,522,52,143,0.364,30,93,0.323,22,50,0.44,9,12,0.75,10,55,65,28,15,4,12,36,143
2020,Allen Crabbe,SF,27,MIN,9,0,131,11,34,0.324,6,26,0.231,5,8,0.625,1,2,0.5,1,11,12,5,0,0,5,11,29
2020,Allonzo Trier,SG,24,NYK,24,1,291,51,106,0.481,19,53,0.358,32,53,0.604,34,43,0.791,6,23,29,28,3,4,22,29,155
2020,Amile Jefferson,PF,26,ORL,18,0,74,5,14,0.357,0,0,,5,14,0.357,5,14,0.357,10,13,23,4,1,3,3,7,15
2020,Amir Coffey,SG,22,LAC,18,1,159,23,54,0.426,6,19,0.316,17,35,0.486,6,11,0.545,4,12,16,14,5,2,8,20,58
2020,Andre Drummond,C,26,TOT,57,56,1879,418,784,0.533,5,35,0.143,413,749,0.551,169,294,0.575,250,614,864,152,109,93,203,201,1010
2020,Andre Drummond,C,26,DET,49,48,1654,360,679,0.53,1,21,0.048,359,658,0.546,149,255,0.584,226,549,775,138,97,82,174,176,870
2020,Andre Drummond,C,26,CLE,8,8,225,58,105,0.552,4,14,0.286,54,91,0.593,20,39,0.513,24,65,89,14,12,11,29,25,140
2020,Andre Iguodala,SF,36,MIA,21,0,418,38,88,0.432,14,47,0.298,24,41,0.585,6,15,0.4,17,61,78,51,14,21,26,35,96
2020,Andre Roberson,SF,28,OKC,7,0,87,8,29,0.276,3,14,0.214,5,15,0.333,1,2,0.5,7,20,27,4,1,3,2,13,20
2020,Andrew Wiggins,SF,24,TOT,54,54,1858,437,978,0.447,111,334,0.332,326,644,0.506,190,268,0.709,66,208,274,198,45,53,132,127,1175
2020,Andrew Wiggins,SF,24,MIN,42,42,1455,351,790,0.444,91,275,0.331,260,515,0.505,149,207,0.72,48,171,219,155,29,36,107,101,942
2020,Andrew Wiggins,SF,24,GSW,12,12,403,86,188,0.457,20,59,0.339,66,129,0.512,41,61,0.672,18,37,55,43,16,17,25,26,233
2020,Anfernee Simons,SG,20,POR,70,4,1449,214,536,0.399,75,226,0.332,139,310,0.448,76,92,0.826,25,127,152,97,26,10,61,135,579
2020,Ante Žižić,C,23,CLE,22,0,221,41,72,0.569,0,0,,41,72,0.569,14,19,0.737,18,48,66,6,7,5,10,27,96
2020,Anthony Davis,PF,26,LAL,62,62,2131,551,1096,0.503,72,218,0.33,479,878,0.546,444,525,0.846,142,435,577,200,91,143,154,156,1618
2020,Anthony Tolliver,PF,34,TOT,55,13,872,65,182,0.357,49,145,0.338,16,37,0.432,21,29,0.724,34,120,154,42,19,11,34,74,200
2020,Anthony Tolliver,PF,34,POR,33,9,554,43,117,0.368,30,89,0.337,13,28,0.464,13,19,0.684,27,83,110,29,8,9,21,54,129
2020,Anthony Tolliver,PF,34,SAC,9,0,82,3,17,0.176,2,15,0.133,1,2,0.5,1,2,0.5,2,9,11,3,4,1,4,6,9
2020,Anthony Tolliver,PF,34,MEM,13,4,236,19,48,0.396,17,41,0.415,2,7,0.286,7,8,0.875,5,28,33,10,7,1,9,14,62
2020,Antonius Cleveland,SG,25,DAL,11,0,46,4,14,0.286,0,3,0,4,11,0.364,3,5,0.6,2,5,7,1,1,3,2,8,11
2020,Anžejs Pasečņiks,C,24,WAS,27,0,437,61,116,0.526,0,3,0,61,113,0.54,34,58,0.586,42,65,107,18,9,12,24,75,156
2020,Aron Baynes,C,33,PHO,42,28,934,183,381,0.48,59,168,0.351,124,213,0.582,56,75,0.747,71,166,237,67,10,23,50,141,481
2020,Austin Rivers,SG,27,HOU,68,4,1594,211,501,0.421,96,270,0.356,115,231,0.498,78,111,0.703,27,148,175,113,49,10,50,129,596
2020,Avery Bradley,SG,29,LAL,49,44,1186,170,383,0.444,63,173,0.364,107,210,0.51,20,24,0.833,18,97,115,63,43,5,47,110,423
2020,B.J. Johnson,SF,24,ORL,10,0,83,9,32,0.281,3,9,0.333,6,23,0.261,9,10,0.9,3,12,15,3,3,0,6,3,30
2020,Bam Adebayo,PF,22,MIA,72,72,2417,440,790,0.557,2,14,0.143,438,776,0.564,264,382,0.691,176,559,735,368,82,93,204,182,1146
2020,Ben McLemore,SF,26,HOU,71,23,1619,242,545,0.444,181,452,0.4,61,93,0.656,50,67,0.746,21,136,157,58,45,16,50,155,715
2020,Ben Simmons,PG,23,PHI,57,57,2017,375,647,0.58,2,7,0.286,373,640,0.583,185,298,0.621,113,331,444,455,119,33,200,186,937
2020,Bismack Biyombo,C,27,CHO,53,29,1029,151,278,0.543,0,0,,151,278,0.543,91,151,0.603,120,188,308,50,10,49,48,116,393
2020,Blake Griffin,PF,30,DET,18,18,512,88,250,0.352,27,111,0.243,61,139,0.439,76,98,0.776,17,67,84,59,7,7,40,27,279
2020,Boban Marjanović,C,31,DAL,44,5,422,121,211,0.573,4,17,0.235,117,194,0.603,43,57,0.754,66,131,197,20,8,10,30,56,289
2020,Bobby Portis,PF,24,NYK,66,5,1393,265,589,0.45,67,187,0.358,198,402,0.493,71,93,0.763,80,258,338,98,32,18,73,110,668
2020,Bogdan Bogdanović,SG,27,SAC,61,28,1766,337,766,0.44,164,441,0.372,173,325,0.532,86,116,0.741,26,181,207,207,64,15,102,133,924
2020,Bojan Bogdanović,SF,30,UTA,63,63,2083,418,935,0.447,189,457,0.414,229,478,0.479,250,277,0.903,39,220,259,131,34,7,159,110,1275
2020,Bol Bol,PF,20,DEN,7,0,87,14,28,0.5,4,9,0.444,10,19,0.526,8,10,0.8,5,14,19,6,2,6,10,11,40
2020,Brad Wanamaker,PG,30,BOS,71,1,1369,162,362,0.448,37,102,0.363,125,260,0.481,126,136,0.926,22,122,144,179,61,14,76,133,487
2020,Bradley Beal,SG,26,WAS,57,57,2053,593,1303,0.455,170,481,0.353,423,822,0.515,385,457,0.842,52,190,242,347,71,23,194,126,1741
2020,Brandon Clarke,PF,23,MEM,58,4,1300,296,479,0.618,23,64,0.359,273,415,0.658,85,112,0.759,92,253,345,81,32,48,55,100,700
2020,Brandon Goodwin,PG,24,ATL,34,1,430,76,190,0.4,26,87,0.299,50,103,0.485,28,30,0.933,11,61,72,51,12,4,29,43,206
2020,Brandon Ingram,PF,22,NOP,62,62,2104,507,1096,0.463,150,384,0.391,357,712,0.501,313,368,0.851,51,329,380,259,61,38,189,179,1477
2020,Brandon Knight,SG-PG,28,TOT,25,3,462,59,167,0.353,45,131,0.344,14,36,0.389,20,34,0.588,4,37,41,69,10,3,38,40,183
2020,Brandon Knight,SG,28,CLE,16,0,241,28,86,0.326,19,64,0.297,9,22,0.409,4,13,0.308,3,17,20,31,5,2,16,20,79
2020,Brandon Knight,PG,28,DET,9,3,221,31,81,0.383,26,67,0.388,5,14,0.357,16,21,0.762,1,20,21,38,5,1,22,20,104
2020,Brian Bowen,SF,21,IND,6,1,31,3,10,0.3,0,2,0,3,8,0.375,0,0,,1,6,7,0,0,1,1,3,6
2020,Brook Lopez,C,31,MIL,68,67,1817,292,671,0.435,102,325,0.314,190,346,0.549,127,152,0.836,58,254,312,99,46,163,70,163,813
2020,Bruce Brown,PG,23,DET,58,43,1634,198,447,0.443,33,96,0.344,165,351,0.47,88,119,0.739,61,213,274,230,63,29,100,162,517
2020,Bruno Caboclo,C,24,TOT,30,0,244,38,89,0.427,6,33,0.182,32,56,0.571,8,9,0.889,23,37,60,12,15,17,13,31,90
2020,Bruno Caboclo,C,24,MEM,22,0,192,28,69,0.406,4,25,0.16,24,44,0.545,2,3,0.667,17,27,44,10,10,12,7,23,62
2020,Bruno Caboclo,C,24,HOU,8,0,52,10,20,0.5,2,8,0.25,8,12,0.667,6,6,1,6,10,16,2,5,5,6,8,28
2020,Bruno Fernando,C,21,ATL,56,13,713,103,199,0.518,5,37,0.135,98,162,0.605,29,51,0.569,67,131,198,49,18,17,42,107,240
2020,Bryn Forbes,SG,26,SAS,63,62,1579,242,581,0.417,148,381,0.388,94,200,0.47,75,90,0.833,12,114,126,108,33,0,57,113,707
2020,Buddy Hield,SG,27,SAC,72,44,2216,498,1162,0.429,271,688,0.394,227,474,0.479,115,136,0.846,57,271,328,213,66,17,168,165,1382
2020,C.J. Miles,SF,32,WAS,10,0,161,19,59,0.322,11,35,0.314,8,24,0.333,15,20,0.75,4,8,12,12,10,4,4,14,64
2020,Caleb Martin,SF,24,CHO,18,1,317,37,84,0.44,20,37,0.541,17,47,0.362,17,21,0.81,10,28,38,23,12,7,15,32,111
2020,Caleb Swanigan,PF-C,22,TOT,27,1,288,28,47,0.596,0,2,0,28,45,0.622,9,17,0.529,27,73,100,31,3,7,37,62,65
2020,Caleb Swanigan,C,22,SAC,7,0,23,2,4,0.5,0,0,,2,4,0.5,1,2,0.5,2,5,7,2,1,2,6,8,5
2020,Caleb Swanigan,PF,22,POR,20,1,265,26,43,0.605,0,2,0,26,41,0.634,8,15,0.533,25,68,93,29,2,5,31,54,60
2020,Cam Reddish,SF,20,ATL,58,34,1551,213,554,0.384,83,250,0.332,130,304,0.428,101,126,0.802,35,181,216,87,62,28,96,132,610
2020,Cameron Johnson,PF,23,PHO,57,9,1255,176,405,0.435,106,272,0.39,70,133,0.526,46,57,0.807,49,138,187,69,36,20,32,88,504
2020,Cameron Payne,SG,25,PHO,8,0,183,33,68,0.485,15,29,0.517,18,39,0.462,6,7,0.857,4,27,31,24,8,2,11,20,87
2020,Caris LeVert,SG,25,BRK,45,31,1330,311,732,0.425,80,220,0.364,231,512,0.451,140,197,0.711,49,140,189,199,53,10,118,81,842
2020,Carmelo Anthony,PF,35,POR,58,58,1902,336,782,0.43,87,226,0.385,249,556,0.448,136,161,0.845,71,297,368,85,49,27,100,171,895
2020,Carsen Edwards,SG,21,BOS,37,0,351,42,128,0.328,24,76,0.316,18,52,0.346,13,19,0.684,6,41,47,24,12,4,15,34,121
2020,Cedi Osman,SF,24,CLE,65,65,1910,266,609,0.437,123,321,0.383,143,288,0.497,63,94,0.67,39,192,231,154,54,16,91,160,718
2020,Chandler Hutchison,SF,23,CHI,28,10,527,80,175,0.457,12,38,0.316,68,137,0.496,46,78,0.59,18,90,108,26,27,7,27,47,218
2020,Chandler Parsons,PF,31,ATL,5,0,54,5,18,0.278,4,14,0.286,1,4,0.25,0,0,,1,6,7,3,4,1,3,3,14
2020,Charlie Brown Jr.,SG,22,ATL,10,0,40,6,19,0.316,3,9,0.333,3,10,0.3,5,5,1,2,2,4,2,2,2,3,3,20
2020,Chasson Randle,PG,26,GSW,3,0,40,0,4,0,0,2,0,0,2,0,5,6,0.833,0,2,2,5,2,0,0,3,5
2020,Cheick Diallo,C,23,PHO,47,2,479,92,142,0.648,1,3,0.333,91,139,0.655,34,39,0.872,30,101,131,22,11,12,32,55,219
2020,Chimezie Metu,C,22,SAS,18,0,105,24,42,0.571,0,2,0,24,40,0.6,10,13,0.769,12,21,33,10,3,6,10,7,58
2020,Chris Boucher,C,27,TOR,62,0,819,141,299,0.472,38,118,0.322,103,181,0.569,91,116,0.784,107,170,277,26,22,61,28,114,411
2020,Chris Chiozza,PG,24,TOT,28,2,401,55,140,0.393,27,72,0.375,28,68,0.412,5,5,1,9,44,53,83,21,4,32,37,142
2020,Chris Chiozza,PG,24,WAS,10,0,123,10,34,0.294,7,16,0.438,3,18,0.167,0,0,,0,15,15,28,10,2,9,12,27
2020,Chris Chiozza,PG,24,BRK,18,2,278,45,106,0.425,20,56,0.357,25,50,0.5,5,5,1,9,29,38,55,11,2,23,25,115
2020,Chris Clemons,SG,22,HOU,33,0,291,57,142,0.401,37,107,0.346,20,35,0.571,10,11,0.909,4,26,30,27,9,6,19,26,161
2020,Chris Paul,PG,34,OKC,70,70,2208,434,887,0.489,111,304,0.365,323,583,0.554,253,279,0.907,26,323,349,472,111,11,161,158,1232
2020,Chris Silva,PF,23,MIA,44,0,346,48,78,0.615,0,3,0,48,75,0.64,37,55,0.673,60,66,126,23,9,21,32,85,133
2020,Christian Wood,PF,24,DET,62,12,1325,288,508,0.567,54,140,0.386,234,368,0.636,180,242,0.744,104,286,390,60,34,54,84,98,810
2020,CJ McCollum,SG,28,POR,70,70,2556,611,1356,0.451,194,512,0.379,417,844,0.494,140,185,0.757,46,251,297,310,54,42,127,183,1556
2020,Clint Capela,C,25,HOU,39,39,1279,244,388,0.629,0,0,,244,388,0.629,55,104,0.529,168,369,537,48,33,72,63,102,543
2020,Coby White,PG,19,CHI,65,1,1674,312,792,0.394,133,376,0.354,179,416,0.43,102,129,0.791,28,202,230,175,49,6,109,117,859
2020,Cody Martin,SF,24,CHO,48,3,903,89,207,0.43,18,77,0.234,71,130,0.546,42,65,0.646,38,120,158,95,39,9,44,78,238
2020,Cody Zeller,C,27,CHO,58,39,1341,251,479,0.524,18,75,0.24,233,404,0.577,122,179,0.682,160,251,411,88,40,25,75,140,642
2020,Collin Sexton,PG,21,CLE,65,65,2143,513,1086,0.472,97,255,0.38,416,831,0.501,226,267,0.846,61,143,204,192,65,7,158,142,1349
2020,Corey Brewer,PF,33,SAC,5,0,33,2,4,0.5,0,1,0,2,3,0.667,1,3,0.333,2,6,8,2,4,0,2,7,5
2020,Cory Joseph,PG,28,SAC,72,26,1759,171,412,0.415,56,159,0.352,115,253,0.455,60,70,0.857,44,144,188,251,53,21,80,133,458
2020,Courtney Lee,SG,34,DAL,24,9,345,40,82,0.488,21,47,0.447,19,35,0.543,6,7,0.857,7,25,32,12,18,6,11,33,107
2020,Cristiano Felício,C,27,CHI,22,0,386,34,54,0.63,0,2,0,34,52,0.654,18,23,0.783,55,47,102,16,10,2,18,34,86
2020,D.J. Augustin,PG,32,ORL,57,13,1420,184,461,0.399,70,201,0.348,114,260,0.438,161,181,0.89,22,100,122,262,34,1,86,72,599
2020,D.J. Wilson,PF,23,MIL,37,1,363,52,132,0.394,18,73,0.247,34,59,0.576,11,18,0.611,12,80,92,25,3,5,19,33,133
2020,D'Angelo Russell,PG,23,TOT,45,45,1452,360,846,0.426,158,431,0.367,202,415,0.487,161,199,0.809,17,160,177,285,48,13,147,86,1039
2020,D'Angelo Russell,PG,23,GSW,33,33,1060,273,635,0.43,120,321,0.374,153,314,0.487,113,144,0.785,14,108,122,206,31,9,101,64,779
2020,D'Angelo Russell,PG,23,MIN,12,12,392,87,211,0.412,38,110,0.345,49,101,0.485,48,55,0.873,3,52,55,79,17,4,46,22,260
2020,Damian Jones,C,24,ATL,55,27,887,121,178,0.68,2,9,0.222,119,169,0.704,62,84,0.738,74,132,206,35,26,40,28,149,306
2020,Damian Lillard,PG,29,POR,66,66,2474,624,1349,0.463,270,674,0.401,354,675,0.524,460,518,0.888,33,251,284,530,70,22,194,114,1978
2020,Damion Lee,SG,27,GSW,49,36,1423,213,511,0.417,85,239,0.356,128,272,0.471,110,126,0.873,32,207,239,133,50,6,67,116,621
2020,Damyean Dotson,SG,25,NYK,48,0,836,120,290,0.414,59,163,0.362,61,127,0.48,22,33,0.667,10,81,91,57,23,4,21,44,321
2020,Daniel Gafford,C,21,CHI,43,7,609,94,134,0.701,0,0,,94,134,0.701,32,60,0.533,52,54,106,21,13,56,29,98,220
2020,Daniel Theis,C,27,BOS,65,64,1566,241,426,0.566,32,96,0.333,209,330,0.633,87,114,0.763,140,286,426,111,37,84,54,219,601
2020,Danilo Gallinari,PF,31,OKC,62,62,1834,358,817,0.438,178,439,0.405,180,378,0.476,266,298,0.893,34,288,322,119,42,5,76,75,1160
2020,Danny Green,SG,32,LAL,68,68,1687,197,474,0.416,120,327,0.367,77,147,0.524,33,48,0.688,51,174,225,91,85,32,63,136,547
2020,Dante Exum,SG,24,TOT,35,1,485,56,119,0.471,15,43,0.349,41,76,0.539,32,43,0.744,12,55,67,40,13,8,31,38,159
2020,Dante Exum,SG,24,UTA,11,0,83,10,23,0.435,2,6,0.333,8,17,0.471,2,2,1,3,9,12,7,1,2,10,8,24
2020,Dante Exum,SG,24,CLE,24,1,402,46,96,0.479,13,37,0.351,33,59,0.559,30,41,0.732,9,46,55,33,12,6,21,30,135
2020,Danuel House Jr.,SF,26,HOU,63,52,1913,230,539,0.427,129,355,0.363,101,184,0.549,73,90,0.811,57,210,267,85,67,34,54,132,662
2020,DaQuan Jeffries,SG,22,SAC,13,0,141,20,40,0.5,5,18,0.278,15,22,0.682,5,6,0.833,3,15,18,7,4,1,2,19,50
2020,Dario Šarić,PF,25,PHO,66,51,1632,256,538,0.476,84,235,0.357,172,303,0.568,108,128,0.844,100,306,406,123,37,16,88,156,704
2020,Darius Bazley,PF,19,OKC,61,9,1130,125,317,0.394,49,141,0.348,76,176,0.432,43,62,0.694,30,216,246,41,23,41,45,55,342
2020,Darius Garland,SG,20,CLE,59,59,1824,280,699,0.401,105,296,0.355,175,403,0.434,63,72,0.875,27,84,111,229,42,4,151,92,728
2020,Daryl Macon,PG,24,MIA,4,0,14,1,3,0.333,1,2,0.5,0,1,0,0,0,,0,0,0,1,0,0,2,1,3
2020,David Nwaba,SF,27,BRK,20,0,268,37,71,0.521,12,28,0.429,25,43,0.581,18,27,0.667,8,37,45,8,11,12,8,32,104
2020,Dāvis Bertāns,PF,27,WAS,54,4,1583,265,610,0.434,200,472,0.424,65,138,0.471,104,122,0.852,35,210,245,92,37,33,59,139,834
2020,De'Aaron Fox,PG,22,SAC,51,49,1634,391,815,0.48,54,185,0.292,337,630,0.535,241,342,0.705,35,161,196,348,74,25,158,145,1077
2020,De'Andre Hunter,SF,22,ATL,63,62,2018,280,683,0.41,108,304,0.355,172,379,0.454,110,144,0.764,44,242,286,112,44,18,103,182,778
2020,De'Anthony Melton,PG,21,MEM,60,8,1167,161,401,0.401,40,140,0.286,121,261,0.464,93,121,0.769,43,177,220,175,77,20,84,109,455
2020,Dean Wade,PF,23,CLE,12,0,71,9,13,0.692,2,4,0.5,7,9,0.778,0,1,0,3,16,19,2,2,4,3,8,20
2020,Deandre Ayton,C,21,PHO,38,32,1236,310,568,0.546,3,13,0.231,307,555,0.553,67,89,0.753,147,289,436,72,26,58,80,117,690
2020,DeAndre Jordan,C,31,BRK,56,6,1234,191,287,0.666,0,0,,191,287,0.666,83,122,0.68,141,420,561,105,18,52,74,114,465
2020,DeAndre' Bembry,SG,25,ATL,43,4,915,104,228,0.456,15,65,0.231,89,163,0.546,26,48,0.542,34,118,152,81,55,19,60,84,249
2020,Dejounte Murray,PG,23,SAS,66,58,1687,294,637,0.462,41,111,0.369,253,526,0.481,91,114,0.798,69,314,383,271,111,17,125,143,720
2020,Delon Wright,PG,27,DAL,73,5,1570,190,411,0.462,47,127,0.37,143,284,0.504,77,100,0.77,70,210,280,244,85,22,73,93,504
2020,DeMar DeRozan,SF,30,SAS,68,68,2316,557,1049,0.531,9,35,0.257,548,1014,0.54,381,451,0.845,44,331,375,380,70,20,164,180,1504
2020,DeMarre Carroll,SF-C,33,TOT,24,0,290,25,66,0.379,8,33,0.242,17,33,0.515,29,42,0.69,12,43,55,25,8,5,17,32,87
2020,DeMarre Carroll,SF,33,SAS,15,0,135,9,29,0.31,3,13,0.231,6,16,0.375,12,20,0.6,7,24,31,11,2,2,10,20,33
2020,DeMarre Carroll,C,33,HOU,9,0,155,16,37,0.432,5,20,0.25,11,17,0.647,17,22,0.773,5,19,24,14,6,3,7,12,54
2020,Dennis Schröder,PG,26,OKC,65,2,1999,453,965,0.469,125,325,0.385,328,640,0.513,198,236,0.839,19,217,236,262,45,14,166,146,1229
2020,Dennis Smith Jr.,PG,22,NYK,34,3,537,72,211,0.341,16,54,0.296,56,157,0.357,27,53,0.509,21,57,78,98,28,8,58,65,187
2020,Denzel Valentine,SF,26,CHI,36,5,488,97,237,0.409,46,137,0.336,51,100,0.51,6,8,0.75,9,65,74,43,26,6,26,51,246
2020,Deonte Burton,SF,26,OKC,39,0,356,43,125,0.344,10,53,0.189,33,72,0.458,8,14,0.571,7,50,57,17,7,10,19,34,104
2020,Derrick Favors,C,28,NOP,51,49,1243,209,339,0.617,1,7,0.143,208,332,0.627,40,71,0.563,163,338,501,81,30,46,55,107,459
2020,Derrick Jones Jr.,SF,22,MIA,59,16,1375,184,349,0.527,37,132,0.28,147,217,0.677,95,123,0.772,66,167,233,62,58,38,30,130,500
2020,Derrick Rose,PG,31,DET,50,15,1298,369,753,0.49,45,147,0.306,324,606,0.535,121,139,0.871,27,94,121,278,40,16,126,49,904
2020,Derrick Walton,PG,24,TOT,26,1,248,18,39,0.462,10,24,0.417,8,15,0.533,7,9,0.778,2,14,16,27,7,0,5,21,53
2020,Derrick Walton,PG,24,LAC,23,1,222,17,36,0.472,9,21,0.429,8,15,0.533,7,9,0.778,2,13,15,22,4,0,4,19,50
2020,Derrick Walton,PG,24,DET,3,0,26,1,3,0.333,1,3,0.333,0,0,,0,0,,0,1,1,5,3,0,1,2,3
2020,Derrick White,SG,25,SAS,68,20,1677,253,552,0.458,79,216,0.366,174,336,0.518,180,211,0.853,35,188,223,241,44,59,89,152,765
2020,Devin Booker,SG,23,PHO,70,70,2512,627,1283,0.489,141,398,0.354,486,885,0.549,468,509,0.919,29,268,297,456,49,18,264,213,1863
2020,Devon Hall,PG,24,OKC,11,0,81,6,30,0.2,4,17,0.235,2,13,0.154,4,8,0.5,2,5,7,13,4,1,5,6,20
2020,Devontae Cacok,C,23,LAL,1,0,9,3,6,0.5,0,0,,3,6,0.5,0,0,,2,3,5,1,0,0,0,0,6
2020,Devonte' Graham,PG,24,CHO,63,53,2211,368,963,0.382,218,585,0.373,150,378,0.397,191,233,0.82,42,170,212,471,62,15,181,115,1145
2020,Dewan Hernandez,C,23,TOR,6,0,28,5,14,0.357,1,2,0.5,4,12,0.333,3,5,0.6,5,9,14,3,1,0,3,6,14
2020,Dewayne Dedmon,C,30,TOT,44,18,774,102,255,0.4,22,107,0.206,80,148,0.541,30,36,0.833,60,189,249,22,25,41,57,133,256
2020,Dewayne Dedmon,C,30,SAC,34,10,541,69,171,0.404,14,71,0.197,55,100,0.55,23,28,0.821,46,121,167,15,15,26,47,93,175
2020,Dewayne Dedmon,C,30,ATL,10,8,233,33,84,0.393,8,36,0.222,25,48,0.521,7,8,0.875,14,68,82,7,10,15,10,40,81
2020,Dillon Brooks,SG,24,MEM,73,73,2112,435,1068,0.407,147,411,0.358,288,657,0.438,164,203,0.808,68,175,243,150,63,27,124,278,1181
2020,Dion Waiters,SG,28,TOT,10,0,207,41,99,0.414,15,47,0.319,26,52,0.5,14,17,0.824,2,22,24,20,4,6,16,21,111
2020,Dion Waiters,SG,28,MIA,3,0,42,10,26,0.385,8,17,0.471,2,9,0.222,0,1,0,0,11,11,3,0,2,3,5,28
2020,Dion Waiters,SG,28,LAL,7,0,165,31,73,0.425,7,30,0.233,24,43,0.558,14,16,0.875,2,11,13,17,4,4,13,16,83
2020,Domantas Sabonis,PF,23,IND,62,62,2159,458,848,0.54,17,67,0.254,441,781,0.565,214,296,0.723,189,582,771,310,47,30,170,195,1147
2020,Donovan Mitchell,SG,23,UTA,69,69,2364,602,1342,0.449,173,473,0.366,429,869,0.494,278,322,0.863,53,251,304,294,70,14,184,172,1655
2020,Donta Hall,C-PF,22,TOT,9,0,133,15,22,0.682,0,0,,15,22,0.682,9,18,0.5,14,24,38,4,3,6,5,23,39
2020,Donta Hall,PF,22,DET,4,0,48,1,4,0.25,0,0,,1,4,0.25,4,6,0.667,6,9,15,2,1,1,2,9,6
2020,Donta Hall,C,22,BRK,5,0,85,14,18,0.778,0,0,,14,18,0.778,5,12,0.417,8,15,23,2,2,5,3,14,33
2020,Donte DiVincenzo,SG,23,MIL,66,24,1520,232,510,0.455,83,247,0.336,149,263,0.567,63,86,0.733,66,252,318,154,85,20,90,113,610
2020,Dorian Finney-Smith,PF,26,DAL,71,68,2120,243,522,0.466,114,303,0.376,129,219,0.589,78,108,0.722,145,260,405,114,45,39,69,178,678
2020,Doug McDermott,PF,28,IND,69,0,1372,267,547,0.488,128,294,0.435,139,253,0.549,48,58,0.828,26,148,174,78,12,5,42,117,710
2020,Dragan Bender,PF-C,22,TOT,16,3,286,41,92,0.446,15,43,0.349,26,49,0.531,10,14,0.714,16,57,73,28,4,9,21,42,107
2020,Dragan Bender,C,22,MIL,7,0,91,10,21,0.476,4,9,0.444,6,12,0.5,2,3,0.667,0,20,20,9,0,5,5,16,26
2020,Dragan Bender,PF,22,GSW,9,3,195,31,71,0.437,11,34,0.324,20,37,0.541,8,11,0.727,16,37,53,19,4,4,16,26,81
2020,Draymond Green,PF,29,GSW,43,43,1222,123,316,0.389,36,129,0.279,87,187,0.465,63,83,0.759,23,243,266,266,59,33,98,110,345
2020,Drew Eubanks,C,22,SAS,22,3,272,43,67,0.642,1,1,1,42,66,0.636,20,26,0.769,28,57,85,15,5,17,21,37,107
2020,Duncan Robinson,SG,25,MIA,73,68,2166,323,687,0.47,270,606,0.446,53,81,0.654,67,72,0.931,10,222,232,102,35,19,70,193,983
2020,Dusty Hannahs,SG,26,MEM,2,0,13,4,9,0.444,2,3,0.667,2,6,0.333,2,2,1,0,1,1,0,0,0,0,1,12
2020,Dwayne Bacon,SG,24,CHO,39,11,687,85,244,0.348,19,67,0.284,66,177,0.373,35,53,0.66,15,85,100,52,23,2,37,52,224
2020,Dwight Howard,C,34,LAL,69,2,1306,202,277,0.729,3,5,0.6,199,272,0.732,110,214,0.514,172,335,507,45,31,79,84,222,517
2020,Dwight Powell,C,28,DAL,40,37,1061,146,229,0.638,10,39,0.256,136,190,0.716,74,111,0.667,75,152,227,59,34,22,36,102,376
2020,Džanan Musa,SF,20,BRK,40,0,487,64,172,0.372,19,78,0.244,45,94,0.479,45,60,0.75,21,65,86,43,15,1,36,30,192
2020,E'Twaun Moore,SG,30,NOP,56,6,1020,186,437,0.426,63,167,0.377,123,270,0.456,31,45,0.689,31,100,131,78,32,11,40,80,466
2020,Ed Davis,C,30,UTA,28,1,303,22,46,0.478,0,0,,22,46,0.478,7,14,0.5,35,70,105,12,11,9,13,61,51
2020,Edmond Sumner,SG,24,IND,31,3,447,61,142,0.43,14,53,0.264,47,89,0.528,16,29,0.552,11,35,46,55,15,9,22,44,152
2020,Elfrid Payton,PG,25,NYK,45,36,1246,193,440,0.439,14,69,0.203,179,371,0.482,49,86,0.57,52,160,212,323,70,17,96,89,449
2020,Elie Okobo,PG,22,PHO,55,3,719,72,181,0.398,25,71,0.352,47,110,0.427,50,71,0.704,16,74,90,115,24,4,38,54,219
2020,Emmanuel Mudiay,PG,23,UTA,54,2,850,151,327,0.462,30,87,0.345,121,240,0.504,63,83,0.759,18,108,126,116,24,10,76,72,395
2020,Enes Freedom,C,27,BOS,58,7,983,199,348,0.572,1,7,0.143,198,341,0.581,70,99,0.707,163,268,431,56,22,41,56,100,469
2020,Eric Bledsoe,PG,30,MIL,61,61,1646,334,703,0.475,74,215,0.344,260,488,0.533,169,214,0.79,43,239,282,328,57,26,148,128,911
2020,Eric Gordon,SF,31,HOU,36,15,1016,171,463,0.369,96,303,0.317,75,160,0.469,82,107,0.766,9,62,71,54,23,13,43,70,520
2020,Eric Mika,C,25,SAC,1,0,19,2,3,0.667,0,0,,2,3,0.667,2,2,1,2,5,7,0,0,0,0,5,6
2020,Eric Paschall,PF,23,GSW,60,26,1654,318,640,0.497,37,129,0.287,281,511,0.55,164,212,0.774,82,193,275,127,32,13,94,125,837
2020,Ersan İlyasova,PF,32,MIL,63,8,986,146,313,0.466,50,137,0.365,96,176,0.545,72,87,0.828,62,240,302,49,24,17,34,95,414
2020,Evan Fournier,SF,27,ORL,66,66,2076,434,929,0.467,173,434,0.399,261,495,0.527,180,220,0.818,18,153,171,209,71,15,125,161,1221
2020,Evan Turner,SG,31,ATL,19,0,251,25,67,0.373,0,5,0,25,62,0.403,12,14,0.857,8,30,38,38,9,8,26,20,62
2020,Frank Jackson,PG,21,NOP,59,2,797,134,331,0.405,47,144,0.326,87,187,0.465,56,75,0.747,22,61,83,61,17,4,49,77,371
2020,Frank Kaminsky,C,26,PHO,39,13,777,138,307,0.45,41,124,0.331,97,183,0.53,61,90,0.678,35,141,176,75,14,10,37,75,378
2020,Frank Mason III,PG,25,MIL,9,0,118,23,51,0.451,6,21,0.286,17,30,0.567,10,17,0.588,5,14,19,29,5,1,11,11,62
2020,Frank Ntilikina,PG,21,NYK,57,26,1187,131,333,0.393,44,137,0.321,87,196,0.444,51,59,0.864,23,98,121,172,54,16,71,142,357
2020,Fred VanVleet,SG,25,TOR,54,54,1928,319,773,0.413,146,374,0.39,173,399,0.434,168,198,0.848,18,185,203,357,100,17,121,132,952
2020,Furkan Korkmaz,SG,22,PHI,72,12,1559,242,563,0.43,143,356,0.402,99,207,0.478,77,102,0.755,18,150,168,79,41,16,59,98,704
2020,Gabe Vincent,PG,23,MIA,9,0,83,8,37,0.216,6,27,0.222,2,10,0.2,0,0,,0,5,5,6,5,0,1,6,22
2020,Garrett Temple,SG,33,BRK,62,35,1730,222,587,0.378,127,386,0.329,95,201,0.473,70,87,0.805,29,189,218,156,49,29,62,108,641
2020,Garrison Mathews,SG,23,WAS,18,0,227,24,56,0.429,19,46,0.413,5,10,0.5,31,34,0.912,6,18,24,10,8,1,8,32,98
2020,Gary Clark,SF-PF,25,TOT,42,5,567,54,133,0.406,39,111,0.351,15,22,0.682,9,10,0.9,37,73,110,17,6,22,10,46,156
2020,Gary Clark,PF,25,HOU,18,0,212,23,59,0.39,18,51,0.353,5,8,0.625,6,7,0.857,11,29,40,12,2,7,2,21,70
2020,Gary Clark,SF,25,ORL,24,5,355,31,74,0.419,21,60,0.35,10,14,0.714,3,3,1,26,44,70,5,4,15,8,25,86
2020,Gary Harris,SG,25,DEN,56,55,1780,218,519,0.42,70,210,0.333,148,309,0.479,75,92,0.815,26,137,163,118,76,14,60,116,581
2020,Gary Payton II,SF,27,WAS,29,17,432,48,116,0.414,13,46,0.283,35,70,0.5,4,8,0.5,26,54,80,48,33,7,20,54,113
2020,Gary Trent Jr.,SF,21,POR,61,8,1332,196,441,0.444,112,268,0.418,84,173,0.486,37,45,0.822,25,75,100,61,48,16,21,90,541
2020,George Hill,PG,33,MIL,59,2,1271,194,376,0.516,81,176,0.46,113,200,0.565,85,101,0.842,50,127,177,180,47,5,57,84,554
2020,Georges Niang,PF,26,UTA,66,1,923,141,322,0.438,90,225,0.4,51,97,0.526,20,24,0.833,15,112,127,44,18,5,30,75,392
2020,Giannis Antetokounmpo,PF,25,MIL,63,63,1917,685,1238,0.553,89,293,0.304,596,945,0.631,398,629,0.633,140,716,856,354,61,66,230,195,1857
2020,Glenn Robinson III,SF,26,TOT,62,52,1786,288,592,0.486,77,197,0.391,211,395,0.534,74,86,0.86,81,189,270,96,54,16,55,100,727
2020,Glenn Robinson III,SF,26,GSW,48,48,1516,244,507,0.481,68,170,0.4,176,337,0.522,63,74,0.851,66,160,226,85,45,14,50,82,619
2020,Glenn Robinson III,SF,26,PHI,14,4,270,44,85,0.518,9,27,0.333,35,58,0.603,11,12,0.917,15,29,44,11,9,2,5,18,108
2020,Goga Bitadze,C,20,IND,54,2,471,70,150,0.467,8,42,0.19,62,108,0.574,24,33,0.727,25,81,106,23,10,37,28,65,172
2020,Goran Dragić,PG,33,MIA,59,3,1663,319,724,0.441,124,338,0.367,195,386,0.505,191,246,0.776,29,158,187,301,40,10,144,124,953
2020,Gordon Hayward,SF,29,BOS,52,52,1740,350,700,0.5,85,222,0.383,265,478,0.554,124,145,0.855,55,293,348,212,38,22,96,96,909
2020,Gorgui Dieng,C,30,TOT,63,17,1096,166,364,0.456,54,152,0.355,112,212,0.528,78,101,0.772,91,263,354,73,51,59,60,124,464
2020,Gorgui Dieng,C,30,MIN,46,17,778,124,277,0.448,46,120,0.383,78,157,0.497,47,59,0.797,73,183,256,58,37,42,44,89,341
2020,Gorgui Dieng,C,30,MEM,17,0,318,42,87,0.483,8,32,0.25,34,55,0.618,31,42,0.738,18,80,98,15,14,17,16,35,123
2020,Grant Williams,PF,21,BOS,69,5,1043,87,211,0.412,24,96,0.25,63,115,0.548,39,54,0.722,59,119,178,68,30,36,50,163,237
2020,Grayson Allen,SG,24,MEM,38,0,718,117,251,0.466,57,141,0.404,60,110,0.545,39,45,0.867,8,77,85,52,10,2,33,53,330
2020,Hamidou Diallo,SF,21,OKC,46,3,896,132,296,0.446,16,57,0.281,116,239,0.485,38,63,0.603,44,123,167,36,37,9,51,101,318
2020,Harrison Barnes,PF,27,SAC,72,72,2482,365,793,0.46,102,268,0.381,263,525,0.501,214,267,0.801,77,278,355,159,43,12,88,93,1046
2020,Harry Giles,C,21,SAC,46,17,667,139,251,0.554,0,2,0,139,249,0.558,38,49,0.776,43,145,188,60,22,18,44,119,316
2020,Hassan Whiteside,C,30,POR,67,61,2008,436,702,0.621,4,7,0.571,432,695,0.622,164,239,0.686,258,647,905,78,26,196,120,196,1040
2020,Henry Ellenson,C,23,BRK,5,0,15,1,7,0.143,0,4,0,1,3,0.333,0,0,,2,4,6,1,0,0,0,1,2
2020,Ian Mahinmi,C,33,WAS,38,35,808,104,210,0.495,5,26,0.192,99,184,0.538,70,113,0.619,78,140,218,49,31,44,45,114,283
2020,Ignas Brazdeikis,SF,21,NYK,9,0,53,6,22,0.273,1,9,0.111,5,13,0.385,4,5,0.8,2,3,5,4,0,1,2,3,17
2020,Iman Shumpert,SF,29,BRK,13,0,241,21,64,0.328,8,33,0.242,13,31,0.419,4,7,0.571,9,25,34,12,12,2,10,21,54
2020,Isaac Bonga,SF,20,WAS,66,49,1250,118,234,0.504,25,71,0.352,93,163,0.571,69,85,0.812,71,151,222,76,45,22,58,156,330
2020,Isaiah Hartenstein,C,21,HOU,23,2,266,44,67,0.657,0,5,0,44,62,0.71,19,28,0.679,29,61,90,18,9,12,16,41,107
2020,Isaiah Roby,PF,21,OKC,3,0,11,0,1,0,0,0,,0,1,0,0,0,,0,2,2,0,0,0,1,1,0
2020,Isaiah Thomas,PG,30,WAS,40,37,925,174,426,0.408,78,189,0.413,96,237,0.405,62,76,0.816,11,57,68,146,13,6,77,77,488
2020,Ish Smith,PG,31,WAS,68,23,1787,308,689,0.447,62,169,0.367,246,520,0.473,62,86,0.721,30,189,219,334,59,30,95,106,740
2020,Ivica Zubac,C,22,LAC,72,70,1326,236,385,0.613,0,2,0,236,383,0.616,124,166,0.747,197,346,543,82,16,66,61,168,596
2020,J.J. Barea,PG,35,DAL,29,6,450,85,207,0.411,32,85,0.376,53,122,0.434,20,22,0.909,10,43,53,112,5,2,38,27,222
2020,J.J. Redick,SG,35,NOP,60,36,1581,286,631,0.453,180,397,0.453,106,234,0.453,165,185,0.892,10,141,151,119,20,10,75,96,917
2020,J.P. Macura,SG,24,CLE,1,0,1,0,0,,0,0,,0,0,,0,0,,0,0,0,0,0,0,0,0,0
2020,J.R. Smith,SG,34,LAL,6,0,79,7,22,0.318,1,11,0.091,6,11,0.545,2,2,1,0,5,5,3,1,0,4,5,17
2020,Ja Morant,PG,20,MEM,67,67,2074,447,937,0.477,60,179,0.335,387,758,0.511,239,308,0.776,51,208,259,488,58,18,220,110,1193
2020,Jabari Parker,PF,24,TOT,38,23,917,219,429,0.51,32,119,0.269,187,310,0.603,61,81,0.753,61,153,214,68,45,16,64,99,531
2020,Jabari Parker,PF,24,ATL,32,23,837,198,393,0.504,31,115,0.27,167,278,0.601,53,72,0.736,54,137,191,58,42,15,60,93,480
2020,Jabari Parker,PF,24,SAC,6,0,80,21,36,0.583,1,4,0.25,20,32,0.625,8,9,0.889,7,16,23,10,3,1,4,6,51
2020,Jacob Evans,SG,22,TOT,29,1,418,45,134,0.336,13,39,0.333,32,95,0.337,25,29,0.862,9,32,41,31,11,12,25,41,128
2020,Jacob Evans,SG,22,GSW,27,1,414,45,133,0.338,13,38,0.342,32,95,0.337,25,29,0.862,9,32,41,31,11,12,25,41,128
2020,Jacob Evans,SG,22,MIN,2,0,4,0,1,0,0,1,0,0,0,,0,0,,0,0,0,0,0,0,0,0,0
2020,Jae Crowder,SF-PF,29,TOT,65,53,1875,226,563,0.401,135,394,0.343,91,169,0.538,97,125,0.776,52,332,384,161,72,24,69,143,684
2020,Jae Crowder,SF,29,MEM,45,45,1322,147,399,0.368,78,266,0.293,69,133,0.519,75,95,0.789,40,237,277,125,47,14,54,85,447
2020,Jae Crowder,PF,29,MIA,20,8,553,79,164,0.482,57,128,0.445,22,36,0.611,22,30,0.733,12,95,107,36,25,10,15,58,237
2020,Jahlil Okafor,C,24,NOP,30,9,467,101,162,0.623,1,3,0.333,100,159,0.629,40,62,0.645,48,79,127,37,7,22,38,67,243
2020,JaKarr Sampson,PF,26,IND,34,12,471,68,115,0.591,2,13,0.154,66,102,0.647,18,27,0.667,20,68,88,21,16,12,15,64,156
2020,Jake Layman,SF,25,MIN,23,2,505,81,179,0.453,24,72,0.333,57,107,0.533,24,32,0.75,17,40,57,15,17,10,24,47,210
2020,Jakob Poeltl,C,24,SAS,66,18,1171,166,266,0.624,0,0,,166,266,0.624,40,86,0.465,131,244,375,116,37,95,54,126,372
2020,Jalen Brunson,PG,23,DAL,57,16,1022,181,388,0.466,43,120,0.358,138,268,0.515,61,75,0.813,22,112,134,188,22,4,66,74,466
2020,Jalen Lecque,SG,19,PHO,5,0,32,4,10,0.4,0,4,0,4,6,0.667,2,2,1,0,2,2,2,0,0,2,3,10
2020,Jalen McDaniels,SF,22,CHO,16,0,293,33,70,0.471,9,24,0.375,24,46,0.522,14,17,0.824,15,50,65,13,8,3,11,36,89
2020,Jamal Crawford,SG,39,BRK,1,0,6,2,4,0.5,1,2,0.5,1,2,0.5,0,0,,0,0,0,3,0,0,0,1,5
2020,Jamal Murray,PG,22,DEN,59,59,1904,408,894,0.456,112,324,0.346,296,570,0.519,163,185,0.881,45,191,236,284,67,17,127,102,1091
2020,James Ennis III,SF-SG,29,TOT,69,18,1265,160,359,0.446,55,169,0.325,105,190,0.553,79,98,0.806,71,174,245,63,35,22,58,137,454
2020,James Ennis III,SF,29,PHI,49,0,776,100,226,0.442,37,106,0.349,63,120,0.525,48,61,0.787,48,102,150,41,23,14,31,85,285
2020,James Ennis III,SG,29,ORL,20,18,489,60,133,0.451,18,63,0.286,42,70,0.6,31,37,0.838,23,72,95,22,12,8,27,52,169
2020,James Harden,SG,30,HOU,68,68,2483,672,1514,0.444,299,843,0.355,373,671,0.556,692,800,0.865,70,376,446,512,125,60,308,227,2335
2020,James Johnson,PF-C,32,TOT,32,1,619,103,215,0.479,33,91,0.363,70,124,0.565,31,48,0.646,25,93,118,74,25,32,48,80,270
2020,James Johnson,PF,32,MIA,18,0,281,39,87,0.448,16,45,0.356,23,42,0.548,8,14,0.571,8,44,52,21,6,13,15,34,102
2020,James Johnson,C,32,MIN,14,1,338,64,128,0.5,17,46,0.37,47,82,0.573,23,34,0.676,17,49,66,53,19,19,33,46,168
2020,JaMychal Green,PF,29,LAC,63,1,1307,151,352,0.429,92,238,0.387,59,114,0.518,36,48,0.75,77,311,388,49,29,24,54,174,430
2020,Jared Dudley,PF,34,LAL,45,1,364,24,60,0.4,18,42,0.429,6,18,0.333,2,2,1,6,46,52,28,15,3,8,41,68
2020,Jared Harper,PG,22,PHO,3,0,8,1,4,0.25,0,2,0,1,2,0.5,0,0,,0,0,0,0,0,0,0,0,2
2020,Jaren Jackson Jr.,C,20,MEM,57,57,1622,353,753,0.469,145,368,0.394,208,385,0.54,139,186,0.747,55,207,262,78,40,92,99,232,990
2020,Jarred Vanderbilt,PF,20,TOT,11,0,46,5,8,0.625,0,1,0,5,7,0.714,2,2,1,3,6,9,2,3,1,7,6,12
2020,Jarred Vanderbilt,PF,20,DEN,9,0,41,5,7,0.714,0,0,,5,7,0.714,0,0,,3,5,8,2,3,1,7,6,10
2020,Jarred Vanderbilt,PF,20,MIN,2,0,5,0,1,0,0,1,0,0,0,,2,2,1,0,1,1,0,0,0,0,0,2
2020,Jarrell Brantley,PF,23,UTA,9,0,96,10,28,0.357,3,13,0.231,7,15,0.467,1,2,0.5,2,18,20,11,3,5,7,7,24
2020,Jarrett Allen,C,21,BRK,70,64,1852,302,465,0.649,0,6,0,302,459,0.658,171,270,0.633,216,455,671,110,40,92,77,162,775
2020,Jarrett Culver,SG,20,MIN,63,35,1506,230,569,0.404,66,221,0.299,164,348,0.471,54,117,0.462,70,142,212,110,57,38,81,125,580
2020,Jarrod Uthoff,PF,26,TOT,7,0,53,7,18,0.389,3,9,0.333,4,9,0.444,2,2,1,2,4,6,0,1,0,0,2,19
2020,Jarrod Uthoff,PF,26,MEM,4,0,14,1,7,0.143,0,4,0,1,3,0.333,2,2,1,1,0,1,0,1,0,0,1,4
2020,Jarrod Uthoff,PF,26,WAS,3,0,39,6,11,0.545,3,5,0.6,3,6,0.5,0,0,,1,4,5,0,0,0,0,1,15
2020,JaVale McGee,C,32,LAL,68,68,1130,195,306,0.637,3,6,0.5,192,300,0.64,53,82,0.646,125,265,390,37,36,94,55,159,446
2020,Javonte Green,SG,26,BOS,48,2,468,63,126,0.5,9,33,0.273,54,93,0.581,28,42,0.667,24,69,93,26,24,8,23,43,163
2020,Jaxson Hayes,C,19,NOP,64,14,1080,174,259,0.672,1,4,0.25,173,255,0.678,123,190,0.647,97,162,259,56,26,55,53,161,472
2020,Jaylen Brown,SG,23,BOS,57,57,1934,427,887,0.481,129,338,0.382,298,549,0.543,176,243,0.724,62,302,364,118,65,20,125,167,1159
2020,Jaylen Hoard,PF,20,POR,13,0,103,15,32,0.469,0,3,0,15,29,0.517,8,13,0.615,14,18,32,4,5,0,4,12,38
2020,Jaylen Nowell,SG,20,MIN,15,0,151,19,53,0.358,3,26,0.115,16,27,0.593,16,17,0.941,3,10,13,19,3,1,3,11,57
2020,Jayson Tatum,PF,21,BOS,66,66,2265,552,1226,0.45,189,469,0.403,363,757,0.48,254,313,0.812,64,396,460,200,93,57,155,136,1547
2020,Jeff Green,PF-C,33,TOT,48,4,960,159,344,0.462,62,183,0.339,97,161,0.602,73,91,0.802,24,109,133,50,26,19,42,89,453
2020,Jeff Green,PF,33,UTA,30,2,553,75,195,0.385,34,104,0.327,41,91,0.451,49,63,0.778,14,67,81,20,12,10,27,46,233
2020,Jeff Green,C,33,HOU,18,2,407,84,149,0.564,28,79,0.354,56,70,0.8,24,28,0.857,10,42,52,30,14,9,15,43,220
2020,Jeff Teague,PG,31,TOT,59,17,1464,213,489,0.436,43,117,0.368,170,372,0.457,172,197,0.873,27,115,142,308,44,19,116,106,641
2020,Jeff Teague,PG,31,MIN,34,13,945,145,324,0.448,33,87,0.379,112,237,0.473,125,144,0.868,15,73,88,208,25,13,76,70,448
2020,Jeff Teague,PG,31,ATL,25,4,519,68,165,0.412,10,30,0.333,58,135,0.43,47,53,0.887,12,42,54,100,19,6,40,36,193
2020,Jerami Grant,PF,25,DEN,71,24,1892,303,634,0.478,98,252,0.389,205,382,0.537,147,196,0.75,58,190,248,88,50,57,63,154,851
2020,Jeremiah Martin,PG,23,BRK,9,0,99,24,53,0.453,5,18,0.278,19,35,0.543,11,14,0.786,1,9,10,18,7,2,4,7,64
2020,Jeremy Lamb,SG,27,IND,46,42,1291,216,479,0.451,53,158,0.335,163,321,0.508,92,110,0.836,24,176,200,96,55,22,50,104,577
2020,Jeremy Pargo,PG,33,GSW,3,0,44,11,22,0.5,3,7,0.429,8,15,0.533,0,1,0,1,2,3,8,1,0,4,8,25
2020,Jerian Grant,SG,27,WAS,6,0,80,10,27,0.37,2,8,0.25,8,19,0.421,5,7,0.714,2,4,6,9,1,1,3,11,27
2020,Jerome Robinson,SG,22,TOT,63,6,979,115,310,0.371,49,153,0.32,66,157,0.42,40,57,0.702,13,116,129,87,28,17,49,112,319
2020,Jerome Robinson,SG,22,LAC,42,1,476,46,136,0.338,19,67,0.284,27,69,0.391,11,19,0.579,5,55,60,46,13,8,26,55,122
2020,Jerome Robinson,SG,22,WAS,21,5,503,69,174,0.397,30,86,0.349,39,88,0.443,29,38,0.763,8,61,69,41,15,9,23,57,197
2020,Jevon Carter,PG,24,PHO,58,2,945,101,243,0.416,62,146,0.425,39,97,0.402,23,27,0.852,30,88,118,84,47,17,32,86,287
2020,Jimmy Butler,SF,30,MIA,58,58,1959,345,758,0.455,29,119,0.244,316,639,0.495,438,525,0.834,106,280,386,350,103,32,127,81,1157
2020,Joakim Noah,C,34,LAC,5,0,50,4,8,0.5,0,0,,4,8,0.5,6,8,0.75,5,11,16,7,1,1,6,9,14
2020,Joe Chealey,PG,24,CHO,4,0,33,0,7,0,0,4,0,0,3,0,2,2,1,0,0,0,1,4,0,2,2,2
2020,Joe Harris,SF,28,BRK,69,69,2123,381,784,0.486,172,406,0.424,209,378,0.553,64,89,0.719,64,234,298,144,41,17,104,159,998
2020,Joe Ingles,PF,32,UTA,72,45,2137,246,553,0.445,141,353,0.399,105,200,0.525,74,94,0.787,27,251,278,373,65,11,142,154,707
2020,Joel Embiid,C,25,PHI,51,51,1506,382,801,0.477,57,172,0.331,325,629,0.517,351,435,0.807,141,452,593,152,45,65,159,174,1172
2020,John Collins,PF,22,ATL,41,41,1363,353,605,0.583,59,147,0.401,294,458,0.642,120,150,0.8,116,300,416,60,31,66,75,138,885
2020,John Henson,C,29,TOT,40,8,600,95,171,0.556,8,36,0.222,87,135,0.644,23,46,0.5,46,116,162,54,24,42,36,78,221
2020,John Henson,C,29,CLE,29,2,412,61,120,0.508,6,31,0.194,55,89,0.618,17,33,0.515,32,82,114,43,16,32,21,55,145
2020,John Henson,C,29,DET,11,6,188,34,51,0.667,2,5,0.4,32,46,0.696,6,13,0.462,14,34,48,11,8,10,15,23,76
2020,John Konchar,SG,23,MEM,19,0,181,24,37,0.649,5,10,0.5,19,27,0.704,1,2,0.5,18,29,47,22,7,3,7,7,54
2020,Johnathan Motley,PF,24,LAC,13,0,41,11,15,0.733,1,1,1,10,14,0.714,5,7,0.714,3,7,10,8,3,0,5,6,28
2020,Johnathan Williams,PF,24,WAS,15,6,180,19,34,0.559,0,2,0,19,32,0.594,7,13,0.538,24,40,64,8,1,8,5,16,45
2020,Jonah Bolden,C,24,TOT,7,0,47,4,11,0.364,0,4,0,4,7,0.571,2,4,0.5,3,6,9,0,3,2,2,10,10
2020,Jonah Bolden,C,24,PHI,4,0,14,2,3,0.667,0,1,0,2,2,1,0,2,0,0,1,1,0,1,0,2,4,4
2020,Jonah Bolden,C,24,PHO,3,0,33,2,8,0.25,0,3,0,2,5,0.4,2,2,1,3,5,8,0,2,2,0,6,6
2020,Jonas Valančiūnas,C,27,MEM,70,70,1845,432,739,0.585,32,91,0.352,400,648,0.617,148,200,0.74,213,575,788,131,30,76,127,185,1044
2020,Jonathan Isaac,PF,22,ORL,34,32,980,156,332,0.47,32,94,0.34,124,238,0.521,60,77,0.779,58,173,231,48,53,78,49,83,404
2020,Jordan Bell,C,25,TOT,29,0,256,35,67,0.522,4,12,0.333,31,55,0.564,19,31,0.613,30,51,81,16,3,10,21,19,93
2020,Jordan Bell,C,25,MIN,27,0,235,32,60,0.533,2,9,0.222,30,51,0.588,17,29,0.586,28,50,78,14,2,10,18,17,83
2020,Jordan Bell,C,25,MEM,2,0,21,3,7,0.429,2,3,0.667,1,4,0.25,2,2,1,2,1,3,2,1,0,3,2,10
2020,Jordan Bone,PG,22,DET,10,0,53,5,20,0.25,2,10,0.2,3,10,0.3,0,0,,0,4,4,8,1,0,2,6,12
2020,Jordan Clarkson,SG,27,TOT,71,2,1705,394,867,0.454,152,413,0.368,242,454,0.533,138,165,0.836,50,137,187,136,46,16,97,108,1078
2020,Jordan Clarkson,SG,27,CLE,29,0,666,144,326,0.442,59,159,0.371,85,167,0.509,76,86,0.884,21,48,69,70,17,8,39,33,423
2020,Jordan Clarkson,SG,27,UTA,42,2,1039,250,541,0.462,93,254,0.366,157,287,0.547,62,79,0.785,29,89,118,66,29,8,58,75,655
2020,Jordan McLaughlin,PG,23,MIN,30,2,590,87,178,0.489,29,76,0.382,58,102,0.569,26,39,0.667,7,42,49,125,34,4,31,31,229
2020,Jordan McRae,SG,28,TOT,37,4,784,149,366,0.407,45,126,0.357,104,240,0.433,83,109,0.761,18,106,124,93,21,16,43,73,426
2020,Jordan McRae,SG,28,WAS,29,4,654,133,317,0.42,40,106,0.377,93,211,0.441,64,83,0.771,17,87,104,82,19,15,38,61,370
2020,Jordan McRae,SG,28,DEN,4,0,32,2,6,0.333,2,4,0.5,0,2,0,3,4,0.75,1,4,5,4,2,1,0,2,9
2020,Jordan McRae,SG,28,DET,4,0,98,14,43,0.326,3,16,0.188,11,27,0.407,16,22,0.727,0,15,15,7,0,0,5,10,47
2020,Jordan Poole,SG,20,GSW,57,14,1274,167,502,0.333,74,265,0.279,93,237,0.392,95,119,0.798,9,109,118,134,35,10,74,94,503
2020,Josh Gray,PG,26,NOP,2,0,23,1,2,0.5,0,0,,1,2,0.5,0,0,,1,1,2,2,0,0,5,1,2
2020,Josh Hart,SF,24,NOP,65,16,1755,225,532,0.423,121,354,0.342,104,178,0.584,85,115,0.739,61,364,425,108,63,23,75,160,656
2020,Josh Jackson,SF,22,MEM,22,0,381,70,159,0.44,23,72,0.319,47,87,0.54,35,50,0.7,11,55,66,35,18,9,28,40,198
2020,Josh Magette,PG,30,ORL,8,0,38,5,15,0.333,1,4,0.25,4,11,0.364,1,2,0.5,1,5,6,5,3,1,5,4,12
2020,Josh Okogie,SG,21,MIN,62,28,1547,170,398,0.427,41,154,0.266,129,244,0.529,152,191,0.796,87,181,268,99,68,26,87,139,533
2020,Josh Reaves,SF,22,DAL,4,0,28,3,9,0.333,0,2,0,3,7,0.429,2,2,1,1,2,3,3,0,0,0,5,8
2020,Josh Richardson,SG,26,PHI,55,53,1693,278,646,0.43,85,249,0.341,193,397,0.486,114,141,0.809,41,133,174,162,52,36,104,136,755
2020,Jrue Holiday,SG,29,NOP,61,61,2117,458,1006,0.455,122,346,0.353,336,660,0.509,129,182,0.709,77,216,293,408,99,48,184,145,1167
2020,Juan Toscano-Anderson,SG,26,GSW,13,6,272,29,63,0.46,8,23,0.348,21,40,0.525,3,5,0.6,9,43,52,26,13,5,16,30,69
2020,Juancho Hernangómez,PF,24,TOT,48,14,833,100,247,0.405,44,129,0.341,56,118,0.475,44,71,0.62,43,154,197,40,19,9,32,64,288
2020,Juancho Hernangómez,PF,24,DEN,34,0,422,38,110,0.345,15,60,0.25,23,50,0.46,16,25,0.64,24,71,95,22,5,5,18,29,107
2020,Juancho Hernangómez,PF,24,MIN,14,14,411,62,137,0.453,29,69,0.42,33,68,0.485,28,46,0.609,19,83,102,18,14,4,14,35,181
2020,Julius Randle,PF,25,NYK,64,64,2080,463,1006,0.46,64,231,0.277,399,775,0.515,258,352,0.733,151,471,622,198,51,22,193,178,1248
2020,Justin Anderson,SG,26,BRK,10,1,107,10,38,0.263,6,29,0.207,4,9,0.444,2,4,0.5,1,20,21,8,0,6,4,13,28
2020,Justin Holiday,SF,30,IND,73,6,1826,208,486,0.428,134,331,0.405,74,155,0.477,53,67,0.791,32,206,238,93,87,46,44,137,603
2020,Justin Jackson,PF,24,DAL,65,3,1045,135,341,0.396,48,163,0.294,87,178,0.489,42,50,0.84,27,127,154,52,15,10,14,69,360
2020,Justin James,SF,23,SAC,36,0,232,35,84,0.417,9,29,0.31,26,55,0.473,10,21,0.476,6,26,32,18,6,9,8,17,89
2020,Justin Patton,C,22,OKC,5,0,24,4,10,0.4,1,4,0.25,3,6,0.5,0,0,,1,4,5,2,0,0,2,4,9
2020,Justin Robinson,PG,22,WAS,9,0,49,5,12,0.417,3,5,0.6,2,7,0.286,0,0,,1,4,5,7,0,1,3,2,13
2020,Justin Wright-Foreman,PG,22,UTA,4,0,45,7,20,0.35,2,10,0.2,5,10,0.5,3,4,0.75,0,5,5,7,2,0,3,5,19
2020,Justise Winslow,SG,23,MIA,11,5,352,50,129,0.388,6,27,0.222,44,102,0.431,18,27,0.667,16,57,73,44,7,5,24,38,124
2020,Jusuf Nurkić,C,25,POR,8,8,253,54,109,0.495,2,10,0.2,52,99,0.525,31,35,0.886,23,59,82,32,11,16,19,39,141
2020,Juwan Morgan,PF,22,UTA,21,0,134,15,26,0.577,3,8,0.375,12,18,0.667,3,4,0.75,10,19,29,6,1,2,6,19,36
2020,Kadeem Allen,PG,27,NYK,10,0,117,19,44,0.432,5,16,0.313,14,28,0.5,7,11,0.636,2,7,9,21,5,2,8,7,50
2020,Karl-Anthony Towns,C,24,MIN,35,35,1187,316,622,0.508,114,277,0.412,202,345,0.586,180,226,0.796,95,283,378,153,33,42,110,117,926
2020,Kawhi Leonard,SF,28,LAC,57,57,1848,532,1133,0.47,123,325,0.378,409,808,0.506,356,402,0.886,54,348,402,280,103,33,149,113,1543
2020,Keita Bates-Diop,PF-SF,24,TOT,44,0,744,100,234,0.427,34,103,0.33,66,131,0.504,54,75,0.72,25,102,127,30,19,24,17,43,288
2020,Keita Bates-Diop,PF,24,MIN,37,0,646,87,206,0.422,31,94,0.33,56,112,0.5,46,65,0.708,21,89,110,30,17,20,14,36,251
2020,Keita Bates-Diop,SF,24,DEN,7,0,98,13,28,0.464,3,9,0.333,10,19,0.526,8,10,0.8,4,13,17,0,2,4,3,7,37
2020,Kelan Martin,SF,24,MIN,31,4,495,71,181,0.392,25,96,0.26,46,85,0.541,30,31,0.968,12,84,96,23,7,9,20,51,197
2020,Keldon Johnson,SF,20,SAS,17,1,301,53,89,0.596,13,22,0.591,40,67,0.597,35,44,0.795,10,47,57,15,14,2,13,28,154
2020,Kelly Olynyk,C,28,MIA,67,9,1300,184,398,0.462,95,234,0.406,89,164,0.543,86,100,0.86,44,261,305,116,45,23,71,173,549
2020,Kelly Oubre Jr.,SF,24,PHO,56,55,1933,373,826,0.452,108,307,0.352,265,519,0.511,192,246,0.78,67,294,361,85,71,40,83,192,1046
2020,Kemba Walker,PG,29,BOS,56,56,1742,378,889,0.425,180,473,0.381,198,416,0.476,209,242,0.864,36,181,217,268,48,28,117,91,1145
2020,Kendrick Nunn,PG,24,MIA,67,67,1962,401,914,0.439,137,391,0.35,264,523,0.505,85,100,0.85,21,159,180,220,56,15,114,152,1024
2020,Kenrich Williams,PF,25,NOP,39,18,832,51,147,0.347,25,97,0.258,26,50,0.52,9,26,0.346,51,135,186,57,27,21,22,88,136
2020,Kent Bazemore,SF,30,TOT,68,21,1688,200,534,0.375,84,244,0.344,116,290,0.4,113,147,0.769,27,267,294,93,74,40,91,196,597
2020,Kent Bazemore,SF,30,POR,43,21,1111,113,326,0.347,56,171,0.327,57,155,0.368,58,72,0.806,13,159,172,61,45,31,60,121,340
2020,Kent Bazemore,SF,30,SAC,25,0,577,87,208,0.418,28,73,0.384,59,135,0.437,55,75,0.733,14,108,122,32,29,9,31,75,257
2020,Kentavious Caldwell-Pope,SG,26,LAL,69,26,1762,237,507,0.467,92,239,0.385,145,268,0.541,79,102,0.775,38,104,142,111,57,14,62,128,645
2020,Kevin Hervey,PF,23,OKC,10,0,52,7,27,0.259,3,20,0.15,4,7,0.571,0,0,,1,11,12,5,1,1,0,4,17
2020,Kevin Huerter,SG,21,ATL,56,48,1760,252,610,0.413,127,334,0.38,125,276,0.453,53,64,0.828,35,193,228,213,51,27,87,139,684
2020,Kevin Knox,SF,20,NYK,65,4,1166,144,401,0.359,65,199,0.327,79,202,0.391,66,101,0.653,28,156,184,61,23,28,45,106,419
2020,Kevin Love,PF,31,CLE,56,56,1780,327,727,0.45,146,390,0.374,181,337,0.537,187,219,0.854,54,493,547,178,33,19,140,90,987
2020,Kevin Porter Jr.,SF,19,CLE,50,3,1162,186,421,0.442,53,158,0.335,133,263,0.506,73,101,0.723,22,140,162,109,46,14,93,135,498
2020,Kevon Looney,C,23,GSW,20,4,262,29,79,0.367,1,14,0.071,28,65,0.431,9,12,0.75,28,38,66,20,12,6,12,34,68
2020,Khem Birch,C,27,ORL,48,24,922,73,143,0.51,0,1,0,73,142,0.514,66,101,0.653,91,129,220,50,20,23,31,91,212
2020,Khris Middleton,SF,28,MIL,62,59,1853,471,947,0.497,147,354,0.415,324,593,0.546,208,227,0.916,44,338,382,265,53,7,137,142,1297
2020,Khyri Thomas,SG,23,DET,8,0,61,5,17,0.294,5,14,0.357,0,3,0,2,4,0.5,1,0,1,3,3,0,3,9,17
2020,Kostas Antetokounmpo,PF,22,LAL,5,0,20,3,3,1,0,0,,3,3,1,1,2,0.5,2,1,3,2,0,0,1,2,7
2020,Kris Dunn,PG,25,CHI,51,32,1269,152,342,0.444,29,112,0.259,123,230,0.535,40,54,0.741,23,163,186,173,101,17,68,158,373
2020,Kristaps Porziņģis,C,24,DAL,57,57,1814,398,932,0.427,142,403,0.352,256,529,0.484,226,283,0.799,100,440,540,102,41,115,92,185,1164
2020,Ky Bowman,PG,22,GSW,45,12,1015,134,321,0.417,33,107,0.308,101,214,0.472,34,41,0.829,24,97,121,131,44,10,70,102,335
2020,Kyle Alexander,C,23,MIA,2,0,13,1,2,0.5,0,0,,1,2,0.5,0,0,,2,1,3,0,0,0,1,1,2
2020,Kyle Anderson,SF,26,MEM,67,28,1330,157,331,0.474,24,85,0.282,133,246,0.541,52,78,0.667,58,227,285,162,54,37,66,111,390
2020,Kyle Guy,SG,22,SAC,3,0,10,2,5,0.4,0,3,0,2,2,1,0,0,,0,1,1,1,0,0,0,1,4
2020,Kyle Korver,SF,38,MIL,58,1,960,126,293,0.43,99,237,0.418,27,56,0.482,35,41,0.854,15,107,122,68,26,12,48,78,386
2020,Kyle Kuzma,PF,24,LAL,61,9,1526,291,668,0.436,86,272,0.316,205,396,0.518,114,155,0.735,52,221,273,80,28,26,91,126,782
2020,Kyle Lowry,PG,33,TOR,58,58,2098,334,803,0.416,164,466,0.352,170,337,0.504,294,343,0.857,32,260,292,433,82,26,178,190,1126
2020,Kyle O'Quinn,C,29,PHI,29,2,313,42,85,0.494,7,27,0.259,35,58,0.603,11,20,0.55,34,82,116,51,7,24,20,37,102
2020,Kyrie Irving,PG,27,BRK,20,20,658,199,416,0.478,56,142,0.394,143,274,0.522,94,102,0.922,22,81,103,128,27,10,52,53,548
2020,KZ Okpala,PF,20,MIA,5,0,26,3,5,0.6,0,1,0,3,4,0.75,1,2,0.5,1,4,5,1,2,1,1,2,7
2020,LaMarcus Aldridge,C,34,SAS,53,53,1754,391,793,0.493,61,157,0.389,330,636,0.519,158,191,0.827,103,289,392,129,36,87,74,128,1001
2020,Lance Thomas,PF,31,BRK,7,4,98,8,23,0.348,4,13,0.308,4,10,0.4,4,4,1,2,11,13,6,0,0,6,11,24
2020,Landry Shamet,SG,22,LAC,53,30,1452,158,391,0.404,111,296,0.375,47,95,0.495,65,76,0.855,6,94,100,99,20,10,42,142,492
2020,Langston Galloway,SG,28,DET,66,6,1702,236,542,0.435,132,331,0.399,104,211,0.493,73,85,0.859,33,116,149,101,48,11,40,96,677
2020,Larry Nance Jr.,PF,27,CLE,56,10,1472,229,431,0.531,56,159,0.352,173,272,0.636,50,74,0.676,106,303,409,123,56,22,60,91,564
2020,Lauri Markkanen,PF,22,CHI,50,50,1492,251,591,0.425,109,317,0.344,142,274,0.518,126,153,0.824,60,253,313,74,42,23,81,96,737
2020,LeBron James,PG,35,LAL,67,67,2316,643,1303,0.493,148,425,0.348,495,878,0.564,264,381,0.693,66,459,525,684,78,36,261,118,1698
2020,Lonnie Walker IV,SG,21,SAS,61,12,988,152,357,0.426,41,101,0.406,111,256,0.434,44,61,0.721,23,116,139,68,32,14,44,78,389
2020,Lonzo Ball,PG,22,NOP,63,54,2025,277,687,0.403,148,395,0.375,129,292,0.442,43,76,0.566,71,312,383,438,88,38,193,128,745
2020,Lou Williams,PG,33,LAC,65,8,1864,391,936,0.418,111,315,0.352,280,621,0.451,292,339,0.861,31,170,201,365,43,12,182,80,1185
2020,Louis King,SF,20,DET,10,0,62,8,21,0.381,4,11,0.364,4,10,0.4,0,3,0,1,9,10,5,2,0,2,10,20
2020,Luc Mbah a Moute,PF,33,HOU,3,0,25,2,5,0.4,0,2,0,2,3,0.667,1,2,0.5,1,1,2,0,2,0,1,0,5
2020,Luguentz Dort,SF,20,OKC,36,28,820,86,218,0.394,30,101,0.297,56,117,0.479,42,53,0.792,24,57,81,27,31,4,22,97,244
2020,Luka Dončić,PG,20,DAL,61,61,2047,581,1255,0.463,171,541,0.316,410,714,0.574,426,562,0.758,78,495,573,538,62,14,260,153,1759
2020,Luka Šamanić,PF,20,SAS,3,1,48,5,16,0.313,3,8,0.375,2,8,0.25,3,4,0.75,1,9,10,6,0,2,2,6,16
2020,Luke Kennard,SG,23,DET,28,25,922,151,342,0.442,73,183,0.399,78,159,0.491,67,75,0.893,9,89,98,115,12,6,43,65,442
2020,Luke Kornet,C,24,CHI,36,14,559,82,187,0.439,31,108,0.287,51,79,0.646,20,28,0.714,22,62,84,32,11,26,14,54,215
2020,Malcolm Brogdon,PG,27,IND,54,54,1666,326,744,0.438,75,230,0.326,251,514,0.488,166,186,0.892,46,216,262,381,35,10,131,98,893
2020,Malcolm Miller,SF,26,TOR,28,1,162,12,29,0.414,8,22,0.364,4,7,0.571,3,8,0.375,2,14,16,11,5,2,4,18,35
2020,Malik Beasley,SG,23,TOT,55,14,1209,227,534,0.425,107,276,0.388,120,258,0.465,54,66,0.818,18,130,148,75,40,8,57,77,615
2020,Malik Beasley,SG,23,DEN,41,0,746,117,301,0.389,58,161,0.36,59,140,0.421,33,38,0.868,9,68,77,48,31,6,36,50,325
2020,Malik Beasley,SG,23,MIN,14,14,463,110,233,0.472,49,115,0.426,61,118,0.517,21,28,0.75,9,62,71,27,9,2,21,27,290
2020,Malik Monk,SG,21,CHO,55,1,1169,212,488,0.434,58,204,0.284,154,284,0.542,82,100,0.82,27,130,157,114,25,16,77,74,564
2020,Malik Newman,SG,22,CLE,1,0,4,0,2,0,0,1,0,0,1,0,2,2,1,0,0,0,0,0,0,1,0,2
2020,Marc Gasol,C,35,TOR,44,43,1161,119,279,0.427,57,148,0.385,62,131,0.473,36,49,0.735,31,244,275,147,34,38,59,124,331
2020,Marco Belinelli,SG,33,SAS,57,0,883,123,314,0.392,67,178,0.376,56,136,0.412,48,58,0.828,7,92,99,69,12,1,19,45,361
2020,Marcus Morris,SF-PF,30,TOT,62,62,1936,355,810,0.438,142,348,0.408,213,462,0.461,181,220,0.823,59,252,311,86,47,30,97,180,1033
2020,Marcus Morris,SF,30,NYK,43,43,1387,281,636,0.442,116,264,0.439,165,372,0.444,163,198,0.823,48,185,233,59,34,17,73,128,841
2020,Marcus Morris,PF,30,LAC,19,19,549,74,174,0.425,26,84,0.31,48,90,0.533,18,22,0.818,11,67,78,27,13,13,24,52,192
2020,Marcus Smart,SG,25,BOS,60,40,1919,256,682,0.375,137,395,0.347,119,287,0.415,127,152,0.836,42,183,225,291,101,29,103,162,776
2020,Marial Shayok,SG,24,PHI,4,0,28,3,12,0.25,2,6,0.333,1,6,0.167,3,4,0.75,1,6,7,1,0,1,3,4,11
2020,Mario Hezonja,PF,24,POR,53,4,871,92,218,0.422,24,78,0.308,68,140,0.486,48,59,0.814,30,154,184,50,36,9,42,107,256
2020,Markelle Fultz,PG,21,ORL,72,60,1996,359,772,0.465,36,135,0.267,323,637,0.507,116,159,0.73,41,197,238,369,90,11,147,142,870
2020,Markieff Morris,PF,30,TOT,58,17,1187,203,458,0.443,88,228,0.386,115,230,0.5,66,85,0.776,40,178,218,77,31,17,76,133,560
2020,Markieff Morris,PF,30,DET,44,16,988,175,389,0.45,75,189,0.397,100,200,0.5,61,79,0.772,24,149,173,69,26,11,70,104,486
2020,Markieff Morris,PF,30,LAL,14,1,199,28,69,0.406,13,39,0.333,15,30,0.5,5,6,0.833,16,29,45,8,5,6,6,29,74
2020,Marko Guduric,SG,24,MEM,44,0,484,62,157,0.395,25,83,0.301,37,74,0.5,24,26,0.923,14,59,73,45,12,8,36,34,173
2020,Marques Bolden,C,21,CLE,1,0,3,0,0,,0,0,,0,0,,0,0,,0,2,2,0,1,0,0,1,0
2020,Marquese Chriss,PF,22,GSW,59,21,1196,210,385,0.545,8,39,0.205,202,346,0.584,120,156,0.769,114,251,365,114,39,62,78,122,548
2020,Marvin Bagley III,C,20,SAC,13,6,334,78,167,0.467,4,22,0.182,74,145,0.51,25,31,0.806,29,68,97,10,6,12,18,43,185
2020,Marvin Williams,PF,33,TOT,58,1,1129,119,267,0.446,56,156,0.359,63,111,0.568,49,57,0.86,30,153,183,60,36,30,33,103,343
2020,Marvin Williams,PF,33,CHO,41,1,808,94,210,0.448,44,117,0.376,50,93,0.538,43,50,0.86,15,94,109,41,26,22,25,71,275
2020,Marvin Williams,PF,33,MIL,17,0,321,25,57,0.439,12,39,0.308,13,18,0.722,6,7,0.857,15,59,74,19,10,8,8,32,68
2020,Mason Plumlee,C,29,DEN,61,1,1057,177,288,0.615,0,5,0,177,283,0.625,83,155,0.535,98,219,317,154,33,38,82,143,437
2020,Matisse Thybulle,SG,22,PHI,65,14,1287,112,265,0.423,56,157,0.357,56,108,0.519,25,41,0.61,44,63,107,79,94,47,51,141,305
2020,Matt Mooney,SG,22,CLE,4,0,19,1,4,0.25,0,2,0,1,2,0.5,0,0,,0,3,3,1,2,1,0,1,2
2020,Matt Thomas,SG,25,TOR,41,1,440,73,150,0.487,47,99,0.475,26,51,0.51,9,12,0.75,9,52,61,22,10,1,16,38,202
2020,Matthew Dellavedova,PG,29,CLE,57,4,821,62,175,0.354,21,91,0.231,41,84,0.488,32,37,0.865,18,57,75,180,20,2,59,78,177
2020,Maurice Harkless,PF-SF,26,TOT,62,48,1427,142,283,0.502,34,98,0.347,108,185,0.584,39,66,0.591,55,185,240,68,58,33,53,148,357
2020,Maurice Harkless,PF,26,LAC,50,38,1141,112,217,0.516,27,73,0.37,85,144,0.59,24,42,0.571,47,153,200,48,49,30,46,120,275
2020,Maurice Harkless,SF,26,NYK,12,10,286,30,66,0.455,7,25,0.28,23,41,0.561,15,24,0.625,8,32,40,20,9,3,7,28,82
2020,Max Strus,SF,23,CHI,2,0,6,2,3,0.667,0,1,0,2,2,1,1,1,1,1,0,1,0,0,0,0,1,5
2020,Maxi Kleber,PF,28,DAL,74,21,1890,237,514,0.461,119,319,0.373,118,195,0.605,79,93,0.849,112,276,388,88,25,83,58,176,672
2020,Melvin Frazier,SG,23,ORL,19,0,126,15,34,0.441,8,16,0.5,7,18,0.389,2,4,0.5,2,8,10,3,9,2,5,11,40
2020,Meyers Leonard,C,27,MIA,51,49,1034,119,234,0.509,53,128,0.414,66,106,0.623,18,28,0.643,30,230,260,55,14,15,39,107,309
2020,Mfiondu Kabengele,C,22,LAC,12,0,64,14,32,0.438,9,20,0.45,5,12,0.417,5,5,1,1,10,11,2,2,2,2,9,42
2020,Michael Carter-Williams,SG,28,ORL,45,0,833,111,260,0.427,22,75,0.293,89,185,0.481,79,95,0.832,46,101,147,109,49,22,52,87,323
2020,Michael Frazier,SG,25,HOU,13,0,145,7,29,0.241,4,23,0.174,3,6,0.5,9,14,0.643,1,9,10,2,2,0,5,22,27
2020,Michael Kidd-Gilchrist,PF,26,TOT,25,0,281,22,66,0.333,5,20,0.25,17,46,0.37,11,14,0.786,14,53,67,14,2,6,16,37,60
2020,Michael Kidd-Gilchrist,PF,26,CHO,12,0,160,18,53,0.34,5,17,0.294,13,36,0.361,7,9,0.778,9,26,35,10,0,3,7,18,48
2020,Michael Kidd-Gilchrist,PF,26,DAL,13,0,121,4,13,0.308,0,3,0,4,10,0.4,4,5,0.8,5,27,32,4,2,3,9,19,12
2020,Michael Porter Jr.,SF,21,DEN,55,8,903,195,383,0.509,62,147,0.422,133,236,0.564,60,72,0.833,66,193,259,46,27,25,49,100,512
2020,Mikal Bridges,SF,23,PHO,73,32,2042,247,484,0.51,70,194,0.361,177,290,0.61,103,122,0.844,66,226,292,129,102,46,73,163,667
2020,Mike Conley,PG,32,UTA,47,41,1363,232,567,0.409,96,256,0.375,136,311,0.437,115,139,0.827,33,118,151,208,36,5,92,104,675
2020,Mike Muscala,C,28,OKC,47,2,572,77,189,0.407,54,143,0.378,23,46,0.5,18,22,0.818,16,92,108,40,9,12,17,58,226
2020,Mike Scott,PF,31,PHI,68,11,1207,149,350,0.426,80,217,0.369,69,133,0.519,30,37,0.811,65,183,248,56,21,5,26,96,408
2020,Miles Bridges,SF,21,CHO,65,64,1995,319,753,0.424,99,300,0.33,220,453,0.486,106,131,0.809,88,274,362,114,40,48,95,132,843
2020,Mitchell Robinson,C,21,NYK,61,7,1412,253,341,0.742,0,0,,253,341,0.742,84,148,0.568,186,242,428,36,52,119,37,194,590
2020,Miye Oni,SF,22,UTA,10,1,109,12,32,0.375,7,19,0.368,5,13,0.385,4,5,0.8,5,12,17,4,4,2,4,9,35
2020,Mo Bamba,C,21,ORL,62,0,878,132,286,0.462,37,107,0.346,95,179,0.531,31,46,0.674,100,202,302,42,23,86,42,116,332
2020,Monte Morris,PG,24,DEN,73,12,1636,260,566,0.459,65,172,0.378,195,394,0.495,75,89,0.843,24,113,137,255,55,17,53,73,660
2020,Montrezl Harrell,C,26,LAC,63,2,1749,471,812,0.58,0,18,0,471,794,0.593,231,351,0.658,163,282,445,107,39,72,108,146,1173
2020,Moritz Wagner,C,22,WAS,45,5,835,145,266,0.545,25,80,0.313,120,186,0.645,78,95,0.821,56,163,219,56,28,19,66,152,393
2020,Moses Brown,C,20,POR,9,0,33,4,10,0.4,0,0,,4,10,0.4,3,8,0.375,3,11,14,1,1,1,3,7,11
2020,Mychal Mulder,SF,25,GSW,7,3,204,26,67,0.388,16,52,0.308,10,15,0.667,9,12,0.75,3,20,23,8,2,1,5,20,77
2020,Myles Turner,C,23,IND,62,62,1826,268,587,0.457,86,250,0.344,182,337,0.54,127,169,0.751,86,321,407,72,46,132,85,166,749
2020,Nassir Little,PF,19,POR,48,5,573,65,151,0.43,14,59,0.237,51,92,0.554,28,44,0.636,31,77,108,22,13,14,15,72,172
2020,Naz Mitrou-Long,SG,26,IND,5,0,47,6,17,0.353,2,12,0.167,4,5,0.8,0,0,,0,7,7,8,1,1,3,2,14
2020,Naz Reid,C,20,MIN,30,11,495,100,243,0.412,32,97,0.33,68,146,0.466,37,53,0.698,34,90,124,35,19,22,22,83,269
2020,Nemanja Bjelica,PF,31,SAC,72,67,2011,314,653,0.481,134,320,0.419,180,333,0.541,69,84,0.821,111,347,458,203,62,40,99,216,831
2020,Nerlens Noel,C,25,OKC,61,7,1127,184,269,0.684,1,3,0.333,183,266,0.688,80,106,0.755,91,209,300,57,59,91,66,166,449
2020,Nic Claxton,C,20,BRK,15,0,187,27,48,0.563,1,7,0.143,26,41,0.634,11,21,0.524,19,25,44,16,1,8,9,14,66
2020,Nickeil Alexander-Walker,SG,21,NOP,47,1,591,98,266,0.368,46,133,0.346,52,133,0.391,25,37,0.676,9,75,84,89,17,8,54,57,267
2020,Nicolas Batum,SF,31,CHO,22,3,505,28,81,0.346,14,49,0.286,14,32,0.438,9,10,0.9,25,75,100,66,17,8,22,41,79
2020,Nicolò Melli,C,29,NOP,60,8,1042,136,323,0.421,69,206,0.335,67,117,0.573,54,73,0.74,38,142,180,82,34,23,46,124,395
2020,Nigel Williams-Goss,PG,25,UTA,10,0,50,5,16,0.313,2,7,0.286,3,9,0.333,2,2,1,2,4,6,6,3,1,3,6,14
2020,Nikola Jokić,C,24,DEN,73,73,2336,565,1071,0.528,80,255,0.314,485,816,0.594,246,301,0.817,166,545,711,512,85,44,226,222,1456
2020,Nikola Vučević,C,29,ORL,62,62,1998,493,1033,0.477,98,289,0.339,395,744,0.531,131,167,0.784,140,533,673,222,54,47,88,135,1215
2020,Noah Vonleh,C,24,TOT,36,1,377,52,92,0.565,3,15,0.2,49,77,0.636,25,32,0.781,37,87,124,28,11,6,21,40,132
2020,Noah Vonleh,C,24,MIN,29,1,347,47,86,0.547,2,14,0.143,45,72,0.625,23,28,0.821,34,82,116,26,11,6,19,36,119
2020,Noah Vonleh,C,24,DEN,7,0,30,5,6,0.833,1,1,1,4,5,0.8,2,4,0.5,3,5,8,2,0,0,2,4,13
2020,Norman Powell,SG,26,TOR,52,26,1479,296,598,0.495,109,273,0.399,187,325,0.575,129,153,0.843,26,164,190,91,60,21,77,108,830
2020,Norvel Pelle,C,26,PHI,24,0,232,25,48,0.521,0,1,0,25,47,0.532,7,14,0.5,20,52,72,8,3,31,18,55,57
2020,OG Anunoby,SF,22,TOR,69,68,2066,286,566,0.505,89,228,0.39,197,338,0.583,72,102,0.706,80,284,364,108,96,45,79,167,733
2020,Omari Spellman,C,22,GSW,49,3,886,127,295,0.431,43,110,0.391,84,185,0.454,73,92,0.793,77,142,219,47,33,24,54,63,370
2020,Oshae Brissett,SF,21,TOR,19,0,135,13,36,0.361,3,15,0.2,10,21,0.476,8,10,0.8,9,17,26,7,4,1,7,18,37
2020,Otto Porter Jr.,SF,26,CHI,14,9,331,62,140,0.443,24,62,0.387,38,78,0.487,19,27,0.704,13,35,48,25,15,6,11,31,167
2020,P.J. Tucker,PF,34,HOU,72,72,2467,177,426,0.415,107,299,0.358,70,127,0.551,39,48,0.813,112,364,476,115,77,36,72,229,500
2020,P.J. Washington,PF,21,CHO,58,57,1759,268,589,0.455,86,230,0.374,182,359,0.507,88,136,0.647,58,258,316,123,51,44,93,158,710
2020,Pascal Siakam,PF,25,TOR,60,60,2110,500,1104,0.453,131,365,0.359,369,739,0.499,240,303,0.792,64,375,439,207,61,53,148,170,1371
2020,Pat Connaughton,SG,27,MIL,67,4,1243,137,301,0.455,55,166,0.331,82,135,0.607,31,40,0.775,60,224,284,107,25,31,52,70,360
2020,Patrick Beverley,PG,31,LAC,51,50,1342,147,341,0.431,80,206,0.388,67,135,0.496,31,47,0.66,57,209,266,183,54,25,66,156,405
2020,Patrick McCaw,SF,24,TOR,37,12,908,67,162,0.414,23,71,0.324,44,91,0.484,13,18,0.722,19,67,86,79,39,4,29,60,170
2020,Patrick Patterson,PF,30,LAC,59,18,776,95,233,0.408,67,172,0.39,28,61,0.459,35,43,0.814,35,116,151,41,7,3,21,54,292
2020,Patty Mills,PG,31,SAS,66,1,1485,258,598,0.431,154,403,0.382,104,195,0.533,97,112,0.866,22,86,108,118,53,6,54,105,767
2020,Paul George,SF,29,LAC,48,48,1419,343,782,0.439,157,381,0.412,186,401,0.464,190,217,0.876,24,248,272,185,68,20,125,113,1033
2020,Paul Millsap,PF,34,DEN,51,48,1240,211,438,0.482,54,124,0.435,157,314,0.5,115,141,0.816,98,195,293,83,44,30,70,150,591
2020,Paul Watson,SF,25,TOT,10,0,87,10,26,0.385,4,12,0.333,6,14,0.429,7,9,0.778,2,15,17,8,4,1,3,5,31
2020,Paul Watson,SF,25,ATL,2,0,17,0,7,0,0,3,0,0,4,0,0,0,,0,2,2,3,1,0,0,1,0
2020,Paul Watson,SF,25,TOR,8,0,70,10,19,0.526,4,9,0.444,6,10,0.6,7,9,0.778,2,13,15,5,3,1,3,4,31
2020,PJ Dozier,SG,23,DEN,29,0,412,65,157,0.414,17,49,0.347,48,108,0.444,21,29,0.724,10,45,55,63,14,6,27,45,168
2020,Quinn Cook,PG,26,LAL,44,1,508,91,214,0.425,31,85,0.365,60,129,0.465,11,14,0.786,11,40,51,49,12,2,33,27,224
2020,Quinndary Weatherspoon,SG,23,SAS,11,0,78,5,17,0.294,1,5,0.2,4,12,0.333,1,2,0.5,1,6,7,11,3,1,5,8,12
2020,Rajon Rondo,PG,33,LAL,48,3,984,137,328,0.418,41,125,0.328,96,203,0.473,27,41,0.659,23,119,142,240,40,2,91,58,342
2020,Raul Neto,PG,27,PHI,54,3,668,101,222,0.455,34,88,0.386,67,134,0.5,39,47,0.83,11,50,61,95,24,6,47,50,275
2020,Rayjon Tucker,SG,22,UTA,20,0,161,20,43,0.465,3,17,0.176,17,26,0.654,19,23,0.826,3,17,20,5,1,1,8,10,62
2020,Reggie Bullock,SG,28,NYK,29,19,684,90,224,0.402,37,111,0.333,53,113,0.469,17,21,0.81,13,55,68,42,25,3,19,56,234
2020,Reggie Jackson,SG-PG,29,TOT,31,16,743,134,326,0.411,57,145,0.393,77,181,0.425,45,54,0.833,17,75,92,126,13,5,51,59,370
2020,Reggie Jackson,PG,29,DET,14,10,381,76,198,0.384,31,82,0.378,45,116,0.388,26,33,0.788,11,30,41,72,8,1,23,21,209
2020,Reggie Jackson,SG,29,LAC,17,6,362,58,128,0.453,26,63,0.413,32,65,0.492,19,21,0.905,6,45,51,54,5,4,28,38,161
2020,Richaun Holmes,C,26,SAC,44,38,1242,223,344,0.648,0,0,,223,344,0.648,93,118,0.788,127,231,358,42,41,56,52,169,539
2020,Ricky Rubio,PG,29,PHO,65,65,2016,287,692,0.415,78,216,0.361,209,476,0.439,195,226,0.863,46,258,304,570,94,11,173,167,847
2020,RJ Barrett,SG,19,NYK,56,55,1704,292,727,0.402,63,197,0.32,229,530,0.432,156,254,0.614,50,229,279,143,55,17,124,122,803
2020,Robert Covington,PF-C,29,TOT,70,68,2137,305,723,0.422,161,480,0.335,144,243,0.593,99,124,0.798,63,400,463,88,115,93,103,220,870
2020,Robert Covington,PF,29,MIN,48,47,1411,216,496,0.435,108,312,0.346,108,184,0.587,75,94,0.798,36,251,287,56,80,45,73,148,615
2020,Robert Covington,C,29,HOU,22,21,726,89,227,0.392,53,168,0.315,36,59,0.61,24,30,0.8,27,149,176,32,35,48,30,72,255
2020,Robert Williams,C,22,BOS,29,1,388,64,88,0.727,0,0,,64,88,0.727,22,34,0.647,40,88,128,27,22,35,21,51,150
2020,Robin Lopez,C,31,MIL,66,5,958,147,299,0.492,35,105,0.333,112,194,0.577,28,53,0.528,56,105,161,45,10,45,63,96,357
2020,Rodions Kurucs,PF,21,BRK,47,9,684,79,177,0.446,33,90,0.367,46,87,0.529,24,38,0.632,25,112,137,51,25,5,46,90,215
2020,Rodney Hood,SF,27,POR,21,21,619,87,172,0.506,35,71,0.493,52,101,0.515,21,27,0.778,10,62,72,32,17,4,19,46,230
2020,Rodney McGruder,SG,28,LAC,56,4,871,72,181,0.398,24,89,0.27,48,92,0.522,19,34,0.559,29,122,151,36,26,8,24,74,187
2020,Romeo Langford,SG,20,BOS,32,2,370,28,80,0.35,5,27,0.185,23,53,0.434,18,25,0.72,15,26,41,13,8,8,11,33,79
2020,Rondae Hollis-Jefferson,PF,25,TOR,60,6,1122,155,329,0.471,3,23,0.13,152,306,0.497,105,143,0.734,110,173,283,106,46,23,59,115,418
2020,Royce O'Neale,SF,26,UTA,71,62,2049,158,365,0.433,92,244,0.377,66,121,0.545,42,55,0.764,27,362,389,180,59,32,61,202,450
2020,Rudy Gay,PF,33,SAS,67,5,1461,266,596,0.446,74,220,0.336,192,376,0.511,120,136,0.882,61,301,362,114,35,33,88,103,726
2020,Rudy Gobert,C,27,UTA,68,68,2333,386,557,0.693,0,0,,386,557,0.693,254,403,0.63,230,686,916,101,51,135,130,215,1026
2020,Rui Hachimura,PF,21,WAS,48,48,1444,254,545,0.466,25,87,0.287,229,458,0.5,116,140,0.829,78,216,294,87,37,8,53,105,649
2020,Russell Westbrook,PG,31,HOU,57,57,2049,604,1281,0.472,55,213,0.258,549,1068,0.514,290,380,0.763,100,351,451,401,93,20,255,200,1553
2020,Ryan Anderson,C,31,HOU,2,0,14,2,7,0.286,1,5,0.2,1,2,0.5,0,0,,0,7,7,2,1,0,1,1,5
2020,Ryan Arcidiacono,PG,25,CHI,58,4,930,90,220,0.409,54,138,0.391,36,82,0.439,27,38,0.711,20,90,110,96,27,3,37,96,261
2020,Ryan Broekhoff,SF,29,DAL,17,1,180,22,59,0.373,20,51,0.392,2,8,0.25,7,8,0.875,5,38,43,11,5,4,6,15,71
2020,Sekou Doumbouya,PF,19,DET,38,19,754,92,236,0.39,28,98,0.286,64,138,0.464,31,46,0.674,20,98,118,19,20,8,35,80,243
2020,Semi Ojeleye,PF,25,BOS,69,6,1011,80,196,0.408,48,127,0.378,32,69,0.464,28,32,0.875,26,119,145,37,21,5,19,80,236
2020,Serge Ibaka,C,30,TOR,55,27,1485,343,670,0.512,70,182,0.385,273,488,0.559,89,124,0.718,114,338,452,77,28,46,109,153,845
2020,Seth Curry,SG,29,DAL,64,25,1576,284,574,0.495,145,321,0.452,139,253,0.549,80,97,0.825,27,118,145,124,38,9,62,113,793
2020,Shabazz Napier,PG,28,TOT,56,32,1344,188,456,0.412,76,240,0.317,112,216,0.519,126,153,0.824,26,132,158,262,69,11,128,101,578
2020,Shabazz Napier,PG,28,MIN,36,22,856,114,283,0.403,47,159,0.296,67,124,0.54,72,88,0.818,17,93,110,187,40,7,76,62,347
2020,Shabazz Napier,PG,28,WAS,20,10,488,74,173,0.428,29,81,0.358,45,92,0.489,54,65,0.831,9,39,48,75,29,4,52,39,231
2020,Shai Gilgeous-Alexander,SG,21,OKC,70,70,2428,478,1015,0.471,87,251,0.347,391,764,0.512,288,357,0.807,47,365,412,232,79,47,134,117,1331
2020,Shake Milton,SG,23,PHI,40,24,805,134,277,0.484,58,135,0.43,76,142,0.535,51,65,0.785,15,73,88,104,20,7,47,92,377
2020,Shamorie Ponds,PG,21,TOR,4,0,11,3,5,0.6,1,2,0.5,2,3,0.667,2,2,1,0,1,1,2,0,1,0,2,9
2020,Shaquille Harrison,SG,26,CHI,43,10,484,77,165,0.467,16,42,0.381,61,123,0.496,39,50,0.78,22,64,86,49,34,19,19,55,209
2020,Sindarius Thornwell,SF,25,NOP,2,0,35,6,11,0.545,2,4,0.5,4,7,0.571,2,4,0.5,0,4,4,4,1,1,2,2,16
2020,Skal Labissière,C,23,POR,33,1,567,81,147,0.551,3,13,0.231,78,134,0.582,25,33,0.758,65,104,169,42,7,31,30,89,190
2020,Solomon Hill,PF,28,TOT,59,4,1088,110,278,0.396,63,171,0.368,47,107,0.439,40,54,0.741,29,136,165,104,43,12,51,85,323
2020,Solomon Hill,PF,28,MEM,48,3,901,96,233,0.412,56,147,0.381,40,86,0.465,26,38,0.684,24,120,144,94,31,7,40,73,274
2020,Solomon Hill,PF,28,MIA,11,1,187,14,45,0.311,7,24,0.292,7,21,0.333,14,16,0.875,5,16,21,10,12,5,11,12,49
2020,Spencer Dinwiddie,PG,26,BRK,64,49,1994,424,1021,0.415,123,400,0.308,301,621,0.485,347,446,0.778,32,189,221,432,40,21,174,180,1318
2020,Stanley Johnson,PF,23,TOR,25,0,150,22,59,0.373,7,24,0.292,15,35,0.429,9,16,0.563,7,30,37,20,6,4,15,16,60
2020,Stanton Kidd,SG,27,UTA,4,0,15,0,3,0,0,1,0,0,2,0,0,0,,0,3,3,1,0,0,2,3,0
2020,Stephen Curry,PG,31,GSW,5,5,139,33,82,0.402,12,49,0.245,21,33,0.636,26,26,1,4,22,26,33,5,2,16,11,104
2020,Sterling Brown,SF,24,MIL,52,1,767,95,256,0.371,44,136,0.324,51,120,0.425,32,40,0.8,31,152,183,51,29,7,42,54,266
2020,Steven Adams,C,26,OKC,63,63,1680,283,478,0.592,1,3,0.333,282,475,0.594,117,201,0.582,207,376,583,146,51,67,94,122,684
2020,Svi Mykhailiuk,SF,22,DET,56,27,1265,166,405,0.41,115,285,0.404,51,120,0.425,57,70,0.814,17,87,104,106,41,4,61,87,504
2020,T.J. Leaf,PF,22,IND,28,1,222,36,86,0.419,5,18,0.278,31,68,0.456,7,16,0.438,23,48,71,9,10,4,8,22,84
2020,T.J. McConnell,PG,27,IND,71,3,1326,212,411,0.516,5,17,0.294,207,394,0.525,35,42,0.833,38,151,189,355,56,11,100,73,464
2020,T.J. Warren,SF,26,IND,67,67,2202,534,997,0.536,91,226,0.403,443,771,0.575,167,204,0.819,68,212,280,99,78,34,84,187,1326
2020,Tacko Fall,C,24,BOS,7,0,33,11,14,0.786,0,0,,11,14,0.786,1,3,0.333,1,14,15,1,1,4,3,7,23
2020,Taj Gibson,C,34,NYK,62,56,1025,167,286,0.584,4,14,0.286,163,272,0.599,41,56,0.732,111,156,267,52,27,30,47,122,379
2020,Talen Horton-Tucker,SG,19,LAL,6,1,81,14,30,0.467,4,13,0.308,10,17,0.588,2,4,0.5,2,5,7,6,8,1,6,10,34
2020,Tariq Owens,PF,24,PHO,3,0,15,1,5,0.2,0,2,0,1,3,0.333,2,2,1,2,1,3,0,1,0,0,1,4
2020,Taurean Prince,PF,25,BRK,64,61,1857,278,739,0.376,146,431,0.339,132,308,0.429,71,89,0.798,50,331,381,116,57,25,127,159,773
2020,Terance Mann,SF,23,LAC,41,6,362,37,79,0.468,7,20,0.35,30,59,0.508,18,27,0.667,10,45,55,53,11,5,18,46,99
2020,Terence Davis,SG,22,TOR,72,4,1209,199,436,0.456,94,242,0.388,105,194,0.541,51,59,0.864,50,187,237,115,39,14,76,124,543
2020,Terrance Ferguson,SF,21,OKC,56,38,1257,78,220,0.355,49,168,0.292,29,52,0.558,15,20,0.75,23,51,74,51,27,17,31,155,220
2020,Terrence Ross,SG,28,ORL,69,0,1889,341,846,0.403,177,504,0.351,164,342,0.48,157,184,0.853,13,209,222,82,77,24,70,109,1016
2020,Terry Rozier,PG,25,CHO,63,63,2164,398,941,0.423,172,423,0.407,226,518,0.436,166,190,0.874,50,226,276,259,61,10,141,126,1134
2020,Thabo Sefolosha,PF,35,HOU,41,0,436,37,91,0.407,15,54,0.278,22,37,0.595,3,8,0.375,21,72,93,25,24,12,15,43,92
2020,Thaddeus Young,PF,31,CHI,64,16,1591,269,601,0.448,79,222,0.356,190,379,0.501,42,72,0.583,94,221,315,117,92,23,102,134,659
2020,Thanasis Antetokounmpo,SF,27,MIL,20,2,129,24,48,0.5,0,10,0,24,38,0.632,7,17,0.412,12,12,24,15,7,2,12,18,55
2020,Theo Pinson,SG,24,BRK,33,0,365,45,155,0.29,15,80,0.188,30,75,0.4,15,16,0.938,10,44,54,56,17,4,33,35,120
2020,Thomas Bryant,C,22,WAS,46,36,1147,243,418,0.581,37,91,0.407,206,327,0.63,86,116,0.741,98,233,331,83,25,49,53,103,609
2020,Thon Maker,C,22,DET,60,14,776,93,193,0.482,22,64,0.344,71,129,0.55,73,110,0.664,54,113,167,43,25,39,45,102,281
2020,Tim Frazier,PG,29,DET,27,11,355,34,94,0.362,10,30,0.333,24,64,0.375,19,24,0.792,9,24,33,93,14,4,36,42,97
2020,Tim Hardaway Jr.,SG,27,DAL,71,58,2091,384,884,0.434,204,513,0.398,180,371,0.485,149,182,0.819,25,207,232,137,41,5,69,125,1121
2020,Timothé Luwawu-Cabarrot,SF,24,BRK,47,2,853,117,269,0.435,62,160,0.388,55,109,0.505,69,81,0.852,29,98,127,29,18,7,37,106,365
2020,Tobias Harris,PF,27,PHI,72,72,2469,553,1173,0.471,131,357,0.367,422,816,0.517,174,216,0.806,69,426,495,227,53,40,104,165,1411
2020,Tomáš Satoranský,SG,28,CHI,65,64,1878,237,551,0.43,64,199,0.322,173,352,0.491,106,121,0.876,76,178,254,354,80,7,130,135,644
2020,Tony Bradley,C,22,UTA,58,3,663,126,189,0.667,3,3,1,123,186,0.661,30,46,0.652,111,156,267,23,14,33,30,115,285
2020,Tony Snell,SF,28,DET,59,57,1641,170,382,0.445,102,254,0.402,68,128,0.531,32,32,1,9,102,111,127,32,15,31,101,474
2020,Torrey Craig,SF,29,DEN,58,27,1072,124,269,0.461,45,138,0.326,79,131,0.603,22,36,0.611,63,126,189,47,23,36,25,135,315
2020,Trae Young,PG,21,ATL,60,60,2120,546,1249,0.437,205,568,0.361,341,681,0.501,481,559,0.86,32,223,255,560,65,8,289,104,1778
2020,Tremont Waters,PG,22,BOS,11,1,119,14,49,0.286,4,24,0.167,10,25,0.4,8,8,1,0,12,12,16,10,2,15,13,40
2020,Treveon Graham,SF,26,TOT,55,20,929,87,242,0.36,33,120,0.275,54,122,0.443,36,56,0.643,51,99,150,45,24,6,29,102,243
2020,Treveon Graham,SF,26,MIN,33,20,663,62,175,0.354,20,83,0.241,42,92,0.457,27,37,0.73,29,71,100,30,17,2,19,66,171
2020,Treveon Graham,SF,26,ATL,22,0,266,25,67,0.373,13,37,0.351,12,30,0.4,9,19,0.474,22,28,50,15,7,4,10,36,72
2020,Trevor Ariza,SF,34,TOT,53,21,1493,142,324,0.438,77,207,0.372,65,117,0.556,62,74,0.838,34,212,246,91,69,15,56,111,423
2020,Trevor Ariza,SF,34,SAC,32,0,791,64,165,0.388,43,122,0.352,21,43,0.488,21,27,0.778,21,125,146,50,35,7,28,63,192
2020,Trevor Ariza,SF,34,POR,21,21,702,78,159,0.491,34,85,0.4,44,74,0.595,41,47,0.872,13,87,100,41,34,8,28,48,231
2020,Trey Burke,PG,27,TOT,33,1,520,94,209,0.45,32,75,0.427,62,134,0.463,23,29,0.793,16,34,50,83,16,2,21,33,243
2020,Trey Burke,PG,27,PHI,25,0,329,59,127,0.465,16,38,0.421,43,89,0.483,13,18,0.722,15,20,35,53,7,1,12,21,147
2020,Trey Burke,PG,27,DAL,8,1,191,35,82,0.427,16,37,0.432,19,45,0.422,10,11,0.909,1,14,15,30,9,1,9,12,96
2020,Trey Lyles,PF,24,SAS,63,53,1271,153,343,0.446,65,168,0.387,88,175,0.503,33,45,0.733,71,290,361,69,28,28,39,98,404
2020,Tristan Thompson,PF,28,CLE,57,51,1721,288,562,0.512,9,23,0.391,279,539,0.518,99,161,0.615,226,351,577,120,33,50,103,124,684
2020,Troy Brown Jr.,SF,20,WAS,69,22,1782,273,622,0.439,61,179,0.341,212,443,0.479,109,139,0.784,76,307,383,178,85,7,79,132,716
2020,Troy Daniels,SG,28,TOT,47,0,532,72,186,0.387,46,132,0.348,26,54,0.481,10,16,0.625,12,40,52,17,11,3,12,37,200
2020,Troy Daniels,SG,28,LAL,41,0,456,62,158,0.392,40,112,0.357,22,46,0.478,10,16,0.625,12,34,46,14,8,3,9,30,174
2020,Troy Daniels,SG,28,DEN,6,0,76,10,28,0.357,6,20,0.3,4,8,0.5,0,0,,0,6,6,3,3,0,3,7,26
2020,Ty Jerome,SG,22,PHO,31,0,328,38,113,0.336,14,50,0.28,24,63,0.381,12,16,0.75,7,39,46,44,15,3,18,29,102
2020,Tyler Cook,PF-SF,22,TOT,13,0,54,8,12,0.667,0,0,,8,12,0.667,7,8,0.875,6,8,14,1,3,0,3,5,23
2020,Tyler Cook,PF,22,CLE,11,0,35,7,10,0.7,0,0,,7,10,0.7,5,6,0.833,4,6,10,1,1,0,1,4,19
2020,Tyler Cook,SF,22,DEN,2,0,19,1,2,0.5,0,0,,1,2,0.5,2,2,1,2,2,4,0,2,0,2,1,4
2020,Tyler Herro,SG,20,MIA,55,8,1508,270,631,0.428,116,298,0.389,154,333,0.462,87,100,0.87,16,208,224,121,34,9,87,76,743
2020,Tyler Johnson,PG-SG,27,TOT,39,7,709,97,250,0.388,38,119,0.319,59,131,0.45,42,50,0.84,18,58,76,74,16,9,29,58,274
2020,Tyler Johnson,PG,27,PHO,31,3,515,65,171,0.38,24,83,0.289,41,88,0.466,24,32,0.75,10,42,52,50,12,8,24,43,178
2020,Tyler Johnson,SG,27,BRK,8,4,194,32,79,0.405,14,36,0.389,18,43,0.419,18,18,1,8,16,24,24,4,1,5,15,96
2020,Tyler Zeller,C,30,SAS,2,0,4,1,4,0.25,0,0,,1,4,0.25,0,0,,3,1,4,0,0,0,0,0,2
2020,Tyrone Wallace,SG,25,ATL,14,0,160,14,44,0.318,1,15,0.067,13,29,0.448,11,17,0.647,3,19,22,13,7,1,10,19,40
2020,Tyson Chandler,C,37,HOU,26,5,219,14,18,0.778,0,0,,14,18,0.778,6,13,0.462,25,41,66,6,6,8,8,32,34
2020,Tyus Jones,PG,23,MEM,65,6,1232,197,429,0.459,47,124,0.379,150,305,0.492,43,58,0.741,9,94,103,285,59,6,55,44,484
2020,Udonis Haslem,C,39,MIA,4,1,44,4,11,0.364,1,3,0.333,3,8,0.375,3,4,0.75,1,15,16,1,0,0,1,6,12
2020,Vic Law,PF,24,ORL,8,0,62,6,18,0.333,1,7,0.143,5,11,0.455,2,6,0.333,2,9,11,3,2,0,2,6,15
2020,Victor Oladipo,SG,27,IND,19,16,528,97,246,0.394,33,104,0.317,64,142,0.451,48,59,0.814,9,66,75,56,17,4,47,36,275
2020,Vince Carter,PF,43,ATL,60,0,876,107,304,0.352,61,202,0.302,46,102,0.451,23,29,0.793,18,106,124,48,23,25,33,90,298
2020,Vincent Poirier,C,26,BOS,22,0,130,17,36,0.472,1,2,0.5,16,34,0.471,6,7,0.857,13,30,43,8,2,9,8,25,41
2020,Vlatko Čančar,PF,22,DEN,14,0,45,6,15,0.4,1,6,0.167,5,9,0.556,4,4,1,5,5,10,3,1,1,3,7,17
2020,Wayne Ellington,SG,32,NYK,36,1,558,61,174,0.351,50,143,0.35,11,31,0.355,11,13,0.846,4,61,65,44,13,4,18,41,183
2020,Wendell Carter Jr.,C,20,CHI,43,43,1256,183,343,0.534,6,29,0.207,177,314,0.564,112,152,0.737,139,266,405,51,33,36,72,162,484
2020,Wenyen Gabriel,PF,22,TOT,30,1,235,21,48,0.438,6,20,0.3,15,28,0.536,15,22,0.682,21,31,52,8,11,7,16,39,63
2020,Wenyen Gabriel,PF,22,SAC,11,0,61,6,17,0.353,1,8,0.125,5,9,0.556,6,10,0.6,4,6,10,3,3,2,5,7,19
2020,Wenyen Gabriel,PF,22,POR,19,1,174,15,31,0.484,5,12,0.417,10,19,0.526,9,12,0.75,17,25,42,5,8,5,11,32,44
2020,Wes Iwundu,SF,25,ORL,52,21,953,97,233,0.416,28,82,0.341,69,151,0.457,78,97,0.804,24,107,131,60,25,13,26,80,300
2020,Wesley Matthews,SG,33,MIL,67,67,1635,167,422,0.396,108,297,0.364,59,125,0.472,52,68,0.765,22,144,166,92,38,9,43,103,494
2020,Will Barton,SF,29,DEN,58,58,1916,332,738,0.45,108,288,0.375,224,450,0.498,102,133,0.767,76,289,365,212,61,29,88,121,874
2020,William Howard,PF,26,HOU,2,0,13,0,4,0,0,4,0,0,0,,0,0,,0,2,2,1,0,0,1,1,0
2020,Willie Cauley-Stein,C,26,TOT,54,39,1097,175,302,0.579,0,1,0,175,301,0.581,40,66,0.606,84,231,315,70,49,61,40,121,390
2020,Willie Cauley-Stein,C,26,GSW,41,37,940,144,257,0.56,0,0,,144,257,0.56,35,57,0.614,71,184,255,60,45,50,35,102,323
2020,Willie Cauley-Stein,C,26,DAL,13,2,157,31,45,0.689,0,1,0,31,44,0.705,5,9,0.556,13,47,60,10,4,11,5,19,67
2020,Willy Hernangómez,C,25,CHO,31,0,375,74,139,0.532,5,22,0.227,69,117,0.59,37,59,0.627,43,91,134,29,10,7,30,32,190
2020,Wilson Chandler,PF,32,BRK,35,3,734,74,183,0.404,37,121,0.306,37,62,0.597,20,23,0.87,11,134,145,39,16,12,34,79,205
2020,Yogi Ferrell,PG,26,SAC,50,0,530,79,188,0.42,24,79,0.304,55,109,0.505,36,42,0.857,6,43,49,69,18,4,28,38,218
2020,Yuta Watanabe,SF,25,MEM,18,0,105,15,34,0.441,3,8,0.375,12,26,0.462,3,8,0.375,7,13,20,5,5,1,2,9,36
2020,Zach Collins,PF,22,POR,11,11,290,32,68,0.471,7,19,0.368,25,49,0.51,6,8,0.75,25,44,69,16,5,5,14,36,77
2020,Zach LaVine,SF,24,CHI,60,60,2085,539,1199,0.45,184,484,0.38,355,715,0.497,268,334,0.802,41,248,289,254,88,28,206,131,1530
2020,Zach Norvell,SG,22,TOT,5,0,41,3,12,0.25,3,8,0.375,0,4,0,1,1,1,0,6,6,3,2,0,3,4,10
2020,Zach Norvell,SG,22,LAL,2,0,5,0,1,0,0,0,,0,1,0,0,0,,0,1,1,0,0,0,0,0,0
2020,Zach Norvell,SG,22,GSW,3,0,36,3,11,0.273,3,8,0.375,0,3,0,1,1,1,0,5,5,3,2,0,3,4,10
2020,Zhaire Smith,SF,20,PHI,7,0,32,3,11,0.273,0,3,0,3,8,0.375,2,4,0.5,0,2,2,2,3,0,2,4,8
2020,Zion Williamson,PF,19,NOP,24,24,668,210,360,0.583,6,14,0.429,204,346,0.59,114,178,0.64,64,86,150,50,16,9,59,42,540
2020,Zylan Cheatham,PF,24,NOP,4,0,51,6,9,0.667,0,1,0,6,8,0.75,0,0,,3,6,9,3,1,1,4,10,12
2021,Aaron Gordon,PF,25,TOT,50,50,1384,231,499,0.463,59,176,0.335,172,323,0.533,97,149,0.651,77,207,284,161,33,34,97,89,618
2021,Aaron Gordon,PF,25,ORL,25,25,736,128,293,0.437,42,112,0.375,86,181,0.475,66,105,0.629,39,127,166,105,16,20,67,49,364
2021,Aaron Gordon,PF,25,DEN,25,25,648,103,206,0.5,17,64,0.266,86,142,0.606,31,44,0.705,38,80,118,56,17,14,30,40,254
2021,Aaron Holiday,PG,24,IND,66,8,1176,170,436,0.39,67,182,0.368,103,254,0.406,68,83,0.819,15,74,89,123,46,13,66,94,475
2021,Aaron Nesmith,SF,21,BOS,46,1,669,78,178,0.438,40,108,0.37,38,70,0.543,22,28,0.786,28,99,127,23,15,9,23,87,218
2021,Abdel Nader,SF,27,PHO,24,0,355,57,116,0.491,18,43,0.419,39,73,0.534,28,37,0.757,7,55,62,19,10,9,19,34,160
2021,Adam Mokoka,SG,22,CHI,14,0,56,7,19,0.368,1,10,0.1,6,9,0.667,0,1,0,1,4,5,5,2,1,5,5,15
2021,Al Horford,C,34,OKC,28,28,782,162,360,0.45,56,152,0.368,106,208,0.51,18,22,0.818,29,159,188,94,25,26,29,48,398
2021,Al-Farouq Aminu,PF,30,TOT,23,14,434,38,99,0.384,8,37,0.216,30,62,0.484,18,22,0.818,22,88,110,31,19,9,28,29,102
2021,Al-Farouq Aminu,PF,30,ORL,17,14,367,36,89,0.404,7,31,0.226,29,58,0.5,14,17,0.824,20,71,91,29,17,9,25,22,93
2021,Al-Farouq Aminu,PF,30,CHI,6,0,67,2,10,0.2,1,6,0.167,1,4,0.25,4,5,0.8,2,17,19,2,2,0,3,7,9
2021,Alec Burks,SG,29,NYK,49,5,1255,210,500,0.42,102,246,0.415,108,254,0.425,101,118,0.856,21,206,227,107,31,14,49,102,623
2021,Aleksej Pokusevski,PF,19,OKC,45,28,1090,139,408,0.341,58,207,0.28,81,201,0.403,31,42,0.738,30,182,212,97,20,42,99,58,367
2021,Alen Smailagić,PF,20,GSW,15,1,84,11,27,0.407,4,10,0.4,7,17,0.412,2,6,0.333,6,10,16,4,3,5,5,11,28
2021,Alex Caruso,PG,26,LAL,58,6,1216,133,305,0.436,55,137,0.401,78,168,0.464,49,76,0.645,31,139,170,160,64,15,76,108,370
2021,Alex Len,C,27,TOT,64,42,979,171,278,0.615,8,25,0.32,163,253,0.644,73,116,0.629,78,182,260,49,20,64,55,127,423
2021,Alex Len,C,27,TOR,7,2,76,5,10,0.5,3,6,0.5,2,4,0.5,3,6,0.5,0,11,11,3,1,6,8,10,16
2021,Alex Len,C,27,WAS,57,40,903,166,268,0.619,5,19,0.263,161,249,0.647,70,110,0.636,78,171,249,46,19,58,47,117,407
2021,Alfonzo McKinnie,SF,28,LAL,39,0,258,48,93,0.516,16,39,0.41,32,54,0.593,10,18,0.556,22,32,54,6,7,0,5,26,122
2021,Alize Johnson,PF,24,BRK,18,0,189,40,68,0.588,1,6,0.167,39,62,0.629,13,13,1,27,63,90,14,5,5,9,16,94
2021,Amida Brimah,C,26,IND,5,0,29,5,8,0.625,0,0,,5,8,0.625,3,3,1,2,6,8,1,0,5,4,4,13
2021,Amir Coffey,SG,23,LAC,44,1,394,45,103,0.437,23,56,0.411,22,47,0.468,27,38,0.711,10,34,44,22,10,0,15,30,140
2021,Anderson Varejão,C,38,CLE,5,0,36,4,16,0.25,0,1,0,4,15,0.267,5,9,0.556,7,13,20,3,0,2,1,3,13
2021,Andre Drummond,C,27,TOT,46,46,1242,282,572,0.493,0,8,0,282,564,0.5,123,205,0.6,166,385,551,94,63,49,124,149,687
2021,Andre Drummond,C,27,CLE,25,25,722,180,380,0.474,0,8,0,180,372,0.484,77,129,0.597,101,236,337,64,40,29,81,69,437
2021,Andre Drummond,C,27,LAL,21,21,520,102,192,0.531,0,0,,102,192,0.531,46,76,0.605,65,149,214,30,23,20,43,80,250
2021,Andre Iguodala,SF,37,MIA,63,5,1339,95,248,0.383,60,182,0.33,35,66,0.53,25,38,0.658,38,183,221,142,57,35,67,90,275
2021,Andre Roberson,SG,29,BRK,5,0,63,2,14,0.143,1,8,0.125,1,6,0.167,1,2,0.5,7,8,15,4,3,1,2,4,6
2021,Andrew Wiggins,PF,25,GSW,71,71,2364,505,1058,0.477,140,368,0.38,365,690,0.529,170,238,0.714,82,265,347,167,67,70,126,159,1320
2021,Anfernee Simons,SG,21,POR,64,0,1104,168,401,0.419,120,282,0.426,48,119,0.403,46,57,0.807,14,126,140,89,18,8,43,96,502
2021,Anthony Davis,PF,27,LAL,36,36,1162,301,613,0.491,26,100,0.26,275,513,0.536,158,214,0.738,62,224,286,110,45,59,74,60,786
2021,Anthony Edwards,SG,19,MIN,72,55,2314,505,1211,0.417,171,520,0.329,334,691,0.483,211,272,0.776,59,277,336,211,82,36,160,129,1392
2021,Anthony Gill,PF,28,WAS,26,4,218,30,60,0.5,7,24,0.292,23,36,0.639,13,16,0.813,16,35,51,11,10,4,8,27,80
2021,Anthony Lamb,SF,23,HOU,24,3,415,46,118,0.39,23,71,0.324,23,47,0.489,18,21,0.857,27,43,70,23,6,5,19,34,133
2021,Anthony Tolliver,PF,35,PHI,11,0,99,4,17,0.235,4,14,0.286,0,3,0,5,6,0.833,3,7,10,2,3,2,3,7,17
2021,Anžejs Pasečņiks,C,25,WAS,1,0,6,0,1,0,0,1,0,0,0,,0,0,,1,0,1,1,0,0,5,2,0
2021,Armoni Brooks,SG,22,HOU,20,5,520,78,192,0.406,60,157,0.382,18,35,0.514,7,12,0.583,10,58,68,30,12,5,22,34,223
2021,Aron Baynes,C,34,TOR,53,31,980,134,304,0.441,27,103,0.262,107,201,0.532,29,41,0.707,87,186,273,47,17,23,46,119,324
2021,Ashton Hagans,PG,21,MIN,2,0,4,0,0,,0,0,,0,0,,0,0,,0,0,0,0,0,0,1,0,0
2021,Austin Rivers,SG,28,TOT,36,7,845,104,245,0.424,55,149,0.369,49,96,0.51,22,31,0.71,8,74,82,81,30,2,36,64,285
2021,Austin Rivers,SG,28,NYK,21,2,442,58,135,0.43,28,77,0.364,30,58,0.517,10,14,0.714,5,42,47,42,12,0,22,32,154
2021,Austin Rivers,SG,28,DEN,15,5,403,46,110,0.418,27,72,0.375,19,38,0.5,12,17,0.706,3,32,35,39,18,2,14,32,131
2021,Avery Bradley,SG,30,TOT,27,6,602,64,171,0.374,33,101,0.327,31,70,0.443,12,15,0.8,8,49,57,46,21,3,28,55,173
2021,Avery Bradley,SG,30,MIA,10,1,211,31,66,0.47,16,38,0.421,15,28,0.536,7,9,0.778,2,16,18,14,7,1,9,26,85
2021,Avery Bradley,SG,30,HOU,17,5,391,33,105,0.314,17,63,0.27,16,42,0.381,5,6,0.833,6,33,39,32,14,2,19,29,88
2021,Axel Toupane,SF,28,MIL,8,1,61,4,11,0.364,1,2,0.5,3,9,0.333,5,7,0.714,0,6,6,4,2,3,0,6,14
2021,Bam Adebayo,C,23,MIA,64,64,2143,456,800,0.57,2,8,0.25,454,792,0.573,283,354,0.799,142,431,573,346,75,66,169,145,1197
2021,Ben McLemore,SG,27,TOT,53,5,905,135,365,0.37,97,280,0.346,38,85,0.447,39,53,0.736,15,85,100,39,23,9,42,88,406
2021,Ben McLemore,SG,27,HOU,32,4,537,80,224,0.357,55,166,0.331,25,58,0.431,23,32,0.719,11,55,66,28,20,3,28,51,238
2021,Ben McLemore,SG,27,LAL,21,1,368,55,141,0.39,42,114,0.368,13,27,0.481,16,21,0.762,4,30,34,11,3,6,14,37,168
2021,Ben Simmons,PG,24,PHI,58,58,1877,325,583,0.557,3,10,0.3,322,573,0.562,176,287,0.613,93,324,417,401,93,35,173,171,829
2021,Bismack Biyombo,C,28,CHO,66,36,1349,142,242,0.587,0,1,0,142,241,0.589,47,105,0.448,137,210,347,81,17,74,71,141,331
2021,Blake Griffin,PF,31,TOT,46,30,1186,174,411,0.423,70,205,0.341,104,206,0.505,87,117,0.744,35,190,225,140,32,15,62,111,505
2021,Blake Griffin,PF,31,DET,20,20,626,81,222,0.365,39,124,0.315,42,98,0.429,44,62,0.71,7,97,104,77,14,2,32,42,245
2021,Blake Griffin,PF,31,BRK,26,10,560,93,189,0.492,31,81,0.383,62,108,0.574,43,55,0.782,28,93,121,63,18,13,30,69,260
2021,Boban Marjanović,C,32,DAL,33,3,271,62,122,0.508,1,8,0.125,61,114,0.535,31,38,0.816,47,81,128,10,2,6,12,29,156
2021,Bobby Portis,C,25,MIL,66,7,1372,313,598,0.523,74,157,0.471,239,441,0.542,54,73,0.74,124,342,466,71,52,26,56,115,754
2021,Bogdan Bogdanović,SG,28,ATL,44,27,1305,267,565,0.473,146,333,0.438,121,232,0.522,40,44,0.909,20,140,160,147,49,13,54,99,720
2021,Bojan Bogdanović,SF,31,UTA,72,72,2216,406,925,0.439,180,461,0.39,226,464,0.487,233,265,0.879,40,241,281,136,45,4,128,115,1225
2021,Bol Bol,PF,21,DEN,32,2,160,25,58,0.431,9,24,0.375,16,34,0.471,10,15,0.667,0,24,24,7,3,10,13,14,69
2021,Brad Wanamaker,PG,31,TOT,61,0,1053,115,299,0.385,16,85,0.188,99,214,0.463,90,101,0.891,18,87,105,174,43,11,71,94,336
2021,Brad Wanamaker,PG,31,GSW,39,0,625,61,173,0.353,13,61,0.213,48,112,0.429,50,56,0.893,8,58,66,99,26,6,37,55,185
2021,Brad Wanamaker,PG,31,CHO,22,0,428,54,126,0.429,3,24,0.125,51,102,0.5,40,45,0.889,10,29,39,75,17,5,34,39,151
2021,Bradley Beal,SG,27,WAS,60,60,2147,670,1382,0.485,130,373,0.349,540,1009,0.535,408,459,0.889,72,211,283,265,69,22,187,140,1878
2021,Brandon Clarke,PF,24,MEM,59,16,1415,256,495,0.517,20,77,0.26,236,418,0.565,78,113,0.69,97,231,328,95,60,51,33,84,610
2021,Brandon Goodwin,PG,25,ATL,47,5,620,84,223,0.377,32,103,0.311,52,120,0.433,28,43,0.651,8,61,69,95,17,0,36,41,228
2021,Brandon Ingram,SF,23,NOP,61,61,2093,513,1101,0.466,143,375,0.381,370,726,0.51,281,320,0.878,34,265,299,296,42,36,154,124,1450
2021,Brian Bowen,SF,22,IND,6,0,15,1,4,0.25,0,1,0,1,3,0.333,1,1,1,0,3,3,0,0,0,0,1,3
2021,Brodric Thomas,SG,24,TOT,32,1,399,39,108,0.361,16,59,0.271,23,49,0.469,31,46,0.674,8,45,53,30,15,10,22,40,125
2021,Brodric Thomas,SG,24,HOU,4,0,24,2,7,0.286,1,6,0.167,1,1,1,5,7,0.714,1,3,4,4,1,1,4,5,10
2021,Brodric Thomas,SG,24,CLE,28,1,375,37,101,0.366,15,53,0.283,22,48,0.458,26,39,0.667,7,42,49,26,14,9,18,35,115
2021,Brook Lopez,C,32,MIL,70,70,1902,322,640,0.503,95,281,0.338,227,359,0.632,120,142,0.845,104,243,347,50,40,103,64,149,859
2021,Bruce Brown,PG,24,BRK,65,37,1451,235,423,0.556,17,59,0.288,218,364,0.599,86,117,0.735,111,238,349,104,58,28,54,145,573
2021,Bruno Caboclo,PF,25,HOU,6,0,36,8,17,0.471,0,5,0,8,12,0.667,1,2,0.5,3,11,14,1,0,2,4,6,17
2021,Bruno Fernando,C,22,ATL,33,0,226,18,44,0.409,0,2,0,18,42,0.429,15,22,0.682,16,62,78,10,4,3,21,23,51
2021,Bryn Forbes,SG,27,MIL,70,10,1354,250,529,0.473,154,341,0.452,96,188,0.511,47,61,0.77,11,101,112,45,24,1,44,77,701
2021,Buddy Hield,SG,28,SAC,71,71,2433,403,992,0.406,282,721,0.391,121,271,0.446,88,104,0.846,29,305,334,257,63,30,130,175,1176
2021,Caleb Martin,SF,25,CHO,53,3,818,96,256,0.375,31,125,0.248,65,131,0.496,41,64,0.641,31,110,141,67,37,12,33,62,264
2021,Cam Reddish,SF,21,ATL,26,21,750,96,263,0.365,33,126,0.262,63,137,0.46,67,82,0.817,22,82,104,35,33,9,34,68,292
2021,Cameron Johnson,PF,24,PHO,60,11,1437,203,483,0.42,117,335,0.349,86,148,0.581,50,59,0.847,33,166,199,86,37,16,40,85,573
2021,Cameron Oliver,SF,24,HOU,4,0,87,19,33,0.576,4,13,0.308,15,20,0.75,1,4,0.25,5,16,21,5,2,4,3,11,43
2021,Cameron Payne,PG,26,PHO,60,1,1079,191,395,0.484,73,166,0.44,118,229,0.515,50,56,0.893,16,128,144,217,36,16,60,97,505
2021,Cameron Reynolds,SF,25,TOT,5,0,40,6,18,0.333,3,12,0.25,3,6,0.5,0,0,,2,3,5,2,0,0,0,2,15
2021,Cameron Reynolds,SF,25,SAS,3,0,6,1,2,0.5,0,0,,1,2,0.5,0,0,,0,0,0,0,0,0,0,0,2
2021,Cameron Reynolds,SF,25,HOU,2,0,34,5,16,0.313,3,12,0.25,2,4,0.5,0,0,,2,3,5,2,0,0,0,2,13
2021,Caris LeVert,SG,26,TOT,47,39,1486,359,814,0.441,84,258,0.326,275,556,0.495,146,180,0.811,33,181,214,245,66,30,102,105,948
2021,Caris LeVert,SG,26,BRK,12,4,334,87,200,0.435,22,63,0.349,65,137,0.474,26,34,0.765,10,42,52,72,13,6,26,20,222
2021,Caris LeVert,SG,26,IND,35,35,1152,272,614,0.443,62,195,0.318,210,419,0.501,120,146,0.822,23,139,162,173,53,24,76,85,726
2021,Carmelo Anthony,PF,36,POR,69,3,1690,327,777,0.421,133,325,0.409,194,452,0.429,137,154,0.89,32,182,214,104,46,38,61,144,924
2021,Carsen Edwards,SG,22,BOS,31,1,276,47,111,0.423,18,63,0.286,29,48,0.604,11,13,0.846,3,23,26,14,7,1,7,25,123
2021,Cassius Stanley,SG,21,IND,24,0,93,13,43,0.302,3,13,0.231,10,30,0.333,7,9,0.778,8,12,20,1,1,2,1,14,36
2021,Cassius Winston,PG,22,WAS,22,0,98,14,33,0.424,8,17,0.471,6,16,0.375,5,6,0.833,0,9,9,12,2,1,5,8,41
2021,Cedi Osman,SF,25,CLE,59,26,1510,219,586,0.374,99,324,0.306,120,262,0.458,76,95,0.8,38,163,201,174,53,9,80,119,613
2021,Chandler Hutchison,SF,24,TOT,25,1,346,39,103,0.379,8,22,0.364,31,81,0.383,21,25,0.84,6,72,78,17,12,5,20,33,107
2021,Chandler Hutchison,SF,24,CHI,7,0,64,5,18,0.278,1,3,0.333,4,15,0.267,2,2,1,1,19,20,4,1,0,5,9,13
2021,Chandler Hutchison,SF,24,WAS,18,1,282,34,85,0.4,7,19,0.368,27,66,0.409,19,23,0.826,5,53,58,13,11,5,15,24,94
2021,Charlie Brown Jr.,SG,23,OKC,9,1,152,13,43,0.302,5,21,0.238,8,22,0.364,9,10,0.9,3,14,17,9,4,2,6,19,40
2021,Chasson Randle,PG,27,ORL,41,5,837,92,237,0.388,44,130,0.338,48,107,0.449,38,48,0.792,7,75,82,74,22,5,46,64,266
2021,Chimezie Metu,C,23,SAC,36,6,488,91,179,0.508,13,37,0.351,78,142,0.549,31,43,0.721,31,81,112,28,14,18,29,59,226
2021,Chris Boucher,C,28,TOR,60,14,1453,288,560,0.514,90,235,0.383,198,325,0.609,152,193,0.788,117,287,404,63,35,111,46,166,818
2021,Chris Chiozza,PG,25,BRK,22,1,232,31,88,0.352,13,42,0.31,18,46,0.391,13,17,0.765,3,21,24,65,7,6,16,19,88
2021,Chris Paul,PG,35,PHO,70,70,2199,439,879,0.499,102,258,0.395,337,621,0.543,169,181,0.934,25,287,312,622,99,19,156,166,1149
2021,Chris Silva,PF,24,TOT,15,0,92,10,16,0.625,1,1,1,9,15,0.6,11,15,0.733,7,20,27,6,1,6,10,24,32
2021,Chris Silva,PF,24,MIA,11,0,83,9,13,0.692,1,1,1,8,12,0.667,11,15,0.733,7,18,25,6,1,5,9,20,30
2021,Chris Silva,PF,24,SAC,4,0,9,1,3,0.333,0,0,,1,3,0.333,0,0,,0,2,2,0,0,1,1,4,2
2021,Christian Wood,C,25,HOU,41,41,1326,329,640,0.514,77,206,0.374,252,434,0.581,125,198,0.631,76,319,395,71,34,48,80,88,860
2021,Chuma Okeke,PF,22,ORL,45,19,1133,135,324,0.417,49,141,0.348,86,183,0.47,30,40,0.75,42,139,181,101,48,22,38,48,349
2021,CJ Elleby,SF,20,POR,30,0,192,25,66,0.379,7,34,0.206,18,32,0.563,11,15,0.733,11,21,32,10,6,3,5,27,68
2021,CJ McCollum,SG,29,POR,47,47,1600,405,884,0.458,169,420,0.402,236,464,0.509,108,133,0.812,30,155,185,223,44,21,65,87,1087
2021,Clint Capela,C,26,ATL,63,63,1898,413,695,0.594,0,0,,413,695,0.594,130,227,0.573,297,606,903,49,44,129,73,145,956
2021,Coby White,PG,20,CHI,69,54,2156,375,902,0.416,163,454,0.359,212,448,0.473,128,142,0.901,28,256,284,328,38,15,156,179,1041
2021,Cody Martin,SF,25,CHO,52,10,849,83,188,0.441,16,58,0.276,67,130,0.515,25,43,0.581,52,109,161,86,37,12,40,52,207
2021,Cody Zeller,C,28,CHO,48,21,1005,181,324,0.559,4,28,0.143,177,296,0.598,85,119,0.714,119,209,328,86,27,17,51,121,451
2021,Cole Anthony,PG,20,ORL,47,34,1273,219,552,0.397,58,172,0.337,161,380,0.424,109,131,0.832,38,183,221,192,30,18,106,98,605
2021,Collin Sexton,SG,22,CLE,60,60,2115,525,1105,0.475,98,264,0.371,427,841,0.508,312,383,0.815,58,129,187,262,62,10,167,157,1460
2021,Cory Joseph,PG,29,TOT,63,13,1446,200,426,0.469,45,132,0.341,155,294,0.527,72,88,0.818,35,124,159,213,61,18,79,139,517
2021,Cory Joseph,PG,29,SAC,44,2,944,111,250,0.444,31,94,0.33,80,156,0.513,36,47,0.766,25,74,99,108,39,9,44,98,289
2021,Cory Joseph,PG,29,DET,19,11,502,89,176,0.506,14,38,0.368,75,138,0.543,36,41,0.878,10,50,60,105,22,9,35,41,228
2021,Cristiano Felício,C,28,CHI,18,0,84,7,13,0.538,0,2,0,7,11,0.636,9,16,0.563,10,16,26,9,4,0,4,10,23
2021,D.J. Augustin,PG,33,TOT,57,12,1129,135,343,0.394,83,217,0.382,52,126,0.413,85,94,0.904,20,74,94,188,28,1,65,56,438
2021,D.J. Augustin,PG,33,MIL,37,6,713,71,192,0.37,49,129,0.38,22,63,0.349,36,40,0.9,11,39,50,110,20,1,34,33,227
2021,D.J. Augustin,PG,33,HOU,20,6,416,64,151,0.424,34,88,0.386,30,63,0.476,49,54,0.907,9,35,44,78,8,0,31,23,211
2021,D.J. Wilson,PF,24,TOT,35,1,433,68,168,0.405,30,87,0.345,38,81,0.469,17,25,0.68,20,92,112,23,11,16,22,44,183
2021,D.J. Wilson,PF,24,MIL,12,0,105,16,43,0.372,10,28,0.357,6,15,0.4,1,2,0.5,3,22,25,3,1,4,4,13,43
2021,D.J. Wilson,PF,24,HOU,23,1,328,52,125,0.416,20,59,0.339,32,66,0.485,16,23,0.696,17,70,87,20,10,12,18,31,140
2021,D'Angelo Russell,PG,24,MIN,42,26,1196,281,652,0.431,120,310,0.387,161,342,0.471,114,149,0.765,16,95,111,244,45,18,112,68,796
2021,Dakota Mathias,SG,25,PHI,8,2,123,19,48,0.396,8,26,0.308,11,22,0.5,2,6,0.333,1,6,7,13,1,3,1,7,48
2021,Damian Jones,C,25,TOT,39,10,547,70,103,0.68,1,5,0.2,69,98,0.704,42,58,0.724,36,85,121,29,11,29,26,77,183
2021,Damian Jones,C,25,PHO,14,0,94,8,16,0.5,0,1,0,8,15,0.533,6,11,0.545,7,11,18,4,1,5,6,19,22
2021,Damian Jones,C,25,LAL,8,6,112,16,17,0.941,0,0,,16,17,0.941,11,12,0.917,8,18,26,1,1,7,5,22,43
2021,Damian Jones,C,25,SAC,17,4,341,46,70,0.657,1,4,0.25,45,66,0.682,25,35,0.714,21,56,77,24,9,17,15,36,118
2021,Damian Lillard,PG,30,POR,67,67,2398,602,1334,0.451,275,704,0.391,327,630,0.519,449,484,0.928,32,251,283,505,62,17,203,102,1928
2021,Damion Lee,SG,28,GSW,57,1,1079,128,274,0.467,77,194,0.397,51,80,0.638,40,44,0.909,22,158,180,73,38,8,30,89,373
2021,Damyean Dotson,SG,26,CLE,46,7,907,119,293,0.406,46,159,0.289,73,134,0.545,24,36,0.667,5,88,93,91,16,4,42,42,308
2021,Daniel Gafford,PF-C,22,TOT,54,11,791,154,225,0.684,0,0,,154,225,0.684,72,108,0.667,94,137,231,29,26,75,41,98,380
2021,Daniel Gafford,PF,22,CHI,31,11,383,60,87,0.69,0,0,,60,87,0.69,27,41,0.659,44,59,103,17,11,34,22,54,147
2021,Daniel Gafford,C,22,WAS,23,0,408,94,138,0.681,0,0,,94,138,0.681,45,67,0.672,50,78,128,12,15,41,19,44,233
2021,Daniel Oturu,C,21,LAC,30,0,161,22,52,0.423,1,5,0.2,21,47,0.447,9,12,0.75,21,27,48,10,4,7,9,24,54
2021,Daniel Theis,C,28,TOT,65,51,1601,252,466,0.541,49,152,0.322,203,314,0.646,74,110,0.673,93,263,356,108,41,57,66,167,627
2021,Daniel Theis,C,28,BOS,42,37,1027,159,288,0.552,33,95,0.347,126,193,0.653,46,67,0.687,54,166,220,67,25,43,41,120,397
2021,Daniel Theis,C,28,CHI,23,14,574,93,178,0.522,16,57,0.281,77,121,0.636,28,43,0.651,39,97,136,41,16,14,25,47,230
2021,Danilo Gallinari,PF,32,ATL,51,4,1222,206,475,0.434,103,254,0.406,103,221,0.466,161,174,0.925,17,194,211,76,30,10,43,105,676
2021,Danny Green,SF,33,PHI,69,69,1934,224,544,0.412,175,432,0.405,49,112,0.438,31,40,0.775,55,205,260,118,92,56,67,125,654
2021,Dante Exum,SG,25,CLE,6,3,116,10,26,0.385,2,11,0.182,8,15,0.533,1,2,0.5,2,15,17,13,4,2,7,9,23
2021,Danuel House Jr.,SF,27,HOU,36,23,932,110,272,0.404,54,156,0.346,56,116,0.483,41,63,0.651,18,114,132,69,20,16,36,67,315
2021,DaQuan Jeffries,SG,23,TOT,31,5,493,50,120,0.417,20,67,0.299,30,53,0.566,7,8,0.875,19,52,71,22,15,10,14,48,127
2021,DaQuan Jeffries,SG,23,SAC,18,2,232,24,57,0.421,9,28,0.321,15,29,0.517,6,7,0.857,9,20,29,6,7,4,8,23,63
2021,DaQuan Jeffries,SG,23,HOU,13,3,261,26,63,0.413,11,39,0.282,15,24,0.625,1,1,1,10,32,42,16,8,6,6,25,64
2021,Dario Šarić,C,26,PHO,50,4,871,153,342,0.447,47,135,0.348,106,207,0.512,84,99,0.848,46,144,190,65,30,4,57,95,437
2021,Darius Bazley,PF,20,OKC,55,55,1714,273,690,0.396,83,286,0.29,190,404,0.47,125,178,0.702,51,345,396,99,29,25,122,60,754
2021,Darius Garland,PG,21,CLE,54,50,1790,362,802,0.451,105,266,0.395,257,536,0.479,112,132,0.848,23,106,129,329,66,6,164,110,941
2021,Darius Miller,SF,30,OKC,18,0,197,22,48,0.458,17,42,0.405,5,6,0.833,12,12,1,2,22,24,21,13,5,8,13,73
2021,David Nwaba,SF,28,HOU,30,9,679,106,218,0.486,17,63,0.27,89,155,0.574,47,68,0.691,40,78,118,31,30,21,17,60,276
2021,Dāvis Bertāns,PF,28,WAS,57,7,1464,193,478,0.404,169,428,0.395,24,50,0.48,100,115,0.87,18,150,168,49,33,13,33,136,655
2021,De'Aaron Fox,PG,23,SAC,58,58,2036,529,1110,0.477,103,320,0.322,426,790,0.539,300,417,0.719,33,170,203,417,87,27,174,170,1461
2021,De'Andre Hunter,SF,23,ATL,23,19,678,120,248,0.484,31,95,0.326,89,153,0.582,73,85,0.859,17,93,110,44,19,12,29,59,344
2021,De'Anthony Melton,PG,22,MEM,52,1,1045,172,393,0.438,87,211,0.412,85,182,0.467,41,51,0.804,30,131,161,132,60,31,66,85,472
2021,Dean Wade,PF,24,CLE,63,19,1212,134,311,0.431,78,213,0.366,56,98,0.571,30,39,0.769,38,177,215,74,35,21,30,78,376
2021,Deandre Ayton,C,22,PHO,69,69,2115,430,687,0.626,4,20,0.2,426,667,0.639,133,173,0.769,228,499,727,99,41,81,103,196,997
2021,DeAndre Jordan,C,32,BRK,57,43,1246,190,249,0.763,0,1,0,190,248,0.766,46,92,0.5,117,310,427,93,17,65,85,116,426
2021,DeAndre' Bembry,SF,26,TOR,51,12,972,117,228,0.513,14,53,0.264,103,175,0.589,45,66,0.682,33,113,146,107,53,18,71,87,293
2021,Deividas Sirvydis,SG,20,DET,20,0,133,14,40,0.35,10,28,0.357,4,12,0.333,3,6,0.5,0,29,29,5,2,0,5,9,41
2021,Dejounte Murray,PG,24,SAS,67,67,2139,441,974,0.453,63,199,0.317,378,775,0.488,106,134,0.791,58,415,473,363,101,7,117,135,1051
2021,Delon Wright,SG-PG,28,TOT,63,39,1748,240,518,0.463,64,172,0.372,176,346,0.509,101,126,0.802,65,204,269,278,101,30,83,75,645
2021,Delon Wright,SG,28,DET,36,31,1052,136,293,0.464,31,89,0.348,105,204,0.515,71,90,0.789,37,127,164,181,58,19,48,45,374
2021,Delon Wright,PG,28,SAC,27,8,696,104,225,0.462,33,83,0.398,71,142,0.5,30,36,0.833,28,77,105,97,43,11,35,30,271
2021,DeMar DeRozan,PF,31,SAS,61,61,2056,455,920,0.495,19,74,0.257,436,846,0.515,387,440,0.88,40,219,259,422,56,15,119,128,1316
2021,DeMarcus Cousins,C,30,TOT,41,11,713,130,305,0.426,47,135,0.348,83,170,0.488,59,81,0.728,53,210,263,76,34,24,64,107,366
2021,DeMarcus Cousins,C,30,HOU,25,11,506,79,210,0.376,39,116,0.336,40,94,0.426,44,59,0.746,30,161,191,60,21,18,39,74,241
2021,DeMarcus Cousins,C,30,LAC,16,0,207,51,95,0.537,8,19,0.421,43,76,0.566,15,22,0.682,23,49,72,16,13,6,25,33,125
2021,Deni Avdija,SF,20,WAS,54,32,1257,130,312,0.417,53,168,0.315,77,144,0.535,29,45,0.644,22,240,262,63,32,15,33,140,342
2021,Dennis Schröder,SG,27,LAL,61,61,1956,332,760,0.437,71,212,0.335,261,548,0.476,206,243,0.848,30,181,211,351,70,13,163,159,941
2021,Dennis Smith Jr.,PG,23,TOT,23,9,420,58,145,0.4,19,58,0.328,39,87,0.448,19,26,0.731,12,43,55,77,23,14,26,37,154
2021,Dennis Smith Jr.,PG,23,NYK,3,0,28,2,10,0.2,0,4,0,2,6,0.333,5,6,0.833,0,2,2,3,3,0,1,4,9
2021,Dennis Smith Jr.,PG,23,DET,20,9,392,56,135,0.415,19,54,0.352,37,81,0.457,14,20,0.7,12,41,53,74,20,14,25,33,145
2021,Denzel Valentine,SG,27,CHI,62,3,1036,155,416,0.373,80,242,0.331,75,174,0.431,16,17,0.941,24,173,197,105,30,7,42,70,406
2021,Derrick Favors,C,29,UTA,68,0,1039,155,243,0.638,0,2,0,155,241,0.643,59,80,0.738,138,238,376,44,32,68,36,143,369
2021,Derrick Jones Jr.,SF,23,POR,58,43,1318,147,304,0.484,43,136,0.316,104,168,0.619,59,91,0.648,77,128,205,47,37,54,32,127,396
2021,Derrick Rose,PG,32,TOT,50,3,1279,287,611,0.47,50,129,0.388,237,482,0.492,110,127,0.866,20,110,130,209,49,19,78,56,734
2021,Derrick Rose,PG,32,DET,15,0,342,79,184,0.429,13,39,0.333,66,145,0.455,42,50,0.84,6,23,29,63,18,4,29,17,213
2021,Derrick Rose,PG,32,NYK,35,3,937,208,427,0.487,37,90,0.411,171,337,0.507,68,77,0.883,14,87,101,146,31,15,49,39,521
2021,Derrick White,SG,26,SAS,36,32,1064,186,453,0.411,84,243,0.346,102,210,0.486,97,114,0.851,13,94,107,127,26,36,45,91,553
2021,Desmond Bane,SG,22,MEM,68,17,1519,234,499,0.469,117,271,0.432,117,228,0.513,40,49,0.816,31,179,210,118,41,16,59,125,625
2021,Devin Booker,SG,24,PHO,67,67,2270,623,1287,0.484,126,371,0.34,497,916,0.543,340,392,0.867,34,247,281,289,53,16,207,181,1712
2021,Devin Cannady,PG,24,ORL,8,0,74,11,28,0.393,6,16,0.375,5,12,0.417,6,7,0.857,0,5,5,1,5,1,2,9,34
2021,Devin Vassell,SF,20,SAS,62,7,1056,123,303,0.406,52,150,0.347,71,153,0.464,43,51,0.843,24,150,174,56,43,18,22,88,341
2021,Devon Dotson,PG,21,CHI,11,0,50,11,21,0.524,1,7,0.143,10,14,0.714,0,0,,2,3,5,7,4,0,0,3,23
2021,Devontae Cacok,PF,24,LAL,20,1,98,17,29,0.586,0,0,,17,29,0.586,5,11,0.455,12,20,32,1,5,4,5,8,39
2021,Devonte' Graham,PG,25,CHO,55,44,1659,252,669,0.377,179,477,0.375,73,192,0.38,133,158,0.842,22,126,148,295,48,6,84,77,816
2021,Dewayne Dedmon,C,31,MIA,16,0,210,46,65,0.708,1,5,0.2,45,60,0.75,20,27,0.741,28,58,86,12,9,6,13,36,113
2021,Didi Louzada,SF,21,NOP,3,0,56,3,13,0.231,2,8,0.25,1,5,0.2,0,0,,1,2,3,3,2,0,3,5,8
2021,Dillon Brooks,SF,25,MEM,67,67,1997,432,1031,0.419,128,372,0.344,304,659,0.461,159,195,0.815,53,143,196,157,78,26,119,237,1151
2021,Domantas Sabonis,PF,24,IND,62,62,2231,484,904,0.535,52,162,0.321,432,742,0.582,240,328,0.732,150,592,742,415,76,33,213,203,1260
2021,Donovan Mitchell,PG,24,UTA,53,53,1771,478,1091,0.438,178,461,0.386,300,630,0.476,267,316,0.845,50,185,235,277,52,15,147,117,1401
2021,Donta Hall,PF,23,ORL,13,0,179,25,35,0.714,0,0,,25,35,0.714,23,34,0.676,24,38,62,11,5,10,8,18,73
2021,Donte DiVincenzo,SG,24,MIL,66,66,1814,253,603,0.42,131,346,0.379,122,257,0.475,51,71,0.718,81,299,380,203,72,15,91,112,688
2021,Dorian Finney-Smith,PF,27,DAL,60,60,1921,220,466,0.472,119,302,0.394,101,164,0.616,31,41,0.756,98,228,326,102,52,25,48,138,590
2021,Doug McDermott,PF,29,IND,66,29,1619,354,665,0.532,111,286,0.388,243,379,0.641,80,98,0.816,60,161,221,85,20,6,53,117,899
2021,Draymond Green,PF,30,GSW,63,63,1982,170,380,0.447,34,126,0.27,136,254,0.535,70,88,0.795,55,394,449,558,105,52,188,194,444
2021,Drew Eubanks,C,23,SAS,54,3,755,116,205,0.566,2,2,1,114,203,0.562,77,106,0.726,74,167,241,42,18,49,45,88,311
2021,Duncan Robinson,SF,26,MIA,72,72,2262,315,717,0.439,250,613,0.408,65,104,0.625,62,75,0.827,7,243,250,127,43,20,81,181,942
2021,Dwayne Bacon,SG,25,ORL,72,50,1853,292,726,0.402,59,207,0.285,233,519,0.449,145,176,0.824,31,193,224,93,45,5,46,103,788
2021,Dwight Howard,C,35,PHI,69,6,1196,178,303,0.587,5,20,0.25,173,283,0.611,121,210,0.576,190,390,580,61,30,62,112,200,482
2021,Dwight Powell,C,29,DAL,58,19,966,120,194,0.619,5,21,0.238,115,173,0.665,97,124,0.782,80,154,234,63,36,30,40,135,342
2021,Dylan Windler,SF,24,CLE,31,0,513,57,130,0.438,26,77,0.338,31,53,0.585,21,27,0.778,20,87,107,33,19,12,32,37,161
2021,E'Twaun Moore,SG,31,PHO,27,1,389,55,121,0.455,11,35,0.314,44,86,0.512,12,14,0.857,14,31,45,40,15,5,23,32,133
2021,Ed Davis,C,31,MIN,23,7,299,19,44,0.432,0,0,,19,44,0.432,10,12,0.833,46,69,115,21,13,13,7,56,48
2021,Edmond Sumner,SG,25,IND,53,24,861,148,282,0.525,35,88,0.398,113,194,0.582,68,83,0.819,18,76,94,49,33,10,51,88,399
2021,Elfrid Payton,PG,26,NYK,63,63,1484,269,622,0.432,28,98,0.286,241,524,0.46,73,107,0.682,64,152,216,203,47,9,103,116,639
2021,Elijah Bryant,SG,25,MIL,1,0,32,6,13,0.462,1,5,0.2,5,8,0.625,3,3,1,2,4,6,3,0,1,4,4,16
2021,Elijah Hughes,SF,22,UTA,18,0,64,10,30,0.333,8,23,0.348,2,7,0.286,3,4,0.75,1,8,9,6,1,1,6,1,31
2021,Enes Freedom,C,28,POR,72,35,1758,339,561,0.604,1,4,0.25,338,557,0.607,127,164,0.774,284,511,795,84,33,48,78,168,806
2021,Eric Bledsoe,SG,31,NOP,71,70,2111,307,730,0.421,121,355,0.341,186,375,0.496,134,195,0.687,29,215,244,268,55,24,114,112,869
2021,Eric Gordon,SG,32,HOU,27,13,789,159,367,0.433,69,210,0.329,90,157,0.573,94,114,0.825,8,50,58,71,14,13,51,44,481
2021,Eric Paschall,PF,24,GSW,40,2,695,148,298,0.497,18,54,0.333,130,244,0.533,67,94,0.713,28,100,128,51,12,7,43,68,381
2021,Ersan İlyasova,PF,33,UTA,17,1,148,21,54,0.389,18,41,0.439,3,13,0.231,5,5,1,7,22,29,4,10,3,8,29,65
2021,Evan Fournier,SF-SG,28,TOT,42,36,1259,247,541,0.457,117,283,0.413,130,258,0.504,108,137,0.788,10,118,128,144,47,19,73,96,719
2021,Evan Fournier,SF,28,ORL,26,26,787,170,369,0.461,73,188,0.388,97,181,0.536,98,123,0.797,5,70,75,95,27,9,54,55,511
2021,Evan Fournier,SG,28,BOS,16,10,472,77,172,0.448,44,95,0.463,33,77,0.429,10,14,0.714,5,48,53,49,20,10,19,41,208
2021,Facundo Campazzo,PG,29,DEN,65,19,1425,120,315,0.381,76,216,0.352,44,99,0.444,80,91,0.879,22,112,134,232,79,14,73,132,396
2021,Frank Jackson,PG,22,DET,40,6,738,134,293,0.457,61,150,0.407,73,143,0.51,61,75,0.813,15,71,86,36,15,1,34,53,390
2021,Frank Kaminsky,C,27,PHO,47,13,715,121,257,0.471,31,85,0.365,90,172,0.523,37,60,0.617,36,152,188,79,14,17,22,70,310
2021,Frank Mason III,PG,26,ORL,4,1,79,9,24,0.375,2,5,0.4,7,19,0.368,5,7,0.714,3,9,12,12,0,0,5,7,25
2021,Frank Ntilikina,PG,22,NYK,33,4,322,29,79,0.367,23,48,0.479,6,31,0.194,8,18,0.444,6,25,31,19,18,4,11,45,89
2021,Fred VanVleet,SG,26,TOR,52,52,1899,338,870,0.389,174,476,0.366,164,394,0.416,169,191,0.885,32,188,220,328,87,37,95,119,1019
2021,Freddie Gillespie,PF,23,TOR,20,2,392,44,84,0.524,0,0,,44,84,0.524,23,33,0.697,42,55,97,9,13,20,12,43,111
2021,Furkan Korkmaz,SG,23,PHI,55,11,1062,170,424,0.401,101,269,0.375,69,155,0.445,60,82,0.732,17,96,113,82,49,9,46,64,501
2021,Gabe Vincent,PG,24,MIA,50,7,655,88,233,0.378,46,149,0.309,42,84,0.5,20,23,0.87,10,46,56,67,21,2,34,79,242
2021,Gabriel Deck,PF,25,OKC,10,0,212,32,67,0.478,2,15,0.133,30,52,0.577,18,22,0.818,16,24,40,24,8,0,6,9,84
2021,Garrett Temple,SG,34,CHI,56,25,1528,158,381,0.415,67,200,0.335,91,181,0.503,40,50,0.8,29,131,160,124,43,30,58,126,423
2021,Garrison Mathews,SG,24,WAS,64,24,1038,97,237,0.409,76,198,0.384,21,39,0.538,84,95,0.884,16,71,87,26,29,7,10,106,354
2021,Gary Clark,PF-SF,26,TOT,39,11,654,40,132,0.303,31,108,0.287,9,24,0.375,8,10,0.8,33,82,115,31,13,7,17,35,119
2021,Gary Clark,SF,26,ORL,35,11,637,40,131,0.305,31,108,0.287,9,23,0.391,8,10,0.8,33,79,112,30,12,7,17,34,119
2021,Gary Clark,SF,26,DEN,2,0,4,0,0,,0,0,,0,0,,0,0,,0,1,1,0,0,0,0,0,0
2021,Gary Clark,PF,26,PHI,2,0,13,0,1,0,0,0,,0,1,0,0,0,,0,2,2,1,1,0,0,1,0
2021,Gary Harris,SG,26,TOT,39,38,1080,138,345,0.4,48,141,0.34,90,204,0.441,64,78,0.821,21,58,79,78,28,11,37,71,388
2021,Gary Harris,SG,26,DEN,19,19,581,69,156,0.442,24,75,0.32,45,81,0.556,22,30,0.733,13,34,47,32,17,4,14,37,184
2021,Gary Harris,SG,26,ORL,20,19,499,69,189,0.365,24,66,0.364,45,123,0.366,42,48,0.875,8,24,32,46,11,7,23,34,204
2021,Gary Payton II,PG,28,GSW,10,0,40,10,13,0.769,2,4,0.5,8,9,0.889,3,4,0.75,2,9,11,1,6,1,1,8,25
2021,Gary Trent Jr.,SG,22,TOT,58,38,1802,320,785,0.408,165,429,0.385,155,356,0.435,83,106,0.783,27,125,152,80,56,10,43,92,888
2021,Gary Trent Jr.,SG,22,POR,41,23,1262,217,524,0.414,121,305,0.397,96,219,0.438,58,75,0.773,21,70,91,58,37,6,31,63,613
2021,Gary Trent Jr.,SG,22,TOR,17,15,540,103,261,0.395,44,124,0.355,59,137,0.431,25,31,0.806,6,55,61,22,19,4,12,29,275
2021,George Hill,PG,34,TOT,30,17,672,95,197,0.482,31,80,0.388,64,117,0.547,40,50,0.8,16,45,61,73,23,5,31,31,261
2021,George Hill,PG,34,OKC,14,14,369,61,120,0.508,22,57,0.386,39,63,0.619,21,25,0.84,8,21,29,43,12,2,12,12,165
2021,George Hill,PG,34,PHI,16,3,303,34,77,0.442,9,23,0.391,25,54,0.463,19,25,0.76,8,24,32,30,11,3,19,19,96
2021,Georges Niang,PF,27,UTA,72,10,1154,177,405,0.437,124,292,0.425,53,113,0.469,22,23,0.957,28,148,176,59,25,8,51,116,500
2021,Giannis Antetokounmpo,PF,26,MIL,61,61,2013,626,1100,0.569,67,221,0.303,559,879,0.636,398,581,0.685,97,574,671,357,72,73,207,168,1717
2021,Glenn Robinson III,SF,27,SAC,23,2,369,42,99,0.424,16,44,0.364,26,55,0.473,21,23,0.913,11,34,45,20,4,3,11,23,121
2021,Goga Bitadze,C,21,IND,45,3,561,83,194,0.428,20,79,0.253,63,115,0.548,45,61,0.738,60,90,150,37,9,60,17,94,231
2021,Goran Dragić,PG,34,MIA,50,11,1337,240,555,0.432,91,244,0.373,149,311,0.479,101,122,0.828,25,144,169,219,33,8,118,113,672
2021,Gordon Hayward,SF,30,CHO,44,44,1496,311,658,0.473,85,205,0.415,226,453,0.499,156,185,0.843,37,221,258,181,52,14,91,74,863
2021,Gorgui Dieng,C,31,TOT,38,1,552,85,163,0.521,30,70,0.429,55,93,0.591,58,67,0.866,40,100,140,48,26,16,32,56,258
2021,Gorgui Dieng,C,31,MEM,22,1,371,56,108,0.519,23,48,0.479,33,60,0.55,38,43,0.884,28,70,98,29,17,14,22,38,173
2021,Gorgui Dieng,C,31,SAS,16,0,181,29,55,0.527,7,22,0.318,22,33,0.667,20,24,0.833,12,30,42,19,9,2,10,18,85
2021,Grant Riller,PG,23,CHO,7,0,27,8,12,0.667,2,4,0.5,6,8,0.75,0,0,,0,1,1,3,1,0,1,0,18
2021,Grant Williams,PF,22,BOS,63,9,1138,108,247,0.437,48,129,0.372,60,118,0.508,30,51,0.588,48,130,178,64,32,24,56,161,294
2021,Grayson Allen,SG,25,MEM,50,38,1259,173,414,0.418,107,274,0.391,66,140,0.471,79,91,0.868,19,141,160,108,46,8,48,71,532
2021,Greg Whittington,PF,27,DEN,4,0,12,0,3,0,0,2,0,0,1,0,0,0,,0,0,0,0,0,0,0,0,0
2021,Hamidou Diallo,SG-SF,22,TOT,52,9,1226,224,470,0.477,28,82,0.341,196,388,0.505,128,200,0.64,59,213,272,101,41,24,76,134,604
2021,Hamidou Diallo,SG,22,OKC,32,5,761,143,297,0.481,12,41,0.293,131,256,0.512,83,132,0.629,37,128,165,77,31,12,49,83,381
2021,Hamidou Diallo,SF,22,DET,20,4,465,81,173,0.468,16,41,0.39,65,132,0.492,45,68,0.662,22,85,107,24,10,12,27,51,223
2021,Harrison Barnes,PF,28,SAC,58,58,2102,319,642,0.497,100,256,0.391,219,386,0.567,195,235,0.83,64,321,385,201,43,11,93,75,933
2021,Harry Giles,C,22,POR,38,0,348,42,97,0.433,8,23,0.348,34,74,0.459,16,27,0.593,31,102,133,29,8,13,20,54,108
2021,Hassan Whiteside,C,31,SAC,36,4,546,126,224,0.563,0,1,0,126,223,0.565,41,79,0.519,61,154,215,20,9,46,40,73,293
2021,Henry Ellenson,PF,24,TOR,2,0,38,5,14,0.357,2,9,0.222,3,5,0.6,3,4,0.75,3,9,12,5,0,0,0,7,15
2021,Ignas Brazdeikis,SF,22,TOT,13,0,249,35,83,0.422,11,28,0.393,24,55,0.436,10,14,0.714,11,34,45,17,4,3,12,22,91
2021,Ignas Brazdeikis,SF,22,NYK,4,0,7,0,1,0,0,0,,0,1,0,2,2,1,1,1,2,1,0,0,1,0,2
2021,Ignas Brazdeikis,SF,22,PHI,1,0,8,0,3,0,0,1,0,0,2,0,0,0,,0,2,2,0,0,0,0,0,0
2021,Ignas Brazdeikis,SF,22,ORL,8,0,234,35,79,0.443,11,27,0.407,24,52,0.462,8,12,0.667,10,31,41,16,4,3,11,22,89
2021,Iman Shumpert,SG,30,BRK,2,0,11,1,4,0.25,0,3,0,1,1,1,0,0,,1,0,1,0,1,0,1,0,2
2021,Immanuel Quickley,PG,21,NYK,64,3,1243,229,580,0.395,118,303,0.389,111,277,0.401,155,174,0.891,25,112,137,127,30,12,58,114,731
2021,Isaac Bonga,SF,21,WAS,40,8,432,30,81,0.37,13,47,0.277,17,34,0.5,5,8,0.625,18,48,66,23,11,9,22,63,78
2021,Isaac Okoro,SG,20,CLE,67,67,2173,235,559,0.42,62,214,0.29,173,345,0.501,114,157,0.726,68,138,206,128,62,24,86,185,646
2021,Isaiah Hartenstein,C,22,TOT,46,2,559,94,171,0.55,2,6,0.333,92,165,0.558,46,71,0.648,65,116,181,55,19,39,44,104,236
2021,Isaiah Hartenstein,C,22,DEN,30,0,272,41,80,0.513,0,0,,41,80,0.513,22,36,0.611,40,45,85,15,11,20,21,59,104
2021,Isaiah Hartenstein,C,22,CLE,16,2,287,53,91,0.582,2,6,0.333,51,85,0.6,24,35,0.686,25,71,96,40,8,19,23,45,132
2021,Isaiah Joe,SG,21,PHI,41,1,383,48,133,0.361,39,106,0.368,9,27,0.333,18,24,0.75,6,30,36,20,12,4,11,34,153
2021,Isaiah Roby,PF,22,OKC,61,34,1425,207,429,0.483,32,109,0.294,175,320,0.547,87,117,0.744,89,252,341,107,52,37,113,162,533
2021,Isaiah Stewart,C,19,DET,68,14,1455,226,409,0.553,21,63,0.333,205,346,0.592,64,92,0.696,159,294,453,59,39,86,67,184,537
2021,Isaiah Thomas,PG,31,NOP,3,0,48,9,27,0.333,3,12,0.25,6,15,0.4,2,2,1,1,3,4,5,1,0,6,3,23
2021,Ish Smith,PG,32,WAS,44,1,924,129,297,0.434,18,49,0.367,111,248,0.448,19,33,0.576,22,128,150,172,32,13,41,62,295
2021,Ivica Zubac,C,23,LAC,72,33,1609,257,394,0.652,1,4,0.25,256,390,0.656,135,171,0.789,189,330,519,90,24,62,81,187,650
2021,J.J. Redick,SG,36,TOT,44,0,723,106,267,0.397,66,178,0.371,40,89,0.449,49,52,0.942,4,60,64,51,11,3,36,50,327
2021,J.J. Redick,SG,36,NOP,31,0,576,87,214,0.407,51,140,0.364,36,74,0.486,45,47,0.957,3,49,52,40,9,2,25,37,270
2021,J.J. Redick,SG,36,DAL,13,0,147,19,53,0.358,15,38,0.395,4,15,0.267,4,5,0.8,1,11,12,11,2,1,11,13,57
2021,Ja Morant,PG,21,MEM,63,63,2053,430,957,0.449,73,241,0.303,357,716,0.499,271,372,0.728,59,193,252,465,57,13,203,87,1204
2021,Jabari Parker,PF,25,TOT,13,0,165,30,55,0.545,2,11,0.182,28,44,0.636,10,13,0.769,10,32,42,11,1,5,10,13,72
2021,Jabari Parker,PF,25,SAC,3,0,27,4,7,0.571,0,1,0,4,6,0.667,0,0,,1,5,6,1,0,1,3,4,8
2021,Jabari Parker,PF,25,BOS,10,0,138,26,48,0.542,2,10,0.2,24,38,0.632,10,13,0.769,9,27,36,10,1,4,7,9,64
2021,Jaden McDaniels,PF,20,MIN,63,27,1511,164,367,0.447,72,198,0.364,92,169,0.544,27,45,0.6,52,180,232,71,35,60,47,172,427
2021,Jae Crowder,PF,30,PHO,60,42,1648,199,492,0.404,148,380,0.389,51,112,0.455,57,75,0.76,32,250,282,127,48,27,55,125,603
2021,Jae'Sean Tate,SF,25,HOU,70,58,2043,316,625,0.506,60,195,0.308,256,430,0.595,102,147,0.694,132,242,374,178,85,36,98,222,794
2021,Jahlil Okafor,C,25,DET,27,2,347,63,102,0.618,2,9,0.222,61,93,0.656,17,24,0.708,23,43,66,13,6,5,21,39,145
2021,Jahmi'us Ramsey,SG,19,SAC,13,0,94,15,38,0.395,5,19,0.263,10,19,0.526,5,5,1,2,8,10,6,4,1,3,8,40
2021,JaKarr Sampson,PF,27,IND,29,4,316,56,113,0.496,3,15,0.2,53,98,0.541,19,29,0.655,27,50,77,4,2,14,15,52,134
2021,Jake Layman,SF,26,MIN,45,11,627,91,184,0.495,23,78,0.295,68,106,0.642,26,37,0.703,13,54,67,28,29,19,26,44,231
2021,Jakob Poeltl,C,25,SAS,69,51,1845,265,430,0.616,0,0,,265,430,0.616,63,124,0.508,219,328,547,134,47,123,83,172,593
2021,Jalen Brunson,PG,24,DAL,68,12,1697,328,627,0.523,81,200,0.405,247,427,0.578,120,151,0.795,27,204,231,239,35,1,80,109,857
2021,Jalen Harris,SG,22,TOR,13,2,172,36,72,0.5,17,36,0.472,19,36,0.528,7,9,0.778,3,15,18,17,8,0,14,15,96
2021,Jalen Lecque,PG,20,IND,4,0,12,1,9,0.111,0,1,0,1,8,0.125,3,3,1,2,3,5,2,0,0,0,0,5
2021,Jalen McDaniels,SF,23,CHO,47,18,904,133,284,0.468,35,105,0.333,98,179,0.547,45,64,0.703,45,124,169,53,28,19,45,95,346
2021,Jalen Smith,PF,20,PHO,27,1,156,22,50,0.44,4,17,0.235,18,33,0.545,5,7,0.714,7,30,37,4,1,5,7,16,53
2021,Jamal Murray,PG,23,DEN,48,48,1704,378,792,0.477,129,316,0.408,249,476,0.523,133,153,0.869,37,157,194,231,64,13,108,95,1018
2021,James Ennis III,SF,30,ORL,41,37,986,115,243,0.473,45,104,0.433,70,139,0.504,70,87,0.805,43,123,166,62,32,7,36,84,345
2021,James Harden,PG,31,TOT,44,43,1609,342,734,0.466,121,334,0.362,221,400,0.553,278,323,0.861,35,313,348,475,53,33,177,99,1083
2021,James Harden,PG,31,HOU,8,8,290,60,135,0.444,25,72,0.347,35,63,0.556,53,60,0.883,5,36,41,83,7,6,34,14,198
2021,James Harden,PG,31,BRK,36,35,1319,282,599,0.471,96,262,0.366,186,337,0.552,225,263,0.856,30,277,307,392,46,27,143,85,885
2021,James Johnson,PF,33,TOT,51,12,1043,146,327,0.446,31,120,0.258,115,207,0.556,45,76,0.592,32,145,177,98,42,42,55,120,368
2021,James Johnson,PF,33,DAL,29,1,504,67,145,0.462,15,60,0.25,52,85,0.612,17,29,0.586,14,72,86,50,24,23,27,59,166
2021,James Johnson,PF,33,NOP,22,11,539,79,182,0.434,16,60,0.267,63,122,0.516,28,47,0.596,18,73,91,48,18,19,28,61,202
2021,James Nunnally,SF,30,NOP,9,0,48,5,13,0.385,4,12,0.333,1,1,1,1,2,0.5,2,7,9,3,0,0,2,1,15
2021,James Wiseman,C,19,GSW,39,27,836,191,368,0.519,12,38,0.316,179,330,0.542,54,86,0.628,55,171,226,26,11,36,60,121,448
2021,JaMychal Green,PF,30,DEN,58,5,1120,173,374,0.463,79,198,0.399,94,176,0.534,46,57,0.807,85,192,277,53,26,22,53,144,471
2021,Jared Dudley,PF,35,LAL,12,0,81,2,9,0.222,2,6,0.333,0,3,0,0,0,,4,17,21,5,1,1,2,7,6
2021,Jared Harper,PG,23,NYK,8,0,16,0,4,0,0,1,0,0,3,0,3,4,0.75,0,2,2,1,0,0,3,1,3
2021,Jaren Jackson Jr.,C,21,MEM,11,4,258,53,125,0.424,17,60,0.283,36,65,0.554,35,42,0.833,17,45,62,12,12,18,15,42,158
2021,Jarred Vanderbilt,PF,21,MIN,64,30,1139,143,236,0.606,1,5,0.2,142,231,0.615,57,102,0.559,118,250,368,76,64,46,53,123,344
2021,Jarrell Brantley,PF,24,UTA,28,0,138,25,52,0.481,12,28,0.429,13,24,0.542,2,2,1,9,18,27,15,7,2,8,17,64
2021,Jarrett Allen,C,22,TOT,63,45,1864,298,482,0.618,6,19,0.316,292,463,0.631,204,290,0.703,196,435,631,106,32,90,100,96,806
2021,Jarrett Allen,C,22,BRK,12,5,320,44,65,0.677,0,0,,44,65,0.677,46,61,0.754,38,87,125,20,7,19,22,21,134
2021,Jarrett Allen,C,22,CLE,51,40,1544,254,417,0.609,6,19,0.316,248,398,0.623,158,229,0.69,158,348,506,86,25,71,78,75,672
2021,Jarrett Culver,SG,21,MIN,34,7,499,69,168,0.411,13,53,0.245,56,115,0.487,29,48,0.604,34,70,104,24,17,9,28,58,180
2021,JaVale McGee,C,33,TOT,46,2,678,144,282,0.511,5,24,0.208,139,258,0.539,44,67,0.657,77,162,239,39,19,54,60,121,337
2021,JaVale McGee,C,33,CLE,33,1,503,112,215,0.521,5,20,0.25,107,195,0.549,36,55,0.655,54,116,170,33,16,40,45,80,265
2021,JaVale McGee,C,33,DEN,13,1,175,32,67,0.478,0,4,0,32,63,0.508,8,12,0.667,23,46,69,6,3,14,15,41,72
2021,Javonte Green,SF-SG,27,TOT,41,2,473,53,102,0.52,10,30,0.333,43,72,0.597,30,40,0.75,26,45,71,17,28,6,19,45,146
2021,Javonte Green,SF,27,BOS,25,2,345,39,71,0.549,7,22,0.318,32,49,0.653,20,30,0.667,20,32,52,11,18,2,13,32,105
2021,Javonte Green,SG,27,CHI,16,0,128,14,31,0.452,3,8,0.375,11,23,0.478,10,10,1,6,13,19,6,10,4,6,13,41
2021,Jaxson Hayes,C,20,NOP,60,3,964,175,280,0.625,6,14,0.429,169,266,0.635,93,120,0.775,92,165,257,35,25,38,39,101,449
2021,Jay Scrubb,SG,20,LAC,4,1,84,14,36,0.389,2,9,0.222,12,27,0.444,5,5,1,2,12,14,1,4,0,7,5,35
2021,Jaylen Adams,PG,24,MIL,7,0,18,1,8,0.125,0,2,0,1,6,0.167,0,0,,0,3,3,2,0,0,0,1,2
2021,Jaylen Brown,SG,24,BOS,58,58,1999,538,1111,0.484,163,411,0.397,375,700,0.536,191,250,0.764,71,276,347,195,72,32,158,168,1430
2021,Jaylen Hoard,SF,21,OKC,19,0,320,44,88,0.5,0,11,0,44,77,0.571,28,41,0.683,21,44,65,24,13,5,17,19,116
2021,Jaylen Nowell,SG,21,MIN,42,0,759,142,335,0.424,50,150,0.333,92,185,0.497,45,55,0.818,19,76,95,62,22,12,28,72,379
2021,Jayson Tatum,SF,22,BOS,64,64,2290,605,1318,0.459,187,485,0.386,418,833,0.502,295,340,0.868,50,422,472,276,75,31,171,122,1692
2021,Jeff Green,PF,34,BRK,68,38,1835,261,530,0.492,103,250,0.412,158,280,0.564,125,161,0.776,34,229,263,108,36,27,54,122,750
2021,Jeff Teague,PG,32,TOT,55,7,950,123,284,0.433,36,82,0.439,87,202,0.431,89,105,0.848,15,73,88,132,34,12,64,56,371
2021,Jeff Teague,PG,32,BOS,34,5,616,78,188,0.415,26,56,0.464,52,132,0.394,51,61,0.836,10,47,57,73,26,7,39,43,233
2021,Jeff Teague,PG,32,MIL,21,2,334,45,96,0.469,10,26,0.385,35,70,0.5,38,44,0.864,5,26,31,59,8,5,25,13,138
2021,Jerami Grant,SF,26,DET,54,54,1829,400,932,0.429,115,329,0.35,285,603,0.473,290,343,0.845,35,215,250,152,35,58,109,125,1205
2021,Jeremiah Martin,PG,24,CLE,9,0,75,9,33,0.273,3,12,0.25,6,21,0.286,1,5,0.2,2,5,7,4,5,2,6,1,22
2021,Jeremy Lamb,SG,28,IND,36,8,765,120,276,0.435,52,128,0.406,68,148,0.459,71,75,0.947,25,106,131,53,34,23,22,72,363
2021,Jerome Robinson,SG,23,WAS,17,6,305,28,95,0.295,11,42,0.262,17,53,0.321,16,20,0.8,4,34,38,25,12,6,19,31,83
2021,Jevon Carter,PG,25,PHO,60,1,717,94,223,0.422,56,151,0.371,38,72,0.528,4,7,0.571,16,76,92,71,29,9,16,56,248
2021,Jimmy Butler,SF,31,MIA,52,52,1745,366,736,0.497,25,102,0.245,341,634,0.538,359,416,0.863,94,265,359,369,108,18,109,71,1116
2021,Joe Harris,SF,29,BRK,69,65,2141,357,707,0.505,211,444,0.475,146,263,0.555,49,63,0.778,43,205,248,130,46,14,62,141,974
2021,Joe Ingles,SF,33,UTA,67,30,1867,275,562,0.489,183,406,0.451,92,156,0.59,76,90,0.844,27,217,244,318,45,12,117,120,809
2021,Joel Embiid,C,26,PHI,51,51,1585,461,899,0.513,58,154,0.377,403,745,0.541,471,548,0.859,113,426,539,145,50,69,159,123,1451
2021,John Collins,PF,23,ATL,63,63,1848,429,771,0.556,83,208,0.399,346,563,0.615,170,204,0.833,118,349,467,78,34,63,84,193,1111
2021,John Konchar,SG,24,MEM,43,0,575,69,138,0.5,21,56,0.375,48,82,0.585,25,30,0.833,35,93,128,47,30,9,18,40,184
2021,John Wall,PG,30,HOU,40,40,1288,293,726,0.404,79,249,0.317,214,477,0.449,158,211,0.749,17,112,129,275,42,31,141,46,823
2021,Jonas Valančiūnas,C,28,MEM,62,61,1755,440,743,0.592,21,57,0.368,419,686,0.611,157,203,0.773,253,523,776,112,35,57,100,179,1058
2021,Jontay Porter,PF,21,MEM,11,0,54,8,15,0.533,3,8,0.375,5,7,0.714,3,5,0.6,4,10,14,1,3,1,7,12,22
2021,Jordan Bell,C,26,TOT,6,1,82,7,22,0.318,0,2,0,7,20,0.35,1,2,0.5,7,17,24,7,3,5,4,7,15
2021,Jordan Bell,C,26,WAS,5,1,67,7,20,0.35,0,2,0,7,18,0.389,0,0,,6,13,19,5,3,3,3,5,14
2021,Jordan Bell,C,26,GSW,1,0,15,0,2,0,0,0,,0,2,0,1,2,0.5,1,4,5,2,0,2,1,2,1
2021,Jordan Bone,PG,23,ORL,14,0,196,23,54,0.426,10,32,0.313,13,22,0.591,0,0,,4,20,24,18,2,0,3,11,56
2021,Jordan Clarkson,SG,28,UTA,68,1,1818,457,1075,0.425,208,599,0.347,249,476,0.523,129,144,0.896,47,227,274,168,61,10,115,110,1251
2021,Jordan McLaughlin,PG,24,MIN,51,2,938,100,242,0.413,33,92,0.359,67,150,0.447,23,30,0.767,21,87,108,193,51,6,51,44,256
2021,Jordan Nwora,SF,22,MIL,30,2,274,62,135,0.459,28,62,0.452,34,73,0.466,19,25,0.76,9,51,60,7,16,7,24,22,171
2021,Jordan Poole,SG,21,GSW,51,7,988,205,474,0.432,97,276,0.351,108,198,0.545,105,119,0.882,15,77,92,99,26,9,51,86,612
2021,Josh Green,SG,20,DAL,39,5,445,42,93,0.452,4,25,0.16,38,68,0.559,13,23,0.565,28,50,78,28,16,3,17,35,101
2021,Josh Hall,SF,20,OKC,21,1,336,30,99,0.303,4,37,0.108,26,62,0.419,22,44,0.5,6,53,59,28,4,1,25,37,86
2021,Josh Hart,SF,25,NOP,47,4,1349,151,344,0.439,63,193,0.326,88,151,0.583,69,89,0.775,53,324,377,109,38,12,49,111,434
2021,Josh Jackson,SG,23,DET,62,25,1560,296,707,0.419,77,257,0.3,219,450,0.487,159,218,0.729,57,197,254,143,53,47,142,178,828
2021,Josh Okogie,SG,22,MIN,59,37,1197,102,254,0.402,29,108,0.269,73,146,0.5,83,108,0.769,63,93,156,63,54,28,43,123,316
2021,Josh Richardson,SG,27,DAL,59,56,1790,264,618,0.427,88,267,0.33,176,351,0.501,99,108,0.917,51,144,195,153,61,24,79,130,715
2021,Jrue Holiday,PG,30,MIL,59,56,1907,414,823,0.503,111,283,0.392,303,540,0.561,107,136,0.787,73,195,268,357,96,37,127,98,1046
2021,Juan Toscano-Anderson,SG,27,GSW,53,16,1107,121,209,0.579,37,92,0.402,84,117,0.718,22,31,0.71,29,205,234,150,41,26,61,111,301
2021,Juancho Hernangómez,PF,25,MIN,52,6,900,130,299,0.435,55,168,0.327,75,131,0.573,60,97,0.619,45,160,205,35,19,7,27,52,375
2021,Julius Randle,PF,26,NYK,71,71,2667,602,1321,0.456,160,389,0.411,442,932,0.474,348,429,0.811,84,639,723,427,64,18,241,225,1712
2021,Justin Holiday,SG,31,IND,72,52,2183,258,625,0.413,173,453,0.382,85,172,0.494,67,85,0.788,32,224,256,119,74,41,54,135,756
2021,Justin Jackson,SF,25,TOT,34,3,577,89,221,0.403,36,117,0.308,53,104,0.51,31,37,0.838,16,61,77,52,15,2,32,32,245
2021,Justin Jackson,SF,25,OKC,33,3,544,86,212,0.406,34,111,0.306,52,101,0.515,30,35,0.857,14,57,71,51,15,2,31,31,236
2021,Justin Jackson,SF,25,MIL,1,0,33,3,9,0.333,2,6,0.333,1,3,0.333,1,2,0.5,2,4,6,1,0,0,1,1,9
2021,Justin James,SF,24,SAC,36,0,310,52,111,0.468,14,38,0.368,38,73,0.521,21,36,0.583,9,21,30,22,8,3,15,23,139
2021,Justin Patton,C,23,HOU,13,6,247,29,70,0.414,9,34,0.265,20,36,0.556,3,4,0.75,14,35,49,14,12,14,4,34,70
2021,Justin Robinson,PG,23,OKC,9,0,88,7,21,0.333,4,14,0.286,3,7,0.429,3,5,0.6,1,6,7,9,3,0,2,10,21
2021,Justise Winslow,SF,24,MEM,26,1,507,74,210,0.352,10,54,0.185,64,156,0.41,20,35,0.571,18,100,118,50,15,12,37,47,178
2021,Jusuf Nurkić,C,26,POR,37,37,880,171,333,0.514,12,30,0.4,159,303,0.525,70,113,0.619,86,246,332,125,38,39,73,103,424
2021,Juwan Morgan,PF,23,UTA,29,0,147,14,30,0.467,4,13,0.308,10,17,0.588,3,7,0.429,9,19,28,9,4,1,4,21,35
2021,Karim Mané,PG,20,ORL,10,0,88,3,13,0.231,1,2,0.5,2,11,0.182,4,5,0.8,1,13,14,4,0,2,3,10,11
2021,Karl-Anthony Towns,C,25,MIN,50,50,1689,425,875,0.486,122,315,0.387,303,560,0.541,267,311,0.859,133,396,529,225,39,57,160,186,1239
2021,Kawhi Leonard,SF,29,LAC,52,52,1773,465,908,0.512,101,254,0.398,364,654,0.557,261,295,0.885,55,282,337,269,81,21,105,82,1292
2021,Keita Bates-Diop,SF,25,SAS,30,0,245,30,67,0.448,5,17,0.294,25,50,0.5,14,21,0.667,9,40,49,12,11,5,7,11,79
2021,Kelan Martin,SF,25,IND,35,0,322,62,138,0.449,24,60,0.4,38,78,0.487,9,10,0.9,18,60,78,17,10,10,16,35,157
2021,Keldon Johnson,SF,21,SAS,69,67,1968,338,705,0.479,60,181,0.331,278,524,0.531,145,196,0.74,93,319,412,121,40,24,78,142,881
2021,Keljin Blevins,SF,25,POR,17,0,75,5,20,0.25,2,8,0.25,3,12,0.25,0,0,,3,7,10,4,2,0,5,8,12
2021,Kelly Olynyk,C-PF,29,TOT,70,62,1997,337,697,0.484,126,368,0.342,211,329,0.641,145,175,0.829,87,402,489,203,79,42,126,207,945
2021,Kelly Olynyk,C,29,MIA,43,38,1157,162,376,0.431,77,243,0.317,85,133,0.639,31,40,0.775,44,217,261,91,40,26,55,123,432
2021,Kelly Olynyk,PF,29,HOU,27,24,840,175,321,0.545,49,125,0.392,126,196,0.643,114,135,0.844,43,185,228,112,39,16,71,84,513
2021,Kelly Oubre Jr.,SF,25,GSW,55,50,1687,318,724,0.439,90,285,0.316,228,439,0.519,123,177,0.695,82,247,329,73,57,42,70,121,849
2021,Kemba Walker,PG,30,BOS,43,43,1369,284,676,0.42,127,353,0.36,157,323,0.486,134,149,0.899,16,154,170,212,48,12,88,61,829
2021,Kendrick Nunn,PG,25,MIA,56,44,1650,319,658,0.485,122,320,0.381,197,338,0.583,56,60,0.933,21,158,179,148,52,14,80,108,816
2021,Kenrich Williams,PF,26,OKC,66,13,1426,219,411,0.533,52,117,0.444,167,294,0.568,36,63,0.571,84,189,273,152,55,17,76,143,526
2021,Kent Bazemore,SF,31,GSW,67,18,1333,176,392,0.449,75,184,0.408,101,208,0.486,54,78,0.692,26,203,229,108,69,33,82,158,481
2021,Kentavious Caldwell-Pope,SG,27,LAL,67,67,1902,218,506,0.431,120,293,0.41,98,213,0.46,97,112,0.866,27,152,179,127,62,26,66,114,653
2021,Kenyon Martin Jr.,SF,20,HOU,45,8,1068,162,318,0.509,35,96,0.365,127,222,0.572,60,84,0.714,73,169,242,48,30,41,38,89,419
2021,Kevin Durant,PF,32,BRK,35,32,1157,324,603,0.537,85,189,0.45,239,414,0.577,210,238,0.882,13,234,247,195,25,45,120,70,943
2021,Kevin Huerter,SG,22,ATL,69,49,2126,316,731,0.432,140,386,0.363,176,345,0.51,50,64,0.781,38,193,231,241,82,18,79,165,822
2021,Kevin Knox,SF,21,NYK,42,0,464,56,143,0.392,35,89,0.393,21,54,0.389,16,20,0.8,10,51,61,19,12,6,17,37,163
2021,Kevin Love,PF,32,CLE,25,25,622,103,252,0.409,57,156,0.365,46,96,0.479,42,51,0.824,17,169,186,63,16,2,38,26,305
2021,Kevin Porter Jr.,SG,20,HOU,26,23,835,156,367,0.425,50,161,0.311,106,206,0.515,69,94,0.734,20,79,99,164,19,8,91,61,431
2021,Kevon Looney,C,24,GSW,61,34,1161,108,197,0.548,4,17,0.235,104,180,0.578,31,48,0.646,117,205,322,119,21,22,37,136,251
2021,Khem Birch,C,28,TOT,67,22,1529,189,380,0.497,13,52,0.25,176,328,0.537,91,129,0.705,174,213,387,89,48,50,44,113,482
2021,Khem Birch,C,28,ORL,48,5,952,94,209,0.45,4,21,0.19,90,188,0.479,63,85,0.741,117,126,243,53,32,28,23,67,255
2021,Khem Birch,C,28,TOR,19,17,577,95,171,0.556,9,31,0.29,86,140,0.614,28,44,0.636,57,87,144,36,16,22,21,46,227
2021,Khris Middleton,SF,29,MIL,68,68,2269,511,1074,0.476,151,365,0.414,360,709,0.508,212,236,0.898,54,352,406,370,74,9,178,160,1385
2021,Khyri Thomas,SG,24,HOU,5,2,153,32,66,0.485,9,27,0.333,23,39,0.59,9,9,1,7,11,18,25,9,6,6,8,82
2021,Killian Hayes,PG,19,DET,26,18,670,71,201,0.353,20,72,0.278,51,129,0.395,14,17,0.824,6,63,69,138,27,10,83,57,176
2021,Killian Tillie,C,22,MEM,18,1,182,19,57,0.333,10,33,0.303,9,24,0.375,9,11,0.818,6,18,24,8,5,8,2,20,57
2021,Kira Lewis Jr.,PG,19,NOP,54,0,904,130,337,0.386,40,120,0.333,90,217,0.415,43,51,0.843,12,59,71,124,38,10,34,88,343
2021,Kostas Antetokounmpo,PF,23,LAL,15,0,56,3,10,0.3,0,0,,3,10,0.3,6,13,0.462,4,15,19,1,2,4,11,8,12
2021,Kris Dunn,PG,26,ATL,4,0,45,1,12,0.083,0,2,0,1,10,0.1,3,4,0.75,0,6,6,2,2,2,3,10,5
2021,Kristaps Porziņģis,C,25,DAL,43,43,1327,325,683,0.476,97,258,0.376,228,425,0.536,118,138,0.855,82,299,381,68,20,58,51,115,865
2021,Kyle Anderson,PF,27,MEM,69,69,1887,308,658,0.468,94,261,0.36,214,397,0.539,144,184,0.783,52,344,396,250,84,57,86,120,854
2021,Kyle Guy,PG,23,SAC,31,0,235,29,88,0.33,13,46,0.283,16,42,0.381,16,20,0.8,5,30,35,32,6,0,11,20,87
2021,Kyle Kuzma,SF,25,LAL,68,32,1954,335,757,0.443,137,380,0.361,198,377,0.525,67,97,0.691,108,309,417,127,35,41,113,121,874
2021,Kyle Lowry,PG,34,TOR,46,46,1601,260,596,0.436,131,331,0.396,129,265,0.487,140,160,0.875,35,212,247,338,45,14,126,143,791
2021,Kyrie Irving,PG,28,BRK,54,54,1886,549,1086,0.506,152,378,0.402,397,708,0.561,201,218,0.922,52,205,257,324,76,37,130,140,1451
2021,KZ Okpala,PF,21,MIA,37,9,447,36,96,0.375,12,50,0.24,24,46,0.522,8,15,0.533,21,47,68,19,10,11,15,59,92
2021,Lamar Stevens,PF,23,CLE,40,0,499,62,136,0.456,4,25,0.16,58,111,0.523,37,51,0.725,24,72,96,25,17,13,23,53,165
2021,LaMarcus Aldridge,C,35,TOT,26,23,674,140,296,0.473,31,80,0.388,109,216,0.505,41,47,0.872,19,99,118,49,11,29,27,47,352
2021,LaMarcus Aldridge,C,35,SAS,21,18,544,115,248,0.464,27,75,0.36,88,173,0.509,31,37,0.838,17,77,94,36,8,18,20,36,288
2021,LaMarcus Aldridge,C,35,BRK,5,5,130,25,48,0.521,4,5,0.8,21,43,0.488,10,10,1,2,22,24,13,3,11,7,11,64
2021,LaMelo Ball,PG,19,CHO,51,31,1469,293,672,0.436,92,261,0.352,201,411,0.489,125,165,0.758,63,239,302,313,81,18,145,136,803
2021,Landry Shamet,SG,23,BRK,61,12,1403,186,456,0.408,129,333,0.387,57,123,0.463,66,78,0.846,11,101,112,99,31,10,48,93,567
2021,Langston Galloway,SG,29,PHO,40,0,438,66,147,0.449,36,85,0.424,30,62,0.484,22,23,0.957,7,35,42,26,8,0,13,25,190
2021,Larry Nance Jr.,PF,28,CLE,35,27,1091,128,272,0.471,41,114,0.36,87,158,0.551,30,49,0.612,54,181,235,107,61,17,55,72,327
2021,Lauri Markkanen,PF,23,CHI,51,26,1317,250,521,0.48,119,296,0.402,131,225,0.582,76,92,0.826,35,233,268,45,26,15,52,75,695
2021,LeBron James,PG,36,LAL,45,45,1504,422,823,0.513,104,285,0.365,318,538,0.591,178,255,0.698,29,317,346,350,48,25,168,70,1126
2021,Lonnie Walker IV,SG,22,SAS,60,38,1522,256,609,0.42,100,282,0.355,156,327,0.477,57,70,0.814,14,141,155,101,29,15,65,101,669
2021,Lonzo Ball,PG,23,NOP,55,55,1747,290,700,0.414,172,455,0.378,118,245,0.482,50,64,0.781,33,230,263,316,82,31,123,103,802
2021,Lou Williams,PG,34,TOT,66,4,1423,265,646,0.41,69,173,0.399,196,473,0.414,150,173,0.867,21,117,138,225,47,6,108,62,749
2021,Lou Williams,PG,34,LAC,42,3,918,181,430,0.421,45,119,0.378,136,311,0.437,103,119,0.866,15,73,88,144,39,4,66,42,510
2021,Lou Williams,PG,34,ATL,24,1,505,84,216,0.389,24,54,0.444,60,162,0.37,47,54,0.87,6,44,50,81,8,2,42,20,239
2021,Louis King,SF,21,SAC,6,1,85,17,34,0.5,4,11,0.364,13,23,0.565,6,6,1,5,13,18,9,7,3,4,9,44
2021,Luguentz Dort,SG,21,OKC,52,52,1543,247,639,0.387,113,329,0.343,134,310,0.432,122,164,0.744,38,151,189,88,45,19,79,134,729
2021,Luka Dončić,PG,21,DAL,66,66,2262,647,1351,0.479,192,548,0.35,455,803,0.567,344,471,0.73,54,473,527,567,64,36,281,152,1830
2021,Luka Šamanić,PF,21,SAS,33,4,308,47,105,0.448,12,43,0.279,35,62,0.565,16,29,0.552,16,52,68,15,8,8,20,43,122
2021,Luke Kennard,SG,24,LAC,63,17,1232,197,414,0.476,100,224,0.446,97,190,0.511,26,31,0.839,15,146,161,104,23,9,48,91,520
2021,Luke Kornet,C-PF,25,TOT,31,2,348,44,101,0.436,15,59,0.254,29,42,0.69,3,6,0.5,14,53,67,24,4,32,7,20,106
2021,Luke Kornet,PF,25,CHI,13,0,94,9,27,0.333,6,23,0.261,3,4,0.75,2,4,0.5,1,14,15,4,2,7,1,1,26
2021,Luke Kornet,C,25,BOS,18,2,254,35,74,0.473,9,36,0.25,26,38,0.684,1,2,0.5,13,39,52,20,2,25,6,19,80
2021,Malachi Flynn,PG,22,TOR,47,14,928,127,340,0.374,54,168,0.321,73,172,0.424,45,56,0.804,10,106,116,137,38,7,43,68,353
2021,Malcolm Brogdon,PG,28,IND,56,56,1930,444,980,0.453,145,374,0.388,299,606,0.493,153,177,0.864,58,236,294,329,49,15,115,110,1186
2021,Malik Beasley,SG,24,MIN,37,36,1214,264,600,0.44,128,321,0.399,136,279,0.487,68,80,0.85,28,134,162,88,30,7,60,62,724
2021,Malik Fitts,PF,23,LAC,3,0,11,1,3,0.333,1,2,0.5,0,1,0,0,0,,0,3,3,0,0,0,0,3,3
2021,Malik Monk,SG,22,CHO,42,0,878,173,399,0.434,85,212,0.401,88,187,0.471,59,72,0.819,14,87,101,87,19,4,55,47,490
2021,Mamadi Diakite,PF,24,MIL,14,1,141,16,40,0.4,1,8,0.125,15,32,0.469,11,14,0.786,8,26,34,8,7,6,3,16,44
2021,Marc Gasol,C,36,LAL,52,42,993,88,194,0.454,50,122,0.41,38,72,0.528,36,50,0.72,38,177,215,109,26,58,53,115,262
2021,Marcus Morris,PF,31,LAC,57,29,1502,276,584,0.473,140,296,0.473,136,288,0.472,73,89,0.82,35,199,234,58,34,15,57,117,765
2021,Marcus Smart,PG,26,BOS,48,45,1581,203,510,0.398,93,282,0.33,110,228,0.482,128,162,0.79,36,131,167,273,72,23,96,126,627
2021,Markelle Fultz,PG,22,ORL,8,8,215,41,104,0.394,4,16,0.25,37,88,0.42,17,19,0.895,5,20,25,43,8,2,18,18,103
2021,Markieff Morris,PF,31,LAL,61,27,1200,153,378,0.405,65,209,0.311,88,169,0.521,36,50,0.72,48,218,266,73,22,19,54,105,407
2021,Markus Howard,SG,21,DEN,37,1,205,40,106,0.377,18,65,0.277,22,41,0.537,7,9,0.778,1,20,21,18,4,1,18,23,105
2021,Marques Bolden,C,22,CLE,6,0,29,1,3,0.333,0,0,,1,3,0.333,5,8,0.625,3,3,6,0,2,2,2,0,7
2021,Marquese Chriss,PF,23,GSW,2,0,27,5,14,0.357,1,5,0.2,4,9,0.444,2,4,0.5,3,10,13,2,0,2,2,3,13
2021,Marvin Bagley III,PF,21,SAC,43,42,1112,247,490,0.504,37,108,0.343,210,382,0.55,77,134,0.575,106,212,318,43,21,21,59,100,608
2021,Mason Jones,SG,22,TOT,32,1,334,52,123,0.423,24,66,0.364,28,57,0.491,40,64,0.625,7,48,55,42,7,1,29,24,168
2021,Mason Jones,SG,22,HOU,26,1,307,47,114,0.412,23,64,0.359,24,50,0.48,35,57,0.614,4,47,51,39,6,1,28,22,152
2021,Mason Jones,SG,22,PHI,6,0,27,5,9,0.556,1,2,0.5,4,7,0.571,5,7,0.714,3,1,4,3,1,0,1,2,16
2021,Mason Plumlee,C,30,DET,56,56,1499,234,381,0.614,0,7,0,234,374,0.626,113,169,0.669,145,374,519,202,43,50,105,186,581
2021,Matisse Thybulle,SG,23,PHI,65,8,1298,102,243,0.42,43,143,0.301,59,100,0.59,8,18,0.444,30,94,124,63,105,71,32,127,255
2021,Matt Thomas,SG,26,TOT,45,0,326,50,127,0.394,27,80,0.338,23,47,0.489,12,14,0.857,7,37,44,19,4,0,14,18,139
2021,Matt Thomas,SG,26,TOR,26,0,192,24,62,0.387,17,41,0.415,7,21,0.333,6,7,0.857,3,18,21,9,2,0,6,10,71
2021,Matt Thomas,SG,26,UTA,19,0,134,26,65,0.4,10,39,0.256,16,26,0.615,6,7,0.857,4,19,23,10,2,0,8,8,68
2021,Matthew Dellavedova,PG,30,CLE,13,1,224,14,56,0.25,4,25,0.16,10,31,0.323,4,4,1,6,18,24,58,4,1,6,21,36
2021,Maurice Harkless,PF-SF,27,TOT,37,23,772,69,165,0.418,23,84,0.274,46,81,0.568,33,43,0.767,13,76,89,44,30,20,22,86,194
2021,Maurice Harkless,SF,27,MIA,11,3,124,5,13,0.385,5,11,0.455,0,2,0,0,2,0,2,11,13,7,2,4,3,14,15
2021,Maurice Harkless,PF,27,SAC,26,20,648,64,152,0.421,18,73,0.247,46,79,0.582,33,41,0.805,11,65,76,37,28,16,19,72,179
2021,Max Strus,SF,24,MIA,39,0,507,85,187,0.455,50,148,0.338,35,39,0.897,16,24,0.667,5,36,41,24,11,2,8,43,236
2021,Maxi Kleber,PF,29,DAL,50,40,1341,116,275,0.422,87,212,0.41,29,63,0.46,34,37,0.919,47,213,260,68,24,35,30,105,353
2021,Meyers Leonard,C,28,MIA,3,2,29,3,7,0.429,3,7,0.429,0,0,,1,2,0.5,0,7,7,2,0,0,2,5,10
2021,Mfiondu Kabengele,PF,23,TOT,39,0,280,33,89,0.371,13,50,0.26,20,39,0.513,16,20,0.8,12,48,60,17,8,13,15,36,95
2021,Mfiondu Kabengele,PF,23,LAC,23,0,94,9,32,0.281,4,18,0.222,5,14,0.357,5,6,0.833,1,13,14,5,2,3,6,18,27
2021,Mfiondu Kabengele,PF,23,CLE,16,0,186,24,57,0.421,9,32,0.281,15,25,0.6,11,14,0.786,11,35,46,12,6,10,9,18,68
2021,Michael Carter-Williams,SG,29,ORL,31,25,800,105,270,0.389,15,61,0.246,90,209,0.431,49,80,0.613,39,100,139,129,25,17,69,81,274
2021,Michael Porter Jr.,SF,22,DEN,61,54,1912,443,817,0.542,170,382,0.445,273,435,0.628,106,134,0.791,91,354,445,70,40,54,77,126,1162
2021,Mikal Bridges,SF,24,PHO,72,72,2348,363,669,0.543,134,315,0.425,229,354,0.647,110,131,0.84,76,233,309,152,76,63,57,116,970
2021,Mike Conley,PG,33,UTA,51,51,1498,284,640,0.444,138,335,0.412,146,305,0.479,121,142,0.852,36,141,177,305,70,9,99,98,827
2021,Mike James,PG,30,BRK,13,1,236,34,92,0.37,11,31,0.355,23,61,0.377,21,27,0.778,3,29,32,54,6,1,20,10,100
2021,Mike Muscala,C,29,OKC,35,0,645,119,267,0.446,68,184,0.37,51,83,0.614,33,36,0.917,19,113,132,28,8,11,21,54,339
2021,Mike Scott,PF,32,PHI,51,12,852,76,211,0.36,53,155,0.342,23,56,0.411,8,12,0.667,11,109,120,40,24,14,19,72,213
2021,Miles Bridges,PF,22,CHO,66,19,1932,313,622,0.503,116,290,0.4,197,332,0.593,98,113,0.867,81,316,397,147,44,52,106,143,840
2021,Mitchell Robinson,C,22,NYK,31,29,853,115,176,0.653,0,0,,115,176,0.653,26,53,0.491,113,139,252,17,35,45,26,86,256
2021,Miye Oni,SG,23,UTA,54,0,519,35,99,0.354,30,88,0.341,5,11,0.455,5,6,0.833,23,61,84,28,11,8,16,61,105
2021,Mo Bamba,C,22,ORL,46,5,725,142,301,0.472,38,118,0.322,104,183,0.568,45,66,0.682,76,189,265,35,14,58,36,87,367
2021,Monte Morris,PG,25,DEN,47,13,1196,186,387,0.481,51,134,0.381,135,253,0.534,58,73,0.795,11,85,96,150,34,13,34,48,481
2021,Montrezl Harrell,C,27,LAL,69,1,1580,375,603,0.622,0,10,0,375,593,0.632,181,256,0.707,158,270,428,73,46,49,74,128,931
2021,Moritz Wagner,C,23,TOT,45,24,722,104,229,0.454,31,91,0.341,73,138,0.529,71,87,0.816,27,119,146,50,26,18,43,108,310
2021,Moritz Wagner,C,23,WAS,25,13,375,62,122,0.508,13,42,0.31,49,80,0.613,41,52,0.788,13,60,73,32,22,8,21,62,178
2021,Moritz Wagner,C,23,BOS,9,1,61,4,14,0.286,2,6,0.333,2,8,0.25,1,2,0.5,3,16,19,6,0,1,9,10,11
2021,Moritz Wagner,C,23,ORL,11,10,286,38,93,0.409,16,43,0.372,22,50,0.44,29,33,0.879,11,43,54,12,4,9,13,36,121
2021,Moses Brown,C,21,OKC,43,32,920,146,268,0.545,0,0,,146,268,0.545,78,126,0.619,154,229,383,10,31,47,43,93,370
2021,Mychal Mulder,PG,26,GSW,60,6,766,119,265,0.449,85,214,0.397,34,51,0.667,14,22,0.636,8,52,60,26,12,12,16,56,337
2021,Myles Turner,C,24,IND,47,47,1455,206,432,0.477,69,206,0.335,137,226,0.606,111,142,0.782,63,243,306,48,40,159,67,165,592
2021,Naji Marshall,SF,23,NOP,32,10,700,82,209,0.392,29,83,0.349,53,126,0.421,53,75,0.707,15,133,148,88,26,10,38,58,246
2021,Nassir Little,PF,20,POR,48,2,640,78,167,0.467,28,80,0.35,50,87,0.575,36,45,0.8,32,96,128,23,5,13,18,51,220
2021,Nate Darling,SG,22,CHO,7,0,26,2,7,0.286,2,7,0.286,0,0,,3,3,1,1,0,1,1,0,1,1,1,9
2021,Nate Hinton,SG,21,DAL,21,0,93,15,42,0.357,4,19,0.211,11,23,0.478,7,10,0.7,1,8,9,8,7,2,5,8,41
2021,Nathan Knight,PF,23,ATL,33,0,279,37,100,0.37,6,33,0.182,31,67,0.463,44,55,0.8,27,45,72,8,9,10,15,22,124
2021,Naz Reid,C,21,MIN,70,15,1347,304,581,0.523,61,174,0.351,243,407,0.597,115,166,0.693,82,240,322,72,34,76,69,179,784
2021,Nemanja Bjelica,PF,32,TOT,37,3,595,89,196,0.454,27,85,0.318,62,111,0.559,37,51,0.725,29,98,127,69,15,5,33,68,242
2021,Nemanja Bjelica,PF,32,SAC,26,1,439,69,150,0.46,17,58,0.293,52,92,0.565,32,42,0.762,24,76,100,49,8,2,28,48,187
2021,Nemanja Bjelica,PF,32,MIA,11,2,156,20,46,0.435,10,27,0.37,10,19,0.526,5,9,0.556,5,22,27,20,7,3,5,20,55
2021,Nerlens Noel,C,26,NYK,64,41,1547,137,223,0.614,0,3,0,137,220,0.623,50,70,0.714,142,266,408,46,70,141,65,176,324
2021,Nic Claxton,C,21,BRK,32,1,594,90,145,0.621,1,5,0.2,89,140,0.636,31,64,0.484,43,123,166,28,23,40,18,68,212
2021,Nick Richards,PF,23,CHO,18,0,63,4,9,0.444,0,1,0,4,8,0.5,7,11,0.636,4,7,11,2,0,0,3,7,15
2021,Nickeil Alexander-Walker,SG,22,NOP,46,13,1007,192,458,0.419,76,219,0.347,116,239,0.485,48,66,0.727,13,131,144,102,47,22,69,88,508
2021,Nico Mannion,PG,19,GSW,30,1,364,39,114,0.342,22,60,0.367,17,54,0.315,23,28,0.821,6,40,46,70,16,1,31,29,123
2021,Nicolas Batum,SF,32,LAC,67,38,1835,191,412,0.464,110,272,0.404,81,140,0.579,48,58,0.828,50,266,316,148,69,37,53,102,540
2021,Nicolò Melli,PF,30,TOT,45,4,566,46,141,0.326,23,85,0.271,23,56,0.411,19,25,0.76,29,93,122,44,14,3,12,58,134
2021,Nicolò Melli,PF,30,NOP,22,0,241,15,59,0.254,7,37,0.189,8,22,0.364,6,7,0.857,12,45,57,25,9,1,7,28,43
2021,Nicolò Melli,PF,30,DAL,23,4,325,31,82,0.378,16,48,0.333,15,34,0.441,13,18,0.722,17,48,65,19,5,2,5,30,91
2021,Nikola Jokić,C,25,DEN,72,72,2488,732,1293,0.566,92,237,0.388,640,1056,0.606,342,394,0.868,205,575,780,599,95,48,222,192,1898
2021,Nikola Vučević,C,30,TOT,70,70,2348,666,1396,0.477,176,440,0.4,490,956,0.513,131,156,0.84,146,671,817,269,65,48,126,137,1639
2021,Nikola Vučević,C,30,ORL,44,44,1500,436,908,0.48,117,288,0.406,319,620,0.515,91,110,0.827,87,430,517,167,42,28,83,79,1080
2021,Nikola Vučević,C,30,CHI,26,26,848,230,488,0.471,59,152,0.388,171,336,0.509,40,46,0.87,59,241,300,102,23,20,43,58,559
2021,Noah Vonleh,C,25,BRK,4,0,11,0,3,0,0,2,0,0,1,0,0,0,,0,1,1,1,0,0,2,2,0
2021,Norman Powell,SG-SF,27,TOT,69,58,2205,438,918,0.477,171,416,0.411,267,502,0.532,236,271,0.871,42,173,215,129,82,18,119,160,1283
2021,Norman Powell,SG,27,TOR,42,31,1277,282,566,0.498,118,269,0.439,164,297,0.552,141,163,0.865,19,107,126,77,47,8,77,98,823
2021,Norman Powell,SF,27,POR,27,27,928,156,352,0.443,53,147,0.361,103,205,0.502,95,108,0.88,23,66,89,52,35,10,42,62,460
2021,Norvel Pelle,C,27,TOT,13,0,84,8,15,0.533,0,0,,8,15,0.533,4,6,0.667,6,13,19,2,1,9,3,14,20
2021,Norvel Pelle,C,27,BRK,3,0,28,3,7,0.429,0,0,,3,7,0.429,0,0,,3,4,7,0,0,3,3,9,6
2021,Norvel Pelle,C,27,SAC,1,0,4,0,1,0,0,0,,0,1,0,3,4,0.75,1,0,1,1,0,0,0,1,3
2021,Norvel Pelle,C,27,NYK,9,0,52,5,7,0.714,0,0,,5,7,0.714,1,2,0.5,2,9,11,1,1,6,0,4,11
2021,Obi Toppin,PF,22,NYK,62,0,683,104,209,0.498,26,85,0.306,78,124,0.629,19,26,0.731,26,112,138,29,17,15,23,55,253
2021,OG Anunoby,SF,23,TOR,43,43,1433,249,519,0.48,104,261,0.398,145,258,0.562,80,102,0.784,54,183,237,94,66,32,75,114,682
2021,Onyeka Okongwu,C,20,ATL,50,4,601,96,149,0.644,0,3,0,96,146,0.658,36,57,0.632,62,101,163,18,23,33,29,100,228
2021,Oshae Brissett,SF,22,IND,21,16,519,73,151,0.483,33,78,0.423,40,73,0.548,50,65,0.769,29,86,115,18,19,20,10,32,229
2021,Otto Porter Jr.,SF-PF,27,TOT,28,6,606,98,227,0.432,39,104,0.375,59,123,0.48,36,42,0.857,28,124,152,55,16,4,25,41,271
2021,Otto Porter Jr.,SF,27,CHI,25,6,540,89,202,0.441,38,95,0.4,51,107,0.477,31,37,0.838,28,110,138,50,12,4,25,37,247
2021,Otto Porter Jr.,PF,27,ORL,3,0,66,9,25,0.36,1,9,0.111,8,16,0.5,5,5,1,0,14,14,5,4,0,0,4,24
2021,P.J. Tucker,PF,35,TOT,52,33,1356,66,177,0.373,40,119,0.336,26,58,0.448,21,28,0.75,51,153,204,61,39,20,40,125,193
2021,P.J. Tucker,PF,35,HOU,32,32,959,48,131,0.366,27,86,0.314,21,45,0.467,18,23,0.783,33,115,148,45,29,18,33,91,141
2021,P.J. Tucker,PF,35,MIL,20,1,397,18,46,0.391,13,33,0.394,5,13,0.385,3,5,0.6,18,38,56,16,10,2,7,34,52
2021,P.J. Washington,PF,22,CHO,64,61,1954,302,686,0.44,112,290,0.386,190,396,0.48,108,145,0.745,93,325,418,161,69,79,128,171,824
2021,Pascal Siakam,PF,26,TOR,56,56,2006,437,961,0.455,73,246,0.297,364,715,0.509,249,301,0.827,95,310,405,250,64,37,130,174,1196
2021,Pat Connaughton,SG,28,MIL,69,4,1575,168,387,0.434,101,272,0.371,67,115,0.583,31,40,0.775,63,269,332,81,49,23,33,99,468
2021,Patrick Beverley,PG,32,LAC,37,34,832,93,220,0.423,56,141,0.397,37,79,0.468,36,45,0.8,29,90,119,76,29,28,34,108,278
2021,Patrick McCaw,SF,25,TOR,5,0,33,1,1,1,0,0,,1,1,1,3,3,1,1,2,3,4,2,0,0,6,5
2021,Patrick Patterson,PF,31,LAC,38,5,582,72,165,0.436,40,112,0.357,32,53,0.604,13,17,0.765,19,56,75,29,14,8,11,45,197
2021,Patrick Williams,PF,19,CHI,71,71,1983,255,528,0.483,54,138,0.391,201,390,0.515,91,125,0.728,66,261,327,99,64,46,98,126,655
2021,Patty Mills,PG,32,SAS,68,1,1685,252,611,0.412,161,429,0.375,91,182,0.5,71,78,0.91,18,98,116,162,42,3,66,81,736
2021,Paul George,SF,30,LAC,54,54,1821,445,953,0.467,171,416,0.411,274,537,0.51,198,228,0.868,45,314,359,280,62,24,179,132,1259
2021,Paul Millsap,PF,35,DEN,56,36,1162,191,401,0.476,49,143,0.343,142,258,0.55,71,98,0.724,76,186,262,98,51,36,51,111,502
2021,Paul Reed,PF,21,PHI,26,0,177,42,78,0.538,0,6,0,42,72,0.583,4,8,0.5,30,31,61,12,10,13,12,29,88
2021,Paul Watson,SF,26,TOR,27,2,297,38,82,0.463,30,64,0.469,8,18,0.444,5,8,0.625,4,41,45,17,6,3,9,36,111
2021,Payton Pritchard,SG,23,BOS,66,4,1268,184,418,0.44,102,248,0.411,82,170,0.482,40,45,0.889,33,125,158,120,37,9,53,104,510
2021,PJ Dozier,SG,24,DEN,50,6,1088,148,355,0.417,47,149,0.315,101,206,0.49,42,66,0.636,35,147,182,92,31,22,46,86,385
2021,Precious Achiuwa,PF,21,MIA,61,4,737,124,228,0.544,0,1,0,124,227,0.546,56,110,0.509,73,135,208,29,20,28,43,91,304
2021,Quinn Cook,PG,27,TOT,23,0,157,29,68,0.426,11,26,0.423,18,42,0.429,7,8,0.875,2,15,17,18,4,1,7,10,76
2021,Quinn Cook,PG,27,LAL,16,0,62,12,26,0.462,5,13,0.385,7,13,0.538,4,5,0.8,0,5,5,5,1,1,3,2,33
2021,Quinn Cook,PG,27,CLE,7,0,95,17,42,0.405,6,13,0.462,11,29,0.379,3,3,1,2,10,12,13,3,0,4,8,43
2021,Quinndary Weatherspoon,SG,24,SAS,20,0,121,16,35,0.457,1,6,0.167,15,29,0.517,13,16,0.813,3,8,11,8,8,2,10,18,46
2021,R.J. Hampton,SG-PG,19,TOT,51,1,888,136,313,0.435,27,87,0.31,109,226,0.482,55,82,0.671,29,150,179,87,21,10,53,61,354
2021,R.J. Hampton,PG,19,DEN,25,0,233,25,60,0.417,5,18,0.278,20,42,0.476,9,12,0.75,10,40,50,14,5,2,11,22,64
2021,R.J. Hampton,SG,19,ORL,26,1,655,111,253,0.439,22,69,0.319,89,184,0.484,46,70,0.657,19,110,129,73,16,8,42,39,290
2021,Rajon Rondo,PG,34,TOT,45,3,770,95,215,0.442,36,89,0.404,59,126,0.468,16,17,0.941,18,92,110,199,37,4,79,53,242
2021,Rajon Rondo,PG,34,ATL,27,2,402,44,110,0.4,17,45,0.378,27,65,0.415,1,2,0.5,4,51,55,95,19,2,39,25,106
2021,Rajon Rondo,PG,34,LAC,18,1,368,51,105,0.486,19,44,0.432,32,61,0.525,15,15,1,14,41,55,104,18,2,40,28,136
2021,Raul Neto,PG,28,WAS,64,22,1403,209,447,0.468,64,164,0.39,145,283,0.512,75,85,0.882,28,128,156,146,73,6,53,109,557
2021,Ray Spalding,C,23,HOU,2,0,19,2,4,0.5,0,1,0,2,3,0.667,0,2,0,2,2,4,0,0,2,3,3,4
2021,Rayjon Tucker,PG,23,PHI,14,0,68,9,18,0.5,2,7,0.286,7,11,0.636,14,19,0.737,1,10,11,6,2,0,4,8,34
2021,Reggie Bullock,SF,29,NYK,65,64,1949,248,561,0.442,163,398,0.41,85,163,0.521,50,55,0.909,16,207,223,99,52,11,45,146,709
2021,Reggie Jackson,SG,30,LAC,67,43,1544,263,585,0.45,122,282,0.433,141,303,0.465,67,82,0.817,24,168,192,205,41,7,74,127,715
2021,Reggie Perry,PF,20,BRK,26,0,211,32,78,0.41,4,21,0.19,28,57,0.491,10,13,0.769,27,46,73,14,6,6,15,40,78
2021,Richaun Holmes,C,27,SAC,61,61,1782,366,575,0.637,2,11,0.182,364,564,0.645,135,170,0.794,144,360,504,101,39,96,75,213,869
2021,Ricky Rubio,PG,30,MIN,68,51,1772,193,498,0.388,66,214,0.308,127,284,0.447,130,150,0.867,28,195,223,433,98,4,111,139,582
2021,RJ Barrett,SG,20,NYK,72,72,2511,467,1060,0.441,124,309,0.401,343,751,0.457,206,276,0.746,68,346,414,217,53,20,139,188,1264
2021,Robert Covington,PF,30,POR,70,70,2243,204,509,0.401,135,356,0.379,69,153,0.451,50,62,0.806,61,405,466,117,101,84,64,195,593
2021,Robert Franks,PF,24,ORL,7,0,101,13,28,0.464,5,15,0.333,8,13,0.615,12,13,0.923,6,8,14,5,3,3,2,8,43
2021,Robert Williams,C,23,BOS,52,13,985,186,258,0.721,0,2,0,186,256,0.727,45,73,0.616,133,225,358,94,43,91,52,105,417
2021,Robert Woodard II,SF,21,SAC,13,0,45,8,20,0.4,1,6,0.167,7,14,0.5,3,8,0.375,4,12,16,2,0,3,1,4,20
2021,Robin Lopez,C,32,WAS,71,9,1354,269,425,0.633,5,18,0.278,264,407,0.649,99,137,0.723,141,131,272,55,15,44,75,109,642
2021,Rodions Kurucs,SF-PF,22,TOT,21,0,125,11,32,0.344,6,21,0.286,5,11,0.455,3,4,0.75,5,18,23,10,9,4,13,16,31
2021,Rodions Kurucs,PF,22,BRK,5,0,16,1,3,0.333,1,2,0.5,0,1,0,0,0,,0,3,3,2,0,0,0,1,3
2021,Rodions Kurucs,SF,22,HOU,11,0,75,5,21,0.238,2,15,0.133,3,6,0.5,1,2,0.5,2,9,11,4,6,4,9,7,13
2021,Rodions Kurucs,SF,22,MIL,5,0,34,5,8,0.625,3,4,0.75,2,4,0.5,2,2,1,3,6,9,4,3,0,4,8,15
2021,Rodney Hood,SF,28,TOT,55,5,942,94,260,0.362,34,113,0.301,60,147,0.408,24,28,0.857,23,80,103,53,24,7,36,74,246
2021,Rodney Hood,SF,28,POR,38,5,726,73,201,0.363,25,84,0.298,48,117,0.41,9,12,0.75,18,55,73,47,20,4,31,59,180
2021,Rodney Hood,SF,28,TOR,17,0,216,21,59,0.356,9,29,0.31,12,30,0.4,15,16,0.938,5,25,30,6,4,3,5,15,66
2021,Rodney McGruder,SG,29,DET,16,2,194,37,70,0.529,11,24,0.458,26,46,0.565,6,8,0.75,8,14,22,16,8,1,7,12,91
2021,Romeo Langford,SG,21,BOS,18,4,283,21,59,0.356,5,18,0.278,16,41,0.39,9,12,0.75,12,23,35,13,6,5,10,24,56
2021,Rondae Hollis-Jefferson,PF,26,POR,11,1,107,9,18,0.5,0,1,0,9,17,0.529,9,16,0.563,11,15,26,13,2,4,2,15,27
2021,Royce O'Neale,SF,27,UTA,71,71,2241,175,394,0.444,107,278,0.385,68,116,0.586,39,46,0.848,88,397,485,181,57,32,83,182,496
2021,Rudy Gay,PF,34,SAS,63,1,1358,264,628,0.42,106,278,0.381,158,350,0.451,82,102,0.804,42,261,303,88,45,40,65,115,716
2021,Rudy Gobert,C,28,UTA,71,71,2187,391,579,0.675,0,4,0,391,575,0.68,233,374,0.623,240,720,960,89,40,190,118,163,1015
2021,Rui Hachimura,PF,22,WAS,57,57,1797,310,648,0.478,45,137,0.328,265,511,0.519,124,161,0.77,49,263,312,82,44,7,68,120,789
2021,Russell Westbrook,PG,32,WAS,65,65,2369,544,1238,0.439,86,273,0.315,458,965,0.475,271,413,0.656,109,641,750,763,89,23,312,190,1445
2021,Ryan Arcidiacono,PG,26,CHI,44,0,450,49,117,0.419,25,67,0.373,24,50,0.48,13,20,0.65,5,62,67,56,9,0,10,47,136
2021,Saben Lee,PG,21,DET,48,7,781,99,210,0.471,8,23,0.348,91,187,0.487,61,89,0.685,20,77,97,174,32,13,55,76,267
2021,Saddiq Bey,SF,21,DET,70,53,1909,279,691,0.404,175,460,0.38,104,231,0.45,124,147,0.844,43,275,318,95,52,14,60,110,857
2021,Sam Merrill,SG,24,MIL,30,2,233,32,72,0.444,21,47,0.447,11,25,0.44,4,4,1,6,24,30,21,8,1,10,17,89
2021,Sean McDermott,SF,24,MEM,18,0,158,13,33,0.394,5,22,0.227,8,11,0.727,8,8,1,6,13,19,4,2,3,4,8,39
2021,Sekou Doumbouya,PF,20,DET,56,11,869,107,282,0.379,26,115,0.226,81,167,0.485,45,64,0.703,39,104,143,47,24,9,44,94,285
2021,Semi Ojeleye,PF,26,BOS,56,15,950,89,221,0.403,58,158,0.367,31,63,0.492,24,32,0.75,31,116,147,37,17,0,21,56,260
2021,Serge Ibaka,C,31,LAC,41,39,955,186,365,0.51,39,115,0.339,147,250,0.588,43,53,0.811,73,202,275,74,9,47,44,76,454
2021,Seth Curry,SG,30,PHI,57,57,1638,258,552,0.467,126,280,0.45,132,272,0.485,69,77,0.896,10,126,136,155,44,8,65,96,711
2021,Shai Gilgeous-Alexander,SG,22,OKC,35,35,1180,287,565,0.508,71,170,0.418,216,395,0.547,185,229,0.808,19,147,166,207,27,23,106,70,830
2021,Shake Milton,SG,24,PHI,63,4,1461,300,667,0.45,71,203,0.35,229,464,0.494,146,176,0.83,33,115,148,193,39,18,103,130,817
2021,Shaquille Harrison,SG,27,TOT,34,0,333,26,78,0.333,3,16,0.188,23,62,0.371,18,22,0.818,7,41,48,25,17,5,11,33,73
2021,Shaquille Harrison,SG,27,UTA,17,0,56,6,20,0.3,0,2,0,6,18,0.333,5,6,0.833,3,6,9,9,2,0,5,3,17
2021,Shaquille Harrison,SG,27,DEN,17,0,277,20,58,0.345,3,14,0.214,17,44,0.386,13,16,0.813,4,35,39,16,15,5,6,30,56
2021,Sindarius Thornwell,SG,26,TOT,21,1,217,15,46,0.326,7,23,0.304,8,23,0.348,4,8,0.5,3,15,18,21,13,2,7,15,41
2021,Sindarius Thornwell,SG,26,NOP,14,1,73,7,21,0.333,3,9,0.333,4,12,0.333,0,2,0,1,4,5,4,5,1,4,3,17
2021,Sindarius Thornwell,SG,26,ORL,7,0,144,8,25,0.32,4,14,0.286,4,11,0.364,4,6,0.667,2,11,13,17,8,1,3,12,24
2021,Skylar Mays,SG,23,ATL,33,0,269,44,98,0.449,14,40,0.35,30,58,0.517,22,25,0.88,10,25,35,30,14,2,9,15,124
2021,Solomon Hill,PF,29,ATL,71,16,1513,107,298,0.359,68,212,0.321,39,86,0.453,35,46,0.761,42,172,214,75,50,11,42,116,317
2021,Spencer Dinwiddie,SG,27,BRK,3,3,64,6,16,0.375,2,7,0.286,4,9,0.444,6,6,1,0,13,13,9,2,1,5,4,20
2021,Stanley Johnson,PF,24,TOR,61,13,1006,89,233,0.382,45,137,0.328,44,96,0.458,44,55,0.8,29,124,153,89,52,18,54,116,267
2021,Stephen Curry,PG,32,GSW,63,63,2152,658,1365,0.482,337,801,0.421,321,564,0.569,362,395,0.916,29,316,345,363,77,8,213,119,2015
2021,Sterling Brown,SG,25,HOU,51,14,1229,150,335,0.448,91,215,0.423,59,120,0.492,25,31,0.806,38,186,224,72,38,12,41,97,416
2021,Steven Adams,C,27,NOP,58,58,1605,189,308,0.614,0,3,0,189,305,0.62,60,135,0.444,213,301,514,111,54,38,78,113,438
2021,Svi Mykhailiuk,SF-SG,23,TOT,66,14,1324,208,506,0.411,105,314,0.334,103,192,0.536,38,50,0.76,24,139,163,110,51,12,88,63,559
2021,Svi Mykhailiuk,SF,23,DET,36,5,634,84,223,0.377,57,171,0.333,27,52,0.519,24,30,0.8,11,63,74,57,27,6,39,33,249
2021,Svi Mykhailiuk,SG,23,OKC,30,9,690,124,283,0.438,48,143,0.336,76,140,0.543,14,20,0.7,13,76,89,53,24,6,49,30,310
2021,T.J. Leaf,PF,23,POR,7,0,35,5,10,0.5,0,0,,5,10,0.5,2,2,1,0,5,5,1,2,1,2,1,12
2021,T.J. McConnell,PG,28,IND,69,3,1796,274,490,0.559,15,48,0.313,259,442,0.586,33,48,0.688,55,201,256,456,128,23,135,113,596
2021,T.J. Warren,SF,27,IND,4,4,117,27,51,0.529,0,7,0,27,44,0.614,8,10,0.8,2,12,14,5,2,0,4,16,62
2021,Tacko Fall,C,25,BOS,19,0,136,21,29,0.724,0,0,,21,29,0.724,5,15,0.333,16,36,52,3,1,20,6,22,47
2021,Taj Gibson,C,35,NYK,45,3,936,99,158,0.627,3,15,0.2,96,143,0.671,40,55,0.727,99,151,250,36,31,49,22,99,241
2021,Talen Horton-Tucker,SG,20,LAL,65,4,1304,224,489,0.458,37,131,0.282,187,358,0.522,100,129,0.775,25,144,169,181,63,21,105,127,585
2021,Taurean Prince,PF,26,TOT,41,10,905,131,327,0.401,62,155,0.4,69,172,0.401,65,76,0.855,19,123,142,76,28,23,47,75,389
2021,Taurean Prince,PF,26,BRK,12,4,218,30,74,0.405,13,37,0.351,17,37,0.459,24,27,0.889,2,32,34,7,8,8,11,21,97
2021,Taurean Prince,PF,26,CLE,29,6,687,101,253,0.399,49,118,0.415,52,135,0.385,41,49,0.837,17,91,108,69,20,15,36,54,292
2021,Terance Mann,SG,24,LAC,67,10,1263,178,350,0.509,38,91,0.418,140,259,0.541,78,94,0.83,56,186,242,104,29,13,40,126,472
2021,Terence Davis,SG,23,TOT,61,4,1074,195,456,0.428,98,267,0.367,97,189,0.513,45,55,0.818,20,134,154,83,44,14,63,97,533
2021,Terence Davis,SG,23,TOR,34,4,493,87,210,0.414,44,122,0.361,43,88,0.489,16,18,0.889,9,57,66,37,17,7,29,48,234
2021,Terence Davis,SG,23,SAC,27,0,581,108,246,0.439,54,145,0.372,54,101,0.535,29,37,0.784,11,77,88,46,27,7,34,49,299
2021,Terrance Ferguson,SG,22,PHI,13,0,49,1,7,0.143,0,5,0,1,2,0.5,0,0,,0,1,1,2,1,0,4,7,2
2021,Terrence Ross,SG,29,ORL,46,2,1347,254,616,0.412,89,264,0.337,165,352,0.469,120,138,0.87,15,143,158,108,47,21,74,88,717
2021,Terry Rozier,SG,26,CHO,69,69,2383,510,1134,0.45,222,571,0.389,288,563,0.512,165,202,0.817,47,255,302,293,87,26,128,119,1407
2021,Thaddeus Young,PF,32,CHI,68,23,1652,370,662,0.559,12,45,0.267,358,617,0.58,71,113,0.628,168,255,423,291,74,40,137,152,823
2021,Thanasis Antetokounmpo,SF,28,MIL,57,3,551,67,137,0.489,7,29,0.241,60,108,0.556,25,49,0.51,54,70,124,46,22,10,43,74,166
2021,Théo Maledon,PG,19,OKC,65,49,1778,226,614,0.368,105,313,0.335,121,301,0.402,101,135,0.748,25,186,211,227,56,11,141,126,658
2021,Theo Pinson,SG,25,NYK,17,0,34,1,9,0.111,0,8,0,1,1,1,0,0,,0,5,5,1,0,0,1,4,2
2021,Thomas Bryant,C,23,WAS,10,10,271,59,91,0.648,9,21,0.429,50,70,0.714,16,24,0.667,18,43,61,15,4,8,11,31,143
2021,Thon Maker,C,23,CLE,8,0,76,10,18,0.556,0,2,0,10,16,0.625,10,11,0.909,8,10,18,4,2,4,3,7,30
2021,Tim Frazier,PG,30,MEM,5,0,62,3,20,0.15,0,8,0,3,12,0.25,2,6,0.333,0,8,8,16,2,1,4,7,8
2021,Tim Hardaway Jr.,SG,28,DAL,70,31,1985,407,911,0.447,207,529,0.391,200,382,0.524,142,174,0.816,20,209,229,126,31,11,64,111,1163
2021,Timothé Luwawu-Cabarrot,SF,25,BRK,58,7,1050,130,356,0.365,75,239,0.314,55,117,0.47,35,43,0.814,28,101,129,69,33,6,43,99,370
2021,Tobias Harris,PF,28,PHI,62,62,2014,473,924,0.512,82,208,0.394,391,716,0.546,182,204,0.892,62,357,419,220,55,51,107,119,1210
2021,Tomáš Satoranský,SG,29,CHI,58,18,1307,169,329,0.514,42,118,0.356,127,211,0.602,67,79,0.848,30,112,142,271,40,14,96,89,447
2021,Tony Bradley,C,23,TOT,42,8,684,131,197,0.665,0,3,0,131,194,0.675,38,55,0.691,85,154,239,37,15,30,33,61,300
2021,Tony Bradley,C,23,PHI,20,8,287,51,75,0.68,0,1,0,51,74,0.689,7,11,0.636,39,65,104,17,6,13,6,28,109
2021,Tony Bradley,C,23,OKC,22,0,397,80,122,0.656,0,2,0,80,120,0.667,31,44,0.705,46,89,135,20,9,17,27,33,191
2021,Tony Snell,SG,29,ATL,47,23,992,88,171,0.515,62,109,0.569,26,62,0.419,11,11,1,18,94,112,59,13,11,21,75,249
2021,Torrey Craig,SF,30,TOT,50,8,803,109,227,0.48,39,106,0.368,70,121,0.579,17,22,0.773,57,140,197,49,28,26,25,83,274
2021,Torrey Craig,SF,30,MIL,18,0,201,18,46,0.391,8,22,0.364,10,24,0.417,1,2,0.5,13,30,43,16,9,7,5,24,45
2021,Torrey Craig,SF,30,PHO,32,8,602,91,181,0.503,31,84,0.369,60,97,0.619,16,20,0.8,44,110,154,33,19,19,20,59,229
2021,Trae Young,PG,22,ATL,63,63,2125,487,1112,0.438,136,397,0.343,351,715,0.491,484,546,0.886,38,207,245,594,53,12,261,111,1594
2021,Tre Jones,PG,21,SAS,37,1,269,37,78,0.474,3,5,0.6,34,73,0.466,17,19,0.895,8,13,21,39,8,0,13,13,94
2021,Tremont Waters,PG,23,BOS,26,3,238,34,84,0.405,15,38,0.395,19,46,0.413,16,17,0.941,5,16,21,62,15,1,27,17,99
2021,Trent Forrest,PG,22,UTA,30,0,302,32,71,0.451,5,26,0.192,27,45,0.6,19,19,1,11,33,44,45,9,4,21,22,88
2021,Trevor Ariza,SF,35,MIA,30,27,841,99,241,0.411,50,143,0.35,49,98,0.5,34,44,0.773,27,117,144,55,31,18,21,55,282
2021,Trey Burke,PG,28,DAL,62,1,911,151,353,0.428,58,164,0.354,93,189,0.492,51,57,0.895,10,44,54,81,36,7,33,64,411
2021,Trey Lyles,PF,25,SAS,23,9,358,43,90,0.478,14,40,0.35,29,50,0.58,15,23,0.652,9,77,86,14,6,1,6,13,115
2021,Tristan Thompson,PF,29,BOS,54,43,1287,169,326,0.518,0,3,0,169,323,0.523,71,120,0.592,169,270,439,67,24,33,62,119,409
2021,Troy Brown Jr.,SF,21,TOT,34,0,524,62,144,0.431,22,70,0.314,40,74,0.541,15,21,0.714,20,85,105,29,10,6,21,49,161
2021,Troy Brown Jr.,SF,21,WAS,21,0,287,33,89,0.371,14,46,0.304,19,43,0.442,10,15,0.667,11,50,61,19,3,4,16,29,90
2021,Troy Brown Jr.,SF,21,CHI,13,0,237,29,55,0.527,8,24,0.333,21,31,0.677,5,6,0.833,9,35,44,10,7,2,5,20,71
2021,Ty Jerome,SG,23,OKC,33,1,788,128,287,0.446,71,168,0.423,57,119,0.479,26,34,0.765,10,81,91,120,20,6,47,61,353
2021,Ty-Shon Alexander,SG,22,PHO,15,0,47,3,12,0.25,2,9,0.222,1,3,0.333,1,2,0.5,2,8,10,6,0,1,3,2,9
2021,Tyler Bey,SF,22,DAL,18,0,71,7,22,0.318,1,4,0.25,6,18,0.333,3,5,0.6,8,11,19,3,0,1,3,6,18
2021,Tyler Cook,SF-PF,23,TOT,32,1,438,69,103,0.67,1,2,0.5,68,101,0.673,17,35,0.486,28,67,95,17,8,2,21,35,156
2021,Tyler Cook,PF,23,BRK,4,0,17,1,3,0.333,0,0,,1,3,0.333,0,0,,1,1,2,2,0,0,1,2,2
2021,Tyler Cook,SF,23,DET,28,1,421,68,100,0.68,1,2,0.5,67,98,0.684,17,35,0.486,27,66,93,15,8,2,20,33,154
2021,Tyler Herro,SG,21,MIA,54,15,1635,307,699,0.439,107,297,0.36,200,402,0.498,94,117,0.803,25,243,268,184,35,17,101,71,815
2021,Tyler Johnson,SG,28,BRK,39,3,684,72,183,0.393,48,132,0.364,24,51,0.471,18,21,0.857,6,71,77,47,14,0,17,43,210
2021,Tyrell Terry,PG,20,DAL,11,0,56,5,16,0.313,0,7,0,5,9,0.556,1,3,0.333,0,6,6,6,5,0,2,2,11
2021,Tyrese Haliburton,PG,20,SAC,58,20,1746,292,619,0.472,121,296,0.409,171,323,0.529,48,56,0.857,39,134,173,309,77,28,92,83,753
2021,Tyrese Maxey,SG,20,PHI,61,8,935,198,429,0.462,31,103,0.301,167,326,0.512,61,70,0.871,11,93,104,120,26,13,41,79,488
2021,Tyus Jones,PG,24,MEM,70,9,1222,178,413,0.431,45,140,0.321,133,273,0.487,41,45,0.911,21,119,140,259,64,6,48,31,442
2021,Udoka Azubuike,C,21,UTA,15,0,57,4,9,0.444,0,0,,4,9,0.444,8,10,0.8,4,9,13,0,1,4,3,9,16
2021,Udonis Haslem,C,40,MIA,1,0,3,2,2,1,0,0,,2,2,1,0,0,,0,1,1,0,0,0,0,0,4
2021,Vernon Carey Jr.,C,19,CHO,19,4,115,18,36,0.5,1,7,0.143,17,29,0.586,9,11,0.818,6,21,27,2,1,5,5,13,46
2021,Victor Oladipo,SG,28,TOT,33,33,1080,235,576,0.408,78,239,0.326,157,337,0.466,104,138,0.754,12,148,160,151,46,14,83,81,652
2021,Victor Oladipo,SG,28,IND,9,9,300,64,152,0.421,25,69,0.362,39,83,0.47,27,37,0.73,1,50,51,38,15,2,18,23,180
2021,Victor Oladipo,SG,28,HOU,20,20,669,155,381,0.407,49,153,0.32,106,228,0.465,65,83,0.783,8,87,95,99,24,10,51,45,424
2021,Victor Oladipo,SG,28,MIA,4,4,111,16,43,0.372,4,17,0.235,12,26,0.462,12,18,0.667,3,11,14,14,7,2,14,13,48
2021,Vincent Poirier,C,27,PHI,10,0,39,3,12,0.25,0,1,0,3,11,0.273,2,6,0.333,6,8,14,2,0,3,4,8,8
2021,Vlatko Čančar,PF,23,DEN,41,1,281,33,72,0.458,9,33,0.273,24,39,0.615,10,13,0.769,11,39,50,14,11,2,14,18,85
2021,Wayne Ellington,SG,33,DET,46,31,1012,149,338,0.441,116,275,0.422,33,63,0.524,28,35,0.8,12,73,85,67,18,9,33,59,442
2021,Wendell Carter Jr.,C,21,TOT,54,44,1375,230,457,0.503,15,51,0.294,215,406,0.53,131,179,0.732,132,311,443,104,35,42,78,146,606
2021,Wendell Carter Jr.,C,21,CHI,32,25,792,129,252,0.512,8,22,0.364,121,230,0.526,82,111,0.739,70,180,250,69,18,24,49,96,348
2021,Wendell Carter Jr.,C,21,ORL,22,19,583,101,205,0.493,7,29,0.241,94,176,0.534,49,68,0.721,62,131,193,35,17,18,29,50,258
2021,Wenyen Gabriel,PF,23,NOP,21,0,241,24,60,0.4,13,32,0.406,11,28,0.393,11,17,0.647,20,34,54,11,9,8,15,32,72
2021,Wes Iwundu,SF,26,TOT,41,4,539,34,102,0.333,5,41,0.122,29,61,0.475,26,31,0.839,15,75,90,18,15,4,19,49,99
2021,Wes Iwundu,SF,26,DAL,23,3,288,17,52,0.327,3,23,0.13,14,29,0.483,12,14,0.857,6,38,44,10,9,3,6,26,49
2021,Wes Iwundu,SF,26,NOP,18,1,251,17,50,0.34,2,18,0.111,15,32,0.469,14,17,0.824,9,37,46,8,6,1,13,23,50
2021,Wesley Matthews,SG,34,LAL,58,10,1130,89,252,0.353,66,197,0.335,23,55,0.418,35,41,0.854,20,73,93,54,38,17,26,80,279
2021,Will Barton,SF,30,DEN,56,52,1736,259,608,0.426,98,257,0.381,161,351,0.459,95,121,0.785,39,187,226,181,50,23,96,95,711
2021,Will Magnay,C,22,NOP,1,0,3,0,1,0,0,1,0,0,0,,0,0,,0,0,0,0,0,0,1,1,0
2021,Willie Cauley-Stein,C,27,DAL,53,16,906,115,182,0.632,1,11,0.091,114,171,0.667,49,78,0.628,66,170,236,35,21,43,29,129,280
2021,Willy Hernangómez,C,26,NOP,47,12,846,151,268,0.563,1,10,0.1,150,258,0.581,62,93,0.667,117,217,334,50,22,23,34,68,365
2021,Xavier Tillman Sr.,PF,22,MEM,59,12,1085,167,299,0.559,22,65,0.338,145,234,0.62,34,53,0.642,74,182,256,75,44,33,45,116,390
2021,Yogi Ferrell,PG,27,TOT,10,0,136,20,57,0.351,9,28,0.321,11,29,0.379,7,9,0.778,5,14,19,22,7,3,3,11,56
2021,Yogi Ferrell,PG,27,CLE,2,0,40,8,21,0.381,3,9,0.333,5,12,0.417,0,2,0,3,4,7,5,3,1,3,4,19
2021,Yogi Ferrell,PG,27,LAC,8,0,96,12,36,0.333,6,19,0.316,6,17,0.353,7,7,1,2,10,12,17,4,2,0,7,37
2021,Yuta Watanabe,SF,26,TOR,50,4,723,79,180,0.439,36,90,0.4,43,90,0.478,24,29,0.828,36,123,159,40,26,19,19,57,218
2021,Zach LaVine,SG,25,CHI,58,58,2034,569,1123,0.507,200,477,0.419,369,646,0.571,253,298,0.849,36,253,289,282,46,27,203,138,1591
2021,Zeke Nnaji,PF,20,DEN,42,1,397,50,104,0.481,24,59,0.407,26,45,0.578,12,15,0.8,14,51,65,10,8,4,7,29,136
2021,Zion Williamson,PF,20,NOP,61,61,2026,634,1037,0.611,10,34,0.294,624,1003,0.622,369,529,0.698,167,274,441,226,57,39,167,135,1647
2022,Aaron Gordon,PF,26,DEN,75,75,2376,434,834,0.52,87,260,0.335,347,574,0.573,171,230,0.743,125,314,439,188,44,44,133,148,1126
2022,Aaron Henry,SF,22,PHI,6,0,17,1,5,0.2,0,1,0,1,4,0.2,0,0,,0,1,1,0,0,2,2,2,2
2022,Aaron Holiday,PG,25,TOT,63,15,1021,151,338,0.447,39,103,0.379,112,235,0.504,59,68,0.868,24,98,122,153,42,9,67,92,400
2022,Aaron Nesmith,SF,22,BOS,52,3,574,72,182,0.396,31,115,0.27,41,67,0.481,21,26,0.808,15,74,89,22,20,5,31,70,196
2022,Aaron Wiggins,SG,23,OKC,50,35,1209,156,337,0.463,42,138,0.304,114,199,0.525,62,85,0.729,51,127,178,68,30,10,54,93,416
2022,Abdel Nader,SF,28,PHO,14,0,145,12,35,0.343,4,14,0.286,8,21,0.4,6,10,0.6,4,23,27,7,8,4,11,20,34
2022,Ade Murkey,SG,24,SAC,1,0,1,0,0,,0,0,,0,0,,0,0,,0,0,0,0,0,0,0,0,0
2022,Admiral Schofield,SF,24,ORL,38,1,469,54,129,0.419,26,79,0.329,28,50,0.519,12,15,0.8,17,72,89,25,4,5,21,58,146
2022,Ahmad Caver,SG,25,IND,1,0,1,1,1,1,0,0,,1,1,1,0,0,,0,0,0,0,0,0,0,0,2
2022,Al Horford,C,35,BOS,69,69,2005,266,569,0.467,89,265,0.336,177,304,0.546,80,95,0.842,108,422,530,232,49,92,65,130,701
2022,Alec Burks,SG,30,NYK,81,44,2318,285,728,0.391,157,389,0.404,128,339,0.499,217,264,0.822,47,350,397,239,85,26,91,215,944
2022,Aleem Ford,SF,24,ORL,5,0,74,6,20,0.3,2,15,0.133,4,5,0.35,0,0,,2,13,15,2,1,0,4,7,14
2022,Aleksej Pokusevski,PF,20,OKC,61,12,1233,186,456,0.408,57,197,0.289,129,259,0.47,35,50,0.7,73,245,318,131,39,38,94,88,464
2022,Alex Caruso,SG,27,CHI,41,18,1147,102,256,0.398,42,126,0.333,60,130,0.48,58,73,0.795,33,115,148,165,71,15,57,106,304
2022,Alex Len,C,28,SAC,39,10,620,94,176,0.534,6,21,0.286,88,155,0.551,41,63,0.651,52,109,161,45,13,25,43,100,235
2022,Alfonzo McKinnie,SF,29,CHI,17,3,206,24,61,0.393,9,27,0.333,15,34,0.467,2,8,0.25,13,20,33,5,2,3,7,26,59
2022,Alize Johnson,PF,25,TOT,23,0,167,17,39,0.436,0,4,0,17,35,0.436,7,12,0.583,28,33,61,9,5,0,12,18,41
2022,Alperen Şengün,C,19,HOU,72,13,1489,249,525,0.474,29,117,0.248,220,408,0.502,165,232,0.711,138,255,393,185,59,68,145,214,692
2022,Amir Coffey,SG,24,LAC,69,30,1567,211,466,0.453,96,254,0.378,115,212,0.556,101,117,0.863,26,171,197,124,38,15,45,87,619
2022,Andre Drummond,C,28,TOT,73,36,1437,247,433,0.57,0,3,0,247,430,0.57,86,164,0.524,229,451,680,131,78,68,115,192,580
2022,Andre Iguodala,SF,38,GSW,31,0,603,46,121,0.38,17,74,0.23,29,47,0.45,15,20,0.75,21,79,100,114,27,22,28,34,124
2022,Andrew Wiggins,SF,26,GSW,73,73,2329,475,1019,0.466,157,399,0.393,318,620,0.543,149,235,0.634,85,240,325,161,76,51,111,158,1256
2022,Anfernee Simons,SG,22,POR,57,30,1681,353,797,0.443,179,442,0.405,174,355,0.555,103,116,0.888,26,125,151,221,30,6,115,110,988
2022,Anthony Davis,C,28,LAL,40,40,1404,370,695,0.532,13,70,0.186,357,625,0.542,174,244,0.713,106,288,394,122,49,90,82,97,927
2022,Anthony Edwards,SG,20,MIN,72,72,2466,549,1245,0.441,215,602,0.357,334,643,0.527,220,280,0.786,62,281,343,275,105,46,190,164,1533
2022,Anthony Gill,PF,29,WAS,44,0,463,62,109,0.569,14,26,0.538,48,83,0.633,42,52,0.808,33,52,85,27,5,11,18,58,180
2022,Anthony Lamb,SF,24,SAS,2,0,8,0,2,0,0,2,0,0,0,0,0,0,,0,1,1,2,0,0,0,0,0
2022,Armoni Brooks,SG-PG,23,TOT,54,11,844,98,289,0.339,74,249,0.297,24,40,0.467,18,21,0.857,20,83,103,62,28,11,27,74,288
2022,Arnoldas Kulboka,SF,24,CHO,2,0,5,0,1,0,0,1,0,0,0,0,0,0,,0,0,0,0,0,0,0,1,0
2022,Austin Reaves,SG,23,LAL,61,19,1418,146,318,0.459,53,167,0.317,93,151,0.542,99,118,0.839,45,148,193,110,29,20,40,87,444
2022,Austin Rivers,SG,29,DEN,67,18,1480,146,350,0.417,79,231,0.342,67,119,0.53,32,44,0.727,19,95,114,90,51,6,54,121,403
2022,Avery Bradley,SG,31,LAL,62,45,1406,148,350,0.423,82,210,0.39,66,140,0.54,16,18,0.889,31,105,136,47,53,9,38,118,394
2022,Ayo Dosunmu,SG,22,CHI,77,40,2110,278,535,0.52,70,186,0.376,208,349,0.585,53,78,0.679,27,187,214,256,60,29,108,182,679
2022,B.J. Johnson,SF,26,ORL,4,0,65,11,25,0.44,4,10,0.4,7,15,0.52,0,0,,6,9,15,0,0,1,0,4,26
2022,Bam Adebayo,C,24,MIA,56,56,1825,406,729,0.557,0,6,0,406,723,0.557,256,340,0.753,137,427,564,190,80,44,148,171,1068
2022,Ben McLemore,SG,28,POR,64,6,1285,216,539,0.401,151,417,0.362,65,122,0.541,72,88,0.818,12,91,103,59,38,10,55,103,655
2022,Bismack Biyombo,C,29,PHO,36,3,506,86,145,0.593,0,0,,86,145,0.593,38,71,0.535,63,104,167,23,12,26,25,70,210
2022,Blake Griffin,C,32,BRK,56,24,958,133,313,0.425,38,145,0.262,95,168,0.486,55,76,0.724,60,168,228,105,27,14,31,95,359
2022,Boban Marjanović,C,33,DAL,23,0,128,42,70,0.6,1,4,0.25,41,66,0.607,13,22,0.591,8,31,39,3,0,3,15,24,98
2022,Bobby Portis,C,26,MIL,72,59,2028,417,871,0.479,133,338,0.393,284,533,0.555,85,113,0.752,180,477,657,86,53,51,90,174,1052
2022,Bogdan Bogdanović,SG,29,ATL,63,27,1848,342,794,0.431,169,459,0.368,173,335,0.537,97,115,0.843,29,221,250,194,68,14,70,132,950
2022,Bojan Bogdanović,PF,32,UTA,69,69,2131,422,928,0.455,181,468,0.387,241,460,0.552,223,260,0.858,58,238,296,120,34,1,118,116,1248
2022,Bol Bol,PF,22,DEN,14,0,81,15,27,0.556,1,4,0.25,14,23,0.574,2,5,0.4,4,16,20,5,1,2,4,4,33
2022,Bones Hyland,SG,21,DEN,69,4,1310,230,571,0.403,131,358,0.366,99,213,0.518,107,125,0.856,14,174,188,191,41,20,86,153,698
2022,Brad Wanamaker,PG,32,TOT,23,2,320,28,77,0.364,4,17,0.235,24,60,0.39,23,25,0.92,6,33,39,55,7,6,23,45,83
2022,Bradley Beal,SG,28,WAS,40,40,1439,348,771,0.451,63,210,0.3,285,561,0.492,169,203,0.833,38,151,189,265,36,15,135,95,928
2022,Brandon Boston Jr.,SG,20,LAC,51,0,760,125,325,0.385,34,111,0.306,91,214,0.437,59,72,0.819,17,94,111,51,26,13,31,43,343
2022,Brandon Clarke,PF,25,MEM,64,1,1246,288,447,0.644,5,22,0.227,283,425,0.65,85,130,0.654,135,207,342,86,39,68,34,122,666
2022,Brandon Goodwin,PG,26,CLE,36,5,502,64,154,0.416,19,55,0.345,45,99,0.477,24,38,0.632,14,53,67,91,25,1,36,39,171
2022,Brandon Ingram,SF,24,NOP,55,55,1869,453,983,0.461,74,226,0.327,379,757,0.498,266,322,0.826,35,285,320,307,34,26,151,119,1246
2022,Brandon Knight,PG,30,DAL,5,0,65,10,25,0.4,4,17,0.235,6,8,0.48,8,8,1,0,8,8,8,1,0,4,5,32
2022,Brandon Williams,PG,22,POR,24,16,640,105,282,0.372,31,106,0.292,74,176,0.427,68,97,0.701,19,55,74,94,24,10,58,52,309
2022,Braxton Key,SF,24,TOT,11,0,197,33,72,0.458,6,21,0.286,27,51,0.5,7,13,0.538,13,37,50,11,10,11,11,26,79
2022,Brodric Thomas,SG,25,BOS,12,0,60,8,18,0.444,2,9,0.222,6,9,0.5,3,5,0.6,2,8,10,11,1,1,6,7,21
2022,Brook Lopez,C,33,MIL,13,11,298,61,131,0.466,19,53,0.358,42,78,0.538,20,23,0.87,19,34,53,6,8,15,12,34,161
2022,Bruce Brown,SF,25,BRK,72,45,1774,256,506,0.506,38,94,0.404,218,412,0.543,97,128,0.758,100,245,345,148,77,52,56,176,647
2022,Bruno Fernando,C,23,TOT,30,0,152,36,55,0.655,1,2,0.5,35,53,0.664,15,24,0.625,18,37,55,7,1,11,14,24,88
2022,Bryn Forbes,SG,28,TOT,75,2,1286,231,539,0.429,122,295,0.414,109,244,0.542,79,87,0.908,10,83,93,75,25,5,56,95,663
2022,Buddy Hield,SG,29,TOT,81,32,2499,446,1098,0.406,262,716,0.366,184,382,0.526,111,127,0.874,66,287,353,229,73,25,153,184,1265
2022,C.J. Miles,SG,34,BOS,1,0,2,0,0,,0,0,,0,0,,0,0,,0,0,0,0,0,0,0,1,0
2022,Cade Cunningham,SG,20,DET,64,64,2088,429,1031,0.416,114,363,0.314,315,668,0.471,142,168,0.845,58,296,354,356,78,43,234,200,1114
2022,Caleb Martin,SF,26,MIA,60,12,1372,208,410,0.507,64,155,0.413,144,255,0.585,71,93,0.763,70,160,230,64,58,30,52,104,551
2022,Cam Reddish,SF,22,TOT,49,7,1012,165,408,0.404,66,184,0.359,99,224,0.485,101,112,0.902,25,80,105,48,47,15,57,60,497
2022,Cam Thomas,SG,20,BRK,67,2,1176,218,503,0.433,47,174,0.27,171,329,0.48,87,105,0.829,16,145,161,78,33,8,55,66,570
2022,Cameron Johnson,PF,25,PHO,66,16,1730,279,607,0.46,166,391,0.425,113,216,0.596,98,114,0.86,42,231,273,99,57,16,47,113,822
2022,Cameron McGriff,SF,24,POR,3,0,46,5,14,0.357,2,6,0.333,3,8,0.429,2,2,1,6,9,15,3,0,1,0,7,14
2022,Cameron Oliver,SF,25,ATL,2,0,43,10,15,0.667,1,3,0.333,9,12,0.7,2,3,0.667,2,4,6,3,1,1,0,5,23
2022,Cameron Payne,PG,27,PHO,58,12,1278,240,587,0.409,71,211,0.336,169,376,0.469,75,89,0.843,24,151,175,282,40,17,103,119,626
2022,Caris LeVert,SG,27,TOT,58,49,1781,379,854,0.444,82,256,0.32,297,598,0.492,146,193,0.756,43,171,214,248,51,23,108,131,986
2022,Carlik Jones,PG,24,TOT,5,0,23,1,9,0.111,0,1,0,1,8,0.111,2,2,1,1,2,3,5,1,0,3,0,4
2022,Carmelo Anthony,PF,37,LAL,69,3,1793,319,723,0.441,149,397,0.375,170,326,0.544,132,159,0.83,62,226,288,68,47,52,59,166,919
2022,Carsen Edwards,SG,23,DET,4,0,79,9,30,0.3,4,16,0.25,5,14,0.367,1,1,1,2,4,6,14,2,0,5,4,23
2022,Cassius Stanley,SG,22,DET,9,1,155,19,46,0.413,4,17,0.235,15,29,0.457,10,10,1,5,14,19,4,5,2,6,17,52
2022,Cassius Winston,PG,23,WAS,7,0,39,4,11,0.364,2,6,0.333,2,5,0.455,4,4,1,0,1,1,7,0,0,3,9,14
2022,Cat Barber,PG,27,ATL,3,0,13,0,4,0,0,0,,0,4,0,0,4,0,1,2,3,3,0,0,1,1,0
2022,Cedi Osman,SF,26,CLE,66,3,1462,247,572,0.432,128,359,0.357,119,213,0.544,87,131,0.664,25,121,146,135,52,10,67,127,709
2022,Chandler Hutchison,SF,25,PHO,6,0,22,1,2,0.5,0,0,,1,2,0.5,2,2,1,0,5,5,2,0,0,4,1,4
2022,Charles Bassey,C,21,PHI,23,0,168,30,47,0.638,0,4,0,30,43,0.638,9,12,0.75,22,40,62,7,5,17,8,32,69
2022,Charlie Brown Jr.,SG,24,TOT,22,2,177,10,39,0.256,1,12,0.083,9,27,0.269,9,10,0.9,14,18,32,6,10,4,5,18,30
2022,Chaundee Brown Jr.,SG-SF,23,TOT,5,2,104,10,32,0.313,6,18,0.333,4,14,0.406,5,6,0.833,1,15,16,4,2,0,1,7,31
2022,Cheick Diallo,C,25,DET,3,0,31,3,8,0.375,0,0,,3,8,0.375,5,6,0.833,4,8,12,0,1,0,1,6,11
2022,Chimezie Metu,C,24,SAC,60,20,1279,203,449,0.452,57,186,0.306,146,263,0.516,71,91,0.78,34,301,335,60,51,32,61,93,534
2022,Chris Boucher,SF,29,TOR,80,9,1690,268,577,0.464,68,229,0.297,200,348,0.523,150,193,0.777,179,315,494,25,49,75,42,174,754
2022,Chris Chiozza,PG,26,GSW,34,1,372,24,81,0.296,17,53,0.321,7,28,0.401,2,3,0.667,9,27,36,65,13,0,32,32,67
2022,Chris Duarte,SG,24,IND,55,39,1541,268,621,0.432,94,255,0.369,174,366,0.507,90,112,0.804,41,185,226,114,56,10,90,95,720
2022,Chris Paul,PG,36,PHO,65,65,2139,363,736,0.493,63,199,0.317,300,537,0.536,169,202,0.837,22,261,283,702,121,20,153,134,958
2022,Chris Silva,PF,25,TOT,10,0,91,8,15,0.533,0,0,,8,15,0.533,10,12,0.833,13,23,36,7,0,1,8,20,26
2022,Christian Wood,C,26,HOU,68,67,2094,440,878,0.501,131,336,0.39,309,542,0.576,207,332,0.623,110,576,686,155,54,65,126,171,1218
2022,Chuma Okeke,PF,23,ORL,70,20,1749,216,575,0.376,118,371,0.318,98,204,0.478,55,65,0.846,47,300,347,118,97,42,57,95,605
2022,CJ Elleby,SF,21,POR,58,28,1174,121,308,0.393,37,126,0.294,84,182,0.453,60,84,0.714,66,161,227,87,35,19,56,116,339
2022,CJ McCollum,SG,30,TOT,62,62,2145,536,1164,0.46,182,469,0.388,354,695,0.539,116,170,0.682,53,216,269,315,70,22,127,121,1370
2022,Clint Capela,C,27,ATL,74,73,2042,370,604,0.613,0,1,0,370,603,0.613,80,169,0.473,279,598,877,92,55,93,44,166,820
2022,Coby White,PG,21,CHI,61,17,1675,279,644,0.433,136,353,0.385,143,291,0.539,78,91,0.857,17,165,182,176,29,11,70,137,772
2022,Cody Martin,SF,26,CHO,71,11,1866,204,423,0.482,61,159,0.384,143,264,0.554,75,107,0.701,82,203,285,179,88,32,61,116,544
2022,Cody Zeller,C,29,POR,27,0,355,51,90,0.567,0,4,0,51,86,0.567,38,49,0.776,50,75,125,22,8,6,19,56,140
2022,Cole Anthony,PG,21,ORL,65,65,2059,357,912,0.391,132,391,0.338,225,521,0.464,216,253,0.854,32,316,348,369,46,17,170,171,1062
2022,Collin Sexton,SG,23,CLE,11,11,316,68,151,0.45,11,45,0.244,57,106,0.487,29,39,0.744,13,23,36,23,10,0,31,25,176
2022,Corey Kispert,SF,22,WAS,77,36,1801,234,514,0.455,112,320,0.35,122,194,0.564,54,62,0.871,53,156,209,85,35,22,50,93,634
2022,Cory Joseph,PG,30,DET,65,39,1600,178,400,0.445,65,157,0.414,113,243,0.526,100,113,0.885,29,145,174,237,42,17,85,147,521
2022,Craig Sword,SG,28,WAS,3,0,19,3,4,0.75,0,1,0,3,3,0.75,0,0,,0,0,0,1,4,0,1,7,6
2022,D.J. Augustin,PG,34,TOT,55,2,883,94,222,0.423,68,164,0.415,26,58,0.577,38,43,0.884,11,57,68,107,17,1,56,39,294
2022,D.J. Wilson,PF,25,TOR,4,1,54,11,15,0.733,0,2,0,11,13,0.733,8,10,0.8,1,15,16,5,5,1,2,6,30
2022,D'Angelo Russell,PG,25,MIN,65,65,2077,401,975,0.411,176,518,0.34,225,457,0.502,198,240,0.825,25,191,216,460,62,22,165,130,1176
2022,Daishen Nix,SG,19,HOU,24,0,261,27,67,0.403,7,26,0.269,20,41,0.455,16,30,0.533,7,26,33,40,15,0,26,21,77
2022,Dakota Mathias,SG,26,MEM,6,0,16,2,6,0.333,2,6,0.333,0,0,0.5,0,0,,0,2,2,1,1,0,0,1,6
2022,Dalano Banton,PG,22,TOR,64,1,696,83,202,0.411,13,51,0.255,70,151,0.443,26,44,0.591,38,86,124,99,28,10,53,68,205
2022,Damian Jones,C,26,SAC,56,15,1017,175,266,0.658,10,29,0.345,165,237,0.677,94,131,0.718,75,171,246,69,26,47,59,130,454
2022,Damian Lillard,PG,31,POR,29,29,1056,222,552,0.402,92,284,0.324,130,268,0.486,159,181,0.878,13,107,120,212,17,11,83,37,695
2022,Damion Lee,SG,29,GSW,63,5,1256,169,383,0.441,63,187,0.337,106,196,0.523,66,75,0.88,27,176,203,63,39,6,38,95,467
2022,Damyean Dotson,SG,27,NYK,2,0,21,2,4,0.5,0,1,0,2,3,0.5,0,0,,0,2,2,1,0,0,0,0,4
2022,Daniel Gafford,C,23,WAS,72,53,1444,285,411,0.693,0,1,0,285,410,0.693,107,153,0.699,155,252,407,68,30,99,65,170,677
2022,Daniel Oturu,C,22,TOR,3,0,27,3,6,0.5,0,1,0,3,5,0.5,3,5,0.6,1,4,5,0,0,2,0,1,9
2022,Daniel Theis,C,29,TOT,47,27,977,151,291,0.519,33,107,0.308,118,184,0.576,49,72,0.681,59,169,228,41,20,31,46,111,384
2022,Danilo Gallinari,PF,33,ATL,66,18,1672,259,597,0.434,112,294,0.381,147,303,0.528,141,156,0.904,35,273,308,101,28,12,38,93,771
2022,Danny Green,SF,34,PHI,62,28,1353,126,320,0.394,103,271,0.38,23,49,0.555,11,14,0.786,32,125,157,64,60,37,45,105,366
2022,Danuel House Jr.,SF,28,TOT,42,7,727,80,198,0.404,44,117,0.376,36,81,0.515,44,58,0.759,18,93,111,44,21,17,33,51,248
2022,DaQuan Jeffries,SG,24,MEM,3,0,9,1,2,0.5,0,1,0,1,1,0.5,0,0,,0,2,2,1,0,0,0,1,2
2022,Darius Bazley,PF,21,OKC,69,53,1924,274,649,0.422,80,269,0.297,194,380,0.484,117,170,0.688,71,365,436,97,58,70,90,68,745
2022,Darius Garland,PG,22,CLE,68,68,2430,542,1173,0.462,174,454,0.383,368,719,0.536,215,241,0.892,39,185,224,583,89,7,248,115,1473
2022,Darren Collison,PG,34,LAL,3,0,37,2,7,0.286,0,3,0,2,4,0.286,0,0,,0,4,4,2,1,0,1,5,4
2022,David Duke Jr.,PG,22,BRK,22,7,341,39,108,0.361,9,37,0.243,30,71,0.403,17,21,0.81,30,37,67,17,14,7,9,36,104
2022,David Johnson,SG,20,TOR,2,0,2,0,1,0,0,1,0,0,0,0,0,0,,0,0,0,0,0,0,0,0,0
2022,David Nwaba,SF,29,HOU,46,4,609,85,176,0.483,15,49,0.306,70,127,0.526,48,67,0.716,41,110,151,35,28,20,21,55,233
2022,Davion Mitchell,PG,23,SAC,75,19,2076,352,843,0.418,101,320,0.316,251,523,0.477,56,85,0.659,33,133,166,313,55,24,114,141,861
2022,Dāvis Bertāns,PF,29,TOT,56,0,807,99,275,0.36,77,230,0.335,22,45,0.5,36,40,0.9,12,105,117,31,17,12,19,85,311
2022,Davon Reed,SG,26,DEN,48,5,668,81,161,0.503,37,86,0.43,44,75,0.618,10,15,0.667,14,94,108,53,24,9,16,63,209
2022,Day'Ron Sharpe,PF,20,BRK,32,8,391,86,149,0.577,2,7,0.286,84,142,0.584,24,41,0.585,81,79,160,17,10,15,30,60,198
2022,De'Aaron Fox,PG,24,SAC,59,59,2083,516,1092,0.473,74,249,0.297,442,843,0.506,261,348,0.75,25,206,231,330,68,25,168,172,1367
2022,De'Andre Hunter,SF,24,ATL,53,52,1577,254,575,0.442,74,195,0.379,180,380,0.506,127,166,0.765,26,150,176,68,36,21,69,155,709
2022,De'Anthony Melton,SG,23,MEM,73,15,1657,281,695,0.404,139,372,0.374,142,323,0.504,90,120,0.75,64,264,328,194,104,39,112,128,791
2022,Dean Wade,PF,25,CLE,51,28,980,99,217,0.456,51,142,0.359,48,75,0.574,20,30,0.667,31,119,150,52,29,7,16,88,269
2022,Deandre Ayton,C,23,PHO,58,58,1713,442,697,0.634,7,19,0.368,435,678,0.639,106,142,0.746,149,444,593,84,40,40,91,142,997
2022,DeAndre Jordan,C,33,TOT,48,20,622,92,143,0.643,0,0,,92,143,0.643,22,40,0.55,83,181,264,21,12,35,37,71,206
2022,DeAndre' Bembry,SF,27,TOT,56,20,1026,124,221,0.561,15,36,0.417,109,185,0.595,21,35,0.6,42,121,163,66,49,25,31,113,284
2022,Deividas Sirvydis,SG,21,DET,3,0,27,1,10,0.1,1,7,0.143,0,3,0.15,0,0,,0,6,6,1,3,1,0,4,3
2022,DeJon Jarreau,SG,24,IND,1,0,1,0,0,,0,0,,0,0,,0,0,,0,0,0,0,0,0,0,0,0
2022,Dejounte Murray,PG,25,SAS,68,68,2366,573,1241,0.462,96,294,0.327,477,947,0.5,196,247,0.794,80,483,563,627,138,23,180,138,1438
2022,Delon Wright,SG,29,ATL,77,8,1452,122,269,0.454,44,116,0.379,78,153,0.535,54,63,0.857,50,170,220,188,93,19,45,56,342
2022,DeMar DeRozan,PF,32,CHI,76,76,2743,774,1535,0.504,50,142,0.352,724,1393,0.521,520,593,0.877,56,336,392,374,68,24,181,178,2118
2022,DeMarcus Cousins,C,31,TOT,48,7,718,149,324,0.46,37,122,0.303,112,202,0.517,95,125,0.76,74,196,270,71,35,21,85,139,430
2022,Deni Avdija,SF,21,WAS,82,8,1984,250,579,0.432,82,259,0.317,168,320,0.503,103,136,0.757,52,373,425,167,59,44,87,190,685
2022,Dennis Schröder,SG-PG,28,TOT,64,29,1837,312,724,0.431,86,250,0.344,226,474,0.49,157,184,0.853,34,180,214,296,53,8,143,154,867
2022,Dennis Smith Jr.,PG,24,POR,37,4,638,79,189,0.418,6,27,0.222,73,162,0.434,42,64,0.656,20,68,88,132,45,12,51,52,206
2022,Denzel Valentine,SG,28,TOT,24,0,222,25,66,0.379,19,47,0.404,6,19,0.523,0,0,,9,33,42,11,8,0,12,20,69
2022,Derrick Favors,C,30,OKC,39,18,653,94,182,0.516,2,16,0.125,92,166,0.522,16,25,0.64,58,126,184,25,17,12,9,62,206
2022,Derrick Jones Jr.,PF,24,CHI,51,8,899,105,195,0.538,20,61,0.328,85,134,0.59,56,70,0.8,60,109,169,30,25,33,30,105,286
2022,Derrick Rose,PG,33,NYK,26,4,636,122,274,0.445,37,92,0.402,85,182,0.513,30,31,0.968,21,57,78,103,22,12,39,15,311
2022,Derrick Walton,PG,26,DET,3,3,108,6,26,0.231,3,13,0.231,3,13,0.288,4,4,1,2,8,10,21,7,4,11,8,19
2022,Derrick White,SG,27,TOT,75,52,2199,337,800,0.421,115,369,0.312,222,431,0.493,203,235,0.864,38,223,261,366,64,58,119,172,992
2022,Desmond Bane,SG,23,MEM,76,76,2266,508,1101,0.461,228,523,0.436,280,578,0.565,140,155,0.903,46,288,334,208,92,29,111,196,1384
2022,Devin Booker,SG,25,PHO,68,68,2345,662,1421,0.466,183,478,0.383,479,943,0.53,315,363,0.868,45,297,342,329,77,26,162,180,1822
2022,Devin Cannady,PG,25,ORL,5,0,145,15,44,0.341,15,37,0.405,0,7,0.511,5,7,0.714,1,5,6,10,5,3,5,9,50
2022,Devin Vassell,SF,21,SAS,71,32,1937,326,764,0.427,137,380,0.361,189,384,0.516,83,99,0.838,44,262,306,136,76,41,58,143,872
2022,Devon Dotson,PG,22,CHI,11,0,85,11,23,0.478,2,9,0.222,9,14,0.522,5,9,0.556,1,8,9,15,1,0,5,11,29
2022,Devontae Cacok,PF,25,SAS,15,0,121,21,31,0.677,0,0,,21,31,0.677,4,7,0.571,8,34,42,6,8,7,3,16,46
2022,Devonte' Graham,PG,26,NOP,76,63,2162,296,815,0.363,192,563,0.341,104,252,0.481,118,140,0.843,37,140,177,316,71,12,105,95,902
2022,Dewayne Dedmon,C,32,MIA,67,15,1065,164,290,0.566,19,47,0.404,145,243,0.598,75,100,0.75,105,281,386,47,24,42,70,174,422
2022,Didi Louzada,SG-SF,22,TOT,9,1,129,12,33,0.364,9,23,0.391,3,10,0.5,2,2,1,5,12,17,5,2,2,5,13,35
2022,Dillon Brooks,SF,26,MEM,32,31,885,227,526,0.432,46,149,0.309,181,377,0.475,90,106,0.849,29,73,102,88,36,8,50,105,590
2022,Domantas Sabonis,PF,25,TOT,62,61,2136,443,773,0.573,39,125,0.312,404,648,0.598,246,332,0.741,201,551,752,323,59,27,195,203,1171
2022,Donovan Mitchell,SG,25,UTA,67,67,2266,617,1376,0.448,232,654,0.355,385,722,0.533,267,313,0.853,55,227,282,358,99,12,200,164,1733
2022,Donte DiVincenzo,SG,25,TOT,42,1,1006,118,336,0.351,74,218,0.339,44,118,0.461,70,83,0.843,40,130,170,118,48,8,72,69,380
2022,Dorian Finney-Smith,PF,28,DAL,80,80,2644,326,692,0.471,172,435,0.395,154,257,0.595,56,83,0.675,122,253,375,150,88,39,80,183,880
2022,Doug McDermott,PF,30,SAS,51,51,1223,215,465,0.462,108,256,0.422,107,209,0.578,40,51,0.784,18,97,115,64,13,6,43,79,578
2022,Draymond Green,PF,31,GSW,46,44,1329,135,257,0.525,16,54,0.296,119,203,0.556,60,91,0.659,45,291,336,320,61,50,139,136,346
2022,Drew Eubanks,C,24,TOT,71,31,1245,221,371,0.596,5,23,0.217,216,348,0.602,99,130,0.762,130,252,382,85,31,40,81,122,546
2022,Duane Washington Jr.,PG,21,IND,48,7,968,173,427,0.405,81,215,0.377,92,212,0.5,46,61,0.754,4,79,83,85,26,3,57,66,473
2022,Duncan Robinson,SG,27,MIA,79,68,2043,290,726,0.399,232,624,0.372,58,102,0.559,51,61,0.836,24,179,203,129,42,14,60,201,863
2022,Dwight Howard,C,36,LAL,60,27,971,134,219,0.612,8,15,0.533,126,204,0.63,96,146,0.658,118,238,356,35,34,36,47,115,372
2022,Dwight Powell,C,30,DAL,82,71,1798,269,401,0.671,13,37,0.351,256,364,0.687,166,212,0.783,173,231,404,97,37,39,64,220,717
2022,Dylan Windler,SF,25,CLE,50,0,459,37,98,0.378,21,70,0.3,16,28,0.485,15,18,0.833,21,68,89,34,14,3,16,47,110
2022,Ed Davis,C,32,CLE,31,3,201,11,16,0.688,0,0,,11,16,0.688,6,14,0.429,14,50,64,7,3,9,5,33,28
2022,Elfrid Payton,PG,27,PHO,50,1,549,67,175,0.383,4,18,0.222,63,157,0.394,12,32,0.375,21,67,88,99,25,6,47,38,150
2022,Elijah Hughes,SG-SF,23,TOT,36,4,434,47,144,0.326,25,95,0.263,22,49,0.413,7,9,0.778,6,52,58,22,14,8,17,39,126
2022,Emanuel Terry,PF,25,PHO,3,0,18,0,5,0,0,0,,0,5,0,0,0,,8,7,15,2,1,0,5,4,0
2022,Emmanuel Mudiay,PG,25,SAC,2,0,11,0,2,0,0,0,,0,2,0,3,4,0.75,0,0,0,4,1,0,1,1,3
2022,Enes Freedom,C,29,BOS,35,1,411,51,97,0.526,2,5,0.4,49,92,0.536,24,28,0.857,61,99,160,8,5,14,20,42,128
2022,Eric Bledsoe,PG,32,LAC,54,29,1361,197,468,0.421,51,163,0.313,146,305,0.475,89,117,0.761,28,154,182,225,69,19,116,85,534
2022,Eric Gordon,SG,33,HOU,57,46,1669,268,564,0.475,124,301,0.412,144,263,0.585,105,135,0.778,15,98,113,154,28,18,107,63,765
2022,Eric Paschall,PF,25,UTA,58,3,736,114,235,0.485,40,108,0.37,74,127,0.57,66,86,0.767,30,76,106,36,9,5,27,51,334
2022,Eugene Omoruyi,SF,24,DAL,4,0,18,2,5,0.4,1,2,0.5,1,3,0.5,2,4,0.5,2,5,7,2,0,0,0,2,7
2022,Evan Fournier,SG,29,NYK,80,80,2358,402,965,0.417,241,619,0.389,161,346,0.541,80,113,0.708,34,176,210,171,79,20,105,180,1125
2022,Evan Mobley,PF,20,CLE,69,69,2331,422,830,0.508,23,92,0.25,399,738,0.522,167,252,0.663,143,427,570,174,56,115,133,147,1034
2022,Facundo Campazzo,PG,30,DEN,65,4,1184,107,296,0.361,58,193,0.301,49,103,0.459,60,78,0.769,23,94,117,220,63,23,67,124,332
2022,Feron Hunt,SF,22,NYK,2,0,8,0,2,0,0,0,,0,2,0,0,0,,1,0,1,1,1,0,1,1,0
2022,Frank Jackson,PG,23,DET,53,7,1164,194,483,0.402,86,279,0.308,108,204,0.491,86,104,0.827,19,68,87,55,27,9,38,89,560
2022,Frank Kaminsky,C,28,PHO,9,0,181,36,66,0.545,5,15,0.333,31,51,0.583,18,20,0.9,11,30,41,13,8,7,5,14,95
2022,Frank Ntilikina,SG,23,DAL,58,5,685,89,223,0.399,38,111,0.342,51,112,0.484,24,25,0.96,12,67,79,69,27,7,31,61,240
2022,Franz Wagner,SF,20,ORL,79,79,2429,456,975,0.468,96,271,0.354,360,704,0.517,189,219,0.863,84,272,356,231,68,34,119,164,1197
2022,Fred VanVleet,PG,27,TOR,65,65,2462,442,1097,0.403,242,642,0.377,200,455,0.513,194,222,0.874,44,245,289,434,111,35,170,162,1320
2022,Freddie Gillespie,PF,24,ORL,9,2,119,9,22,0.409,0,1,0,9,21,0.409,3,7,0.429,13,23,36,5,3,9,5,18,21
2022,Furkan Korkmaz,SG,24,PHI,67,19,1414,182,470,0.387,77,266,0.289,105,204,0.469,68,84,0.81,22,153,175,127,33,9,48,58,509
2022,Gabe Vincent,PG,25,MIA,68,27,1589,214,513,0.417,119,323,0.368,95,190,0.533,44,54,0.815,22,104,126,210,62,12,98,158,591
2022,Gabe York,SG,28,IND,2,0,21,2,7,0.286,1,6,0.167,1,1,0.357,3,5,0.6,0,2,2,4,2,1,1,4,8
2022,Gabriel Deck,PF,26,OKC,7,0,56,8,14,0.571,2,4,0.5,6,10,0.643,0,0,,1,5,6,5,1,0,2,2,18
2022,Gabriel Lundberg,SG,27,PHO,4,0,44,5,19,0.263,3,8,0.375,2,11,0.342,0,0,,2,5,7,11,3,0,3,7,13
2022,Garrett Temple,SG,35,NOP,59,16,1098,111,295,0.376,59,185,0.319,52,110,0.476,28,41,0.683,29,114,143,74,43,23,42,81,309
2022,Garrison Mathews,SG,25,HOU,65,33,1712,184,461,0.399,139,386,0.36,45,75,0.55,143,180,0.794,32,158,190,64,57,24,41,168,650
2022,Gary Clark,PF,27,NOP,38,1,378,33,88,0.375,28,70,0.4,5,18,0.534,7,10,0.7,23,67,90,18,13,7,10,20,101
2022,Gary Harris,SG,27,ORL,61,30,1730,240,553,0.434,116,302,0.384,124,251,0.539,83,95,0.874,36,86,122,108,59,9,61,112,679
2022,Gary Payton II,SG,29,GSW,71,16,1247,212,344,0.616,43,120,0.358,169,224,0.679,35,58,0.603,72,175,247,64,96,22,40,131,502
2022,Gary Trent Jr.,SG,23,TOR,70,69,2448,450,1086,0.414,209,545,0.383,241,541,0.511,174,204,0.853,26,165,191,141,122,19,73,144,1283
2022,George Hill,PG,35,MIL,54,17,1253,118,275,0.429,41,134,0.306,77,141,0.504,57,62,0.919,38,117,155,120,42,6,41,70,334
2022,George King,SF,28,DAL,4,0,19,0,5,0,0,4,0,0,1,0,1,2,0.5,0,5,5,0,0,0,1,4,1
2022,Georges Niang,PF,28,PHI,76,7,1736,246,563,0.437,156,387,0.403,90,176,0.575,52,59,0.881,25,178,203,102,30,13,59,190,700
2022,Georgios Kalaitzakis,SF,23,TOT,13,4,214,31,67,0.463,10,26,0.385,21,41,0.537,14,30,0.467,6,15,21,12,11,2,20,19,86
2022,Giannis Antetokounmpo,PF,27,MIL,67,67,2204,689,1245,0.553,71,242,0.293,618,1003,0.582,553,766,0.722,134,644,778,388,72,91,219,212,2002
2022,Goga Bitadze,C,22,IND,50,16,729,131,252,0.52,23,80,0.288,108,172,0.565,64,94,0.681,79,98,177,55,21,42,46,107,349
2022,Goran Dragić,PG,35,TOT,21,8,498,57,151,0.377,16,63,0.254,41,88,0.43,27,33,0.818,13,52,65,86,19,4,34,45,157
2022,Gordon Hayward,SF,31,CHO,49,48,1564,283,617,0.459,86,220,0.391,197,397,0.528,126,149,0.846,38,186,224,177,47,22,81,85,778
2022,Gorgui Dieng,C,32,ATL,44,3,371,53,112,0.473,29,68,0.426,24,44,0.603,19,26,0.731,32,89,121,34,11,13,20,52,154
2022,Grant Williams,PF,23,BOS,77,21,1875,205,432,0.475,106,258,0.411,99,174,0.597,86,95,0.905,64,210,274,78,38,57,62,186,602
2022,Grayson Allen,SG,26,MIL,66,61,1805,255,569,0.448,159,389,0.409,96,180,0.588,64,74,0.865,32,190,222,100,46,18,43,96,733
2022,Greg Brown III,SF,20,POR,48,6,640,81,190,0.426,19,61,0.311,62,129,0.476,44,65,0.677,38,97,135,35,26,24,36,90,225
2022,Greg Monroe,C,31,TOT,14,0,195,32,57,0.561,0,0,,32,57,0.561,12,23,0.522,30,34,64,22,8,10,12,24,76
2022,Hamidou Diallo,SG,23,DET,58,29,1269,261,526,0.496,23,93,0.247,238,433,0.518,91,140,0.65,69,208,277,73,71,17,58,143,636
2022,Harrison Barnes,PF,29,SAC,77,77,2587,391,834,0.469,142,360,0.394,249,474,0.554,341,413,0.826,82,350,432,186,53,14,118,94,1265
2022,Hassan Whiteside,C,32,UTA,65,8,1162,215,330,0.652,0,0,,215,330,0.652,104,167,0.623,166,328,494,26,22,103,53,179,534
2022,Hassani Gravett,PG,25,ORL,8,3,171,18,38,0.474,11,26,0.423,7,12,0.618,3,4,0.75,1,20,21,20,5,1,9,13,50
2022,Haywood Highsmith,SF,25,MIA,19,1,163,16,46,0.348,9,28,0.321,7,18,0.446,2,5,0.4,10,16,26,6,2,3,3,13,43
2022,Herbert Jones,PF,23,NOP,78,69,2335,274,576,0.476,57,169,0.337,217,407,0.525,137,163,0.84,98,198,296,167,130,60,100,238,742
2022,Ignas Brazdeikis,SF,23,ORL,42,1,536,81,188,0.431,27,87,0.31,54,101,0.503,21,32,0.656,23,49,72,37,10,3,17,48,210
2022,Immanuel Quickley,PG,22,NYK,78,3,1802,284,724,0.392,137,396,0.346,147,328,0.487,177,201,0.881,31,216,247,275,54,3,99,167,882
2022,Isaac Bonga,SF,22,TOR,15,0,69,3,13,0.231,1,4,0.25,2,9,0.269,5,8,0.625,4,3,7,4,8,2,2,10,12
2022,Isaac Okoro,SF,21,CLE,67,61,1981,207,431,0.48,55,157,0.35,152,274,0.544,119,155,0.768,72,129,201,121,56,22,58,164,588
2022,Isaiah Hartenstein,C,23,LAC,68,0,1216,229,366,0.626,14,30,0.467,215,336,0.645,91,132,0.689,117,215,332,160,50,77,84,167,563
2022,Isaiah Jackson,C,20,IND,36,15,541,116,206,0.563,5,16,0.313,111,190,0.575,60,88,0.682,60,89,149,10,25,52,40,92,297
2022,Isaiah Joe,SG,22,PHI,55,1,609,62,177,0.35,45,135,0.333,17,42,0.477,29,31,0.935,6,50,56,35,14,3,19,47,198
2022,Isaiah Livers,SF,23,DET,19,5,383,41,90,0.456,27,64,0.422,14,26,0.606,12,14,0.857,15,42,57,21,13,7,15,37,121
2022,Isaiah Roby,PF,23,OKC,45,28,948,166,323,0.514,44,99,0.444,122,224,0.582,78,116,0.672,75,142,217,71,36,34,43,109,454
2022,Isaiah Stewart,C,20,DET,71,71,1816,250,490,0.51,15,46,0.326,235,444,0.526,74,103,0.718,226,391,617,82,22,78,85,211,589
2022,Isaiah Thomas,PG,32,TOT,22,1,333,67,167,0.401,28,83,0.337,39,84,0.485,22,26,0.846,4,25,29,34,7,5,15,34,184
2022,Isaiah Todd,PF,20,WAS,12,0,74,7,26,0.269,4,16,0.25,3,10,0.346,2,6,0.333,3,9,12,4,4,2,4,4,20
2022,Ish Smith,PG,33,TOT,65,1,1126,185,430,0.43,25,67,0.373,160,363,0.459,15,24,0.625,25,115,140,244,47,23,78,78,410
2022,Ish Wainright,PF,27,PHO,45,0,359,41,104,0.394,19,59,0.322,22,45,0.486,7,12,0.583,27,27,54,15,20,6,13,49,108
2022,Ivica Zubac,C,24,LAC,76,76,1852,310,495,0.626,0,0,,310,495,0.626,165,227,0.727,217,427,644,120,36,77,114,203,785
2022,Ja Morant,PG,22,MEM,57,57,1889,580,1177,0.493,88,256,0.344,492,921,0.53,316,415,0.761,77,248,325,384,66,22,196,86,1564
2022,Jabari Parker,PF,26,BOS,12,0,112,18,38,0.474,8,16,0.5,10,22,0.579,9,9,1,5,23,28,6,4,1,8,13,53
2022,Jaden McDaniels,PF,21,MIN,70,31,1803,255,554,0.46,80,252,0.317,175,302,0.532,57,71,0.803,76,217,293,79,52,54,75,224,647
2022,Jaden Springer,SG,19,PHI,2,0,6,1,1,1,0,0,,1,1,1,0,0,,1,1,2,0,0,2,1,0,2
2022,Jae Crowder,PF,31,PHO,67,67,1886,217,544,0.399,127,365,0.348,90,179,0.516,71,90,0.789,30,324,354,124,95,30,55,173,632
2022,Jae'Sean Tate,PF,26,HOU,78,77,2056,363,729,0.498,63,202,0.312,300,527,0.541,130,184,0.707,135,285,420,222,72,41,139,286,919
2022,Jahmi'us Ramsey,SG,20,SAC,19,0,134,24,58,0.414,5,18,0.278,19,40,0.457,7,14,0.5,4,9,13,7,1,1,5,10,60
2022,Jaime Echenique,C,24,WAS,1,0,3,0,0,,0,0,,0,0,,0,0,,0,0,0,0,0,0,0,0,0
2022,Jake Layman,SF,27,MIN,34,1,231,30,73,0.411,8,35,0.229,22,38,0.466,13,18,0.722,6,30,36,9,7,5,10,12,81
2022,Jakob Poeltl,C,26,SAS,68,67,1970,410,663,0.618,1,1,1,409,662,0.619,94,190,0.495,262,372,634,189,45,118,109,212,915
2022,Jalen Brunson,SG,25,DAL,79,61,2524,506,1008,0.502,94,252,0.373,412,756,0.549,179,213,0.84,43,266,309,377,66,3,124,151,1285
2022,Jalen Green,SG,19,HOU,67,67,2138,406,954,0.426,157,458,0.343,249,496,0.508,188,236,0.797,33,193,226,176,44,18,135,103,1157
2022,Jalen Johnson,PF,20,ATL,22,0,120,22,41,0.537,3,13,0.231,19,28,0.573,5,7,0.714,2,24,26,3,3,2,9,9,52
2022,Jalen McDaniels,SF,24,CHO,55,2,895,123,254,0.484,41,108,0.38,82,146,0.565,53,72,0.736,37,133,170,58,26,22,36,93,340
2022,Jalen Smith,PF,21,TOT,51,8,925,176,350,0.503,40,122,0.328,136,228,0.56,78,102,0.765,101,206,307,24,15,41,42,96,470
2022,Jalen Suggs,PG,20,ORL,48,45,1307,198,548,0.361,42,196,0.214,156,352,0.4,126,163,0.773,26,145,171,209,59,19,143,142,564
2022,James Bouknight,SG,21,CHO,31,0,304,49,141,0.348,17,49,0.347,32,92,0.408,27,31,0.871,22,30,52,26,7,1,15,29,142
2022,James Ennis III,SF,31,TOT,7,0,56,11,24,0.458,3,8,0.375,8,16,0.521,4,5,0.8,5,7,12,3,2,2,2,5,29
2022,James Harden,PG,32,TOT,65,65,2419,407,992,0.41,148,448,0.33,259,544,0.485,470,536,0.877,55,445,500,667,82,36,284,153,1432
2022,James Johnson,PF,34,BRK,62,10,1191,144,307,0.469,23,85,0.271,121,222,0.507,29,55,0.527,51,164,215,130,30,34,48,162,340
2022,Jamorko Pickett,PF,24,DET,13,0,176,18,50,0.36,13,39,0.333,5,11,0.49,1,2,0.5,6,26,32,7,0,7,5,12,50
2022,JaMychal Green,PF,31,DEN,67,8,1085,159,327,0.486,33,124,0.266,126,203,0.537,81,93,0.871,81,200,281,59,43,26,57,158,432
2022,JaQuori McLaughlin,PG,24,DAL,4,0,11,0,2,0,0,1,0,0,1,0,0,0,,0,0,0,2,0,0,0,1,0
2022,Jared Butler,SG,21,UTA,42,1,360,61,151,0.404,28,88,0.318,33,63,0.497,11,16,0.688,5,40,45,63,17,8,33,47,161
2022,Jared Harper,PG,24,NOP,5,0,43,14,26,0.538,5,12,0.417,9,14,0.635,4,4,1,2,0,2,14,4,1,2,5,37
2022,Jaren Jackson Jr.,PF,22,MEM,78,78,2126,430,1036,0.415,128,401,0.319,302,635,0.477,284,345,0.823,119,335,454,86,73,177,130,272,1272
2022,Jarred Vanderbilt,PF,22,MIN,74,67,1880,212,361,0.587,2,14,0.143,210,347,0.59,86,131,0.656,215,409,624,94,99,46,73,181,512
2022,Jarrett Allen,C,23,CLE,56,56,1809,369,545,0.677,1,10,0.1,368,535,0.678,165,233,0.708,192,410,602,92,44,75,94,97,904
2022,Jarrett Culver,SG,22,MEM,37,0,338,51,135,0.378,12,47,0.255,39,88,0.422,16,34,0.471,13,35,48,33,20,5,20,42,130
2022,Jarron Cumberland,SG,24,POR,3,0,12,1,2,0.5,0,1,0,1,1,0.5,0,0,,1,2,3,1,0,0,0,2,2
2022,JaVale McGee,C,34,PHO,74,17,1172,288,458,0.629,2,9,0.222,286,449,0.631,102,146,0.699,163,333,496,42,22,81,98,181,680
2022,Javin DeLaurier,C,23,MIL,1,0,3,0,0,,0,0,,0,0,,0,0,,0,1,1,0,1,0,0,1,0
2022,Javonte Green,SF,28,CHI,65,45,1519,176,325,0.542,36,101,0.356,140,224,0.597,80,96,0.833,91,185,276,60,67,32,30,132,468
2022,Javonte Smart,PG,22,TOT,17,1,200,19,60,0.317,8,27,0.296,11,33,0.383,5,6,0.833,5,19,24,16,6,3,11,12,51
2022,Jaxson Hayes,C,21,NOP,70,28,1398,245,398,0.616,20,57,0.351,225,341,0.641,144,188,0.766,115,200,315,43,33,55,54,155,654
2022,Jay Huff,C,23,LAL,4,0,20,0,3,0,0,2,0,0,1,0,0,0,,1,3,4,1,1,1,1,1,0
2022,Jay Scrubb,SG,21,LAC,18,0,121,18,46,0.391,6,21,0.286,12,25,0.457,7,10,0.7,2,14,16,8,4,3,7,9,49
2022,Jaylen Brown,SF,25,BOS,66,66,2220,576,1217,0.473,166,464,0.358,410,753,0.541,241,318,0.758,53,351,404,231,70,18,178,163,1559
2022,Jaylen Hoard,SF,22,OKC,7,5,240,44,90,0.489,9,25,0.36,35,65,0.539,6,14,0.429,30,54,84,17,6,5,8,14,103
2022,Jaylen Morris,SG,26,SAS,3,0,16,0,6,0,0,2,0,0,4,0,2,4,0.5,0,2,2,2,0,0,1,2,2
2022,Jaylen Nowell,SG,22,MIN,62,1,975,196,413,0.475,63,160,0.394,133,253,0.551,72,92,0.783,22,101,123,130,27,10,36,73,527
2022,Jaysean Paige,PG,27,DET,1,0,7,0,3,0,0,2,0,0,1,0,0,0,,0,1,1,1,0,0,1,2,0
2022,Jayson Tatum,SF,23,BOS,76,76,2731,708,1564,0.453,230,651,0.353,478,913,0.526,400,469,0.853,85,524,609,334,75,49,217,174,2046
2022,Jeff Dowtin,PG,24,TOT,9,0,108,8,26,0.308,1,9,0.111,7,17,0.327,2,2,1,8,10,18,10,5,1,5,5,19
2022,Jeff Green,PF,35,DEN,75,63,1849,277,529,0.524,53,168,0.315,224,361,0.574,165,198,0.833,41,190,231,96,28,27,71,151,772
2022,Jemerrio Jones,SF,26,LAL,2,0,15,2,3,0.667,0,0,,2,3,0.667,0,0,,2,1,3,0,1,0,0,2,4
2022,Jerami Grant,PF,27,DET,47,47,1500,298,699,0.426,91,254,0.358,207,445,0.491,217,259,0.838,28,163,191,111,44,49,85,107,904
2022,Jeremiah Robinson-Earl,C,21,OKC,49,36,1087,134,324,0.414,58,165,0.352,76,159,0.503,40,54,0.741,75,199,274,49,29,15,39,75,366
2022,Jeremy Lamb,SF-SG,29,TOT,56,0,935,133,347,0.383,55,170,0.324,78,177,0.463,89,106,0.84,26,128,154,81,31,22,37,59,410
2022,Jericho Sims,PF,23,NYK,41,5,555,39,54,0.722,0,0,,39,54,0.722,12,29,0.414,61,108,169,21,11,22,20,66,90
2022,Jevon Carter,PG,26,TOT,66,3,905,98,253,0.387,66,170,0.388,32,83,0.518,15,18,0.833,14,96,110,96,24,14,34,67,277
2022,Jimmy Butler,SF,32,MIA,57,57,1931,398,829,0.48,27,116,0.233,371,713,0.496,396,455,0.87,102,234,336,312,94,27,121,88,1219
2022,Jock Landale,C,26,SAS,54,1,589,101,204,0.495,29,89,0.326,72,115,0.566,34,41,0.829,63,75,138,45,10,14,31,53,265
2022,Joe Harris,SF,30,BRK,14,14,423,56,124,0.452,41,88,0.466,15,36,0.617,5,6,0.833,5,51,56,14,7,2,16,31,158
2022,Joe Ingles,SF,34,UTA,45,15,1122,115,285,0.404,78,225,0.347,37,60,0.54,17,22,0.773,12,119,131,158,23,5,46,82,325
2022,Joe Johnson,SG,40,BOS,1,0,2,1,1,1,0,0,,1,1,1,0,0,,0,0,0,0,0,0,0,0,2
2022,Joe Wieskamp,SG,22,SAS,29,0,205,20,56,0.357,14,43,0.326,6,13,0.482,7,13,0.538,4,10,14,9,4,3,2,14,61
2022,Joel Ayayi,SG,21,WAS,7,0,20,1,6,0.167,0,1,0,1,5,0.167,0,0,,1,2,3,4,0,0,0,0,2
2022,Joel Embiid,C,27,PHI,68,68,2297,666,1334,0.499,93,251,0.371,573,1083,0.534,654,803,0.814,146,650,796,284,77,99,214,181,2079
2022,John Collins,PF,24,ATL,54,53,1663,339,644,0.526,64,176,0.364,275,468,0.576,134,169,0.793,93,329,422,98,33,56,60,164,876
2022,John Konchar,SG,25,MEM,72,7,1292,135,262,0.515,52,126,0.413,83,136,0.615,27,49,0.551,87,242,329,109,45,22,29,90,349
2022,Jon Teske,C,24,MEM,3,0,8,0,1,0,0,0,,0,1,0,0,2,0,0,2,2,1,1,0,0,1,0
2022,Jonas Valančiūnas,C,29,NOP,74,74,2240,510,938,0.544,57,158,0.361,453,780,0.574,237,289,0.82,226,617,843,190,41,60,179,247,1314
2022,Jonathan Kuminga,SF,19,GSW,70,12,1185,236,460,0.513,50,149,0.336,186,311,0.567,130,190,0.684,54,180,234,64,31,22,74,146,652
2022,Jordan Bell,C,27,CHI,1,0,2,0,0,,0,0,,0,0,,0,0,,1,0,1,0,1,0,0,2,0
2022,Jordan Clarkson,SG,29,UTA,79,1,2141,466,1113,0.419,190,597,0.318,276,516,0.504,144,174,0.828,67,206,273,194,66,16,129,149,1266
2022,Jordan Goodwin,SG,23,WAS,2,0,6,0,3,0,0,1,0,0,2,0,0,0,,0,1,1,0,0,0,0,1,0
2022,Jordan McLaughlin,PG,25,MIN,62,3,902,88,200,0.44,27,85,0.318,61,115,0.508,30,40,0.75,22,72,94,180,57,10,38,54,233
2022,Jordan Nwora,SF,23,MIL,62,13,1185,186,462,0.403,79,227,0.348,107,235,0.488,36,43,0.837,37,184,221,59,25,17,57,78,487
2022,Jordan Poole,SG,22,GSW,76,51,2283,474,1058,0.448,211,580,0.364,263,478,0.548,246,266,0.925,34,226,260,304,60,23,187,206,1405
2022,Jordan Schakel,SG,23,WAS,4,0,30,1,11,0.091,1,6,0.167,0,5,0.136,2,2,1,2,6,8,0,1,0,1,0,5
2022,Jose Alvarado,PG,23,NOP,54,1,834,131,294,0.446,32,110,0.291,99,184,0.5,36,53,0.679,25,75,100,152,71,7,40,73,330
2022,Josh Christopher,SG,20,HOU,74,2,1334,224,500,0.448,56,189,0.296,168,311,0.504,83,113,0.735,52,134,186,150,65,13,114,97,587
2022,Josh Giddey,SF,19,OKC,54,54,1700,281,670,0.419,56,213,0.263,225,457,0.461,56,79,0.709,98,323,421,345,51,20,171,88,674
2022,Josh Green,SG,21,DAL,67,3,1039,130,256,0.508,28,78,0.359,102,178,0.563,31,45,0.689,52,109,161,79,45,14,44,115,319
2022,Josh Hart,SG,26,TOT,54,53,1791,287,569,0.504,73,213,0.343,214,356,0.569,160,211,0.758,62,326,388,224,61,13,114,150,807
2022,Josh Jackson,SF,24,TOT,51,3,830,120,300,0.4,33,130,0.254,87,170,0.455,55,77,0.714,21,120,141,54,26,22,47,88,328
2022,Josh Okogie,SG,23,MIN,49,6,516,42,104,0.404,14,47,0.298,28,57,0.471,35,51,0.686,29,41,70,25,26,12,23,53,133
2022,Josh Richardson,SG,28,TOT,65,7,1600,234,534,0.438,102,246,0.415,132,288,0.534,96,108,0.889,42,143,185,115,56,29,66,116,666
2022,Joshua Primo,SF,19,SAS,50,16,965,101,270,0.374,42,137,0.307,59,133,0.452,44,59,0.746,32,81,113,81,20,23,57,79,288
2022,Jrue Holiday,PG,31,MIL,67,64,2207,478,954,0.501,132,321,0.411,346,633,0.57,137,180,0.761,69,232,301,457,108,29,183,133,1225
2022,JT Thor,PF,19,CHO,33,0,262,24,55,0.436,7,27,0.259,17,28,0.5,12,20,0.6,11,32,43,19,8,11,10,26,67
2022,Juan Toscano-Anderson,SF,28,GSW,73,6,994,115,235,0.489,28,87,0.322,87,148,0.549,40,70,0.571,28,148,176,127,48,17,68,115,298
2022,Juancho Hernangómez,PF,26,TOT,40,9,445,44,106,0.415,24,69,0.348,20,37,0.528,19,34,0.559,28,72,100,20,14,10,16,25,131
2022,Julius Randle,PF,27,NYK,72,72,2544,512,1246,0.411,120,390,0.308,392,856,0.459,303,401,0.756,125,591,716,370,53,39,245,205,1447
2022,Justin Anderson,SF,28,TOT,16,6,316,36,95,0.379,15,59,0.254,21,36,0.458,15,19,0.789,4,42,46,33,8,6,8,22,102
2022,Justin Champagnie,SF,20,TOR,36,0,281,31,67,0.463,10,28,0.357,21,39,0.537,9,9,1,37,35,72,11,8,4,8,32,81
2022,Justin Holiday,SF-SG,32,TOT,74,65,2057,261,662,0.394,177,482,0.367,84,180,0.528,50,62,0.806,29,161,190,128,57,33,70,154,749
2022,Justin Jackson,SF,26,TOT,7,0,37,5,15,0.333,3,9,0.333,2,6,0.433,2,2,1,1,6,7,2,0,0,1,3,15
2022,Justin Robinson,PG,24,TOT,25,0,304,28,93,0.301,18,61,0.295,10,32,0.398,4,8,0.5,4,17,21,32,9,1,17,27,78
2022,Justise Winslow,PF,25,TOT,48,11,774,110,257,0.428,15,66,0.227,95,191,0.457,39,66,0.591,50,152,202,84,35,25,49,67,274
2022,Jusuf Nurkić,C,27,POR,56,56,1579,321,600,0.535,15,56,0.268,306,544,0.548,185,268,0.69,167,452,619,157,62,34,143,189,842
2022,Juwan Morgan,PF,24,TOT,2,0,31,2,3,0.667,1,2,0.5,1,1,0.833,0,0,,2,2,4,1,0,0,0,3,5
2022,Kai Jones,C,21,CHO,21,0,63,9,14,0.643,1,2,0.5,8,12,0.679,3,8,0.375,3,8,11,4,1,2,6,8,22
2022,Karl-Anthony Towns,C,26,MIN,74,74,2476,642,1214,0.529,150,366,0.41,492,848,0.591,384,467,0.822,194,533,727,269,72,83,226,267,1818
2022,Keifer Sykes,PG,28,IND,32,11,566,69,190,0.363,27,90,0.3,42,100,0.434,15,17,0.882,8,37,45,62,12,4,33,51,180
2022,Keita Bates-Diop,SF,26,SAS,59,14,956,136,263,0.517,17,55,0.309,119,208,0.549,46,61,0.754,62,169,231,41,27,14,45,61,335
2022,Kelan Martin,SF,26,TOT,30,1,450,70,171,0.409,22,75,0.293,48,96,0.474,9,13,0.692,17,38,55,21,13,9,14,36,171
2022,Keldon Johnson,SF,22,SAS,75,74,2392,471,1011,0.466,159,399,0.398,312,612,0.545,177,234,0.756,80,377,457,158,58,14,92,148,1278
2022,Keljin Blevins,SF,26,POR,31,1,349,34,111,0.306,21,72,0.292,13,39,0.401,6,11,0.545,16,29,45,19,13,1,17,29,95
2022,Kelly Olynyk,C,30,DET,40,1,764,128,286,0.448,40,119,0.336,88,167,0.517,69,89,0.775,54,123,177,111,31,19,58,100,365
2022,Kelly Oubre Jr.,SF,26,CHO,76,13,1999,410,932,0.44,191,553,0.345,219,379,0.542,126,189,0.667,79,223,302,84,77,31,67,189,1137
2022,Kemba Walker,PG,31,NYK,37,37,948,149,370,0.403,73,199,0.367,76,171,0.501,60,71,0.845,14,97,111,131,26,7,48,37,431
2022,Kenrich Williams,SF,27,OKC,49,0,1072,146,317,0.461,41,121,0.339,105,196,0.525,30,55,0.545,75,145,220,108,44,10,46,81,363
2022,Kent Bazemore,SF,32,LAL,39,14,545,45,139,0.324,29,80,0.363,16,59,0.428,13,17,0.765,13,56,69,34,25,9,21,70,132
2022,Kentavious Caldwell-Pope,SG,28,WAS,77,77,2329,361,829,0.435,159,408,0.39,202,421,0.531,137,154,0.89,41,220,261,145,83,26,97,139,1018
2022,Kenyon Martin Jr.,SF,21,HOU,79,2,1656,279,523,0.533,60,168,0.357,219,355,0.591,78,123,0.634,80,217,297,101,34,40,60,113,696
2022,Keon Johnson,SG,19,TOT,37,12,697,96,272,0.353,34,100,0.34,62,172,0.415,41,51,0.804,24,57,81,76,28,12,46,69,267
2022,Kessler Edwards,SF,21,BRK,48,23,987,110,267,0.412,48,136,0.353,62,131,0.502,16,19,0.842,44,128,172,31,29,24,42,85,284
2022,Kevin Durant,PF,33,BRK,55,55,2047,578,1115,0.518,115,300,0.383,463,815,0.57,372,409,0.91,29,378,407,351,48,52,191,113,1643
2022,Kevin Huerter,SF,23,ATL,74,60,2188,345,760,0.454,160,411,0.389,185,349,0.559,42,52,0.808,32,222,254,203,55,26,91,185,892
2022,Kevin Knox,SF,22,TOT,30,0,222,31,85,0.365,15,54,0.278,16,31,0.453,16,22,0.727,14,30,44,10,4,2,7,19,93
2022,Kevin Love,C,33,CLE,74,4,1665,327,761,0.43,187,477,0.392,140,284,0.553,166,198,0.838,87,449,536,160,26,18,98,101,1007
2022,Kevin Pangos,PG,29,CLE,24,3,166,15,46,0.326,6,26,0.231,9,20,0.391,3,4,0.75,2,9,11,30,3,0,7,11,39
2022,Kevin Porter Jr.,PG,21,HOU,61,61,1907,335,808,0.415,155,413,0.375,180,395,0.511,124,193,0.642,43,224,267,376,69,22,192,156,949
2022,Kevon Looney,C,25,GSW,82,80,1732,208,364,0.571,0,1,0,208,363,0.571,75,125,0.6,208,388,596,165,50,52,67,215,491
2022,Khem Birch,C,29,TOR,55,28,991,97,200,0.485,0,14,0,97,186,0.485,53,71,0.746,122,117,239,56,30,26,29,104,247
2022,Khris Middleton,SF,30,MIL,66,66,2141,452,1021,0.443,162,434,0.373,290,587,0.522,259,291,0.89,41,315,356,358,76,18,190,160,1325
2022,Killian Hayes,PG,20,DET,66,40,1647,176,459,0.383,44,167,0.263,132,292,0.431,57,74,0.77,36,174,210,277,78,35,111,183,453
2022,Killian Tillie,C,23,MEM,36,3,461,43,127,0.339,27,86,0.314,16,41,0.445,5,8,0.625,21,39,60,22,23,15,13,58,118
2022,Kira Lewis Jr.,PG,20,NOP,24,0,341,59,146,0.404,13,58,0.224,46,88,0.449,10,12,0.833,9,30,39,49,11,1,26,17,141
2022,Klay Thompson,SG,31,GSW,32,32,941,246,573,0.429,114,296,0.385,132,277,0.529,46,51,0.902,15,110,125,88,16,17,43,54,652
2022,Kris Dunn,PG,27,POR,14,3,336,44,102,0.431,1,11,0.091,43,91,0.436,17,18,0.944,9,40,49,79,23,3,32,38,106
2022,Kristaps Porziņģis,PF,26,TOT,51,51,1481,352,767,0.459,78,252,0.31,274,515,0.51,248,286,0.867,102,309,411,119,37,84,81,137,1030
2022,Kyle Anderson,PF,28,MEM,69,11,1484,209,469,0.446,36,109,0.33,173,360,0.484,67,105,0.638,69,299,368,183,77,45,71,108,521
2022,Kyle Guy,SG,24,MIA,19,0,186,26,65,0.4,14,40,0.35,12,25,0.508,8,12,0.667,4,13,17,17,7,1,13,12,74
2022,Kyle Kuzma,PF,26,WAS,66,66,2204,423,936,0.452,128,375,0.341,295,561,0.52,156,219,0.712,70,491,561,233,42,57,169,128,1130
2022,Kyle Lowry,PG,35,MIA,63,63,2133,276,627,0.44,144,382,0.377,132,245,0.555,148,174,0.851,33,249,282,474,67,17,168,177,844
2022,Kyrie Irving,PG,29,BRK,29,29,1091,289,616,0.469,100,239,0.418,189,377,0.55,118,129,0.915,16,111,127,167,41,17,73,81,796
2022,KZ Okpala,PF,22,MIA,21,0,244,30,69,0.435,9,26,0.346,21,43,0.5,8,11,0.727,11,30,41,14,4,7,5,25,77
2022,Lamar Stevens,PF,24,CLE,63,13,1015,156,319,0.489,18,65,0.277,138,254,0.517,53,75,0.707,47,117,164,44,31,18,41,106,383
2022,LaMarcus Aldridge,C,36,BRK,47,12,1050,252,458,0.55,14,46,0.304,238,412,0.566,89,102,0.873,73,185,258,42,14,47,44,78,607
2022,LaMelo Ball,PG,20,CHO,75,75,2422,538,1254,0.429,220,565,0.389,318,689,0.517,212,243,0.872,108,393,501,571,119,30,245,237,1508
2022,Lance Stephenson,PG-SG,31,TOT,46,1,814,147,323,0.455,27,90,0.3,120,233,0.497,63,80,0.788,12,115,127,165,24,4,72,96,384
2022,Landry Shamet,SG,24,PHO,69,14,1437,191,485,0.394,123,334,0.368,68,151,0.521,68,81,0.84,16,110,126,108,28,9,41,92,573
2022,Langston Galloway,SG,30,TOT,7,0,107,6,26,0.231,2,16,0.125,4,10,0.269,0,0,,3,15,18,12,1,0,6,7,14
2022,Larry Nance Jr.,C-PF,29,TOT,46,11,1040,129,247,0.522,23,70,0.329,106,177,0.569,40,57,0.702,72,176,248,81,43,20,37,84,321
2022,Lauri Markkanen,SF,24,CLE,61,61,1878,313,703,0.445,136,380,0.358,177,323,0.542,138,159,0.868,59,286,345,81,45,30,54,130,900
2022,Leandro Bolmaro,SF,21,MIN,35,2,241,17,54,0.315,5,18,0.278,12,36,0.361,11,13,0.846,16,27,43,21,6,0,13,26,50
2022,LeBron James,C,37,LAL,56,56,2084,640,1221,0.524,161,448,0.359,479,773,0.59,254,336,0.756,63,396,459,349,73,59,196,121,1695
2022,Lindell Wigginton,PG,23,MIL,19,0,199,26,61,0.426,9,26,0.346,17,35,0.5,19,35,0.543,3,22,25,23,5,1,12,17,80
2022,Lindy Waters III,SG,24,OKC,25,1,465,71,175,0.406,53,146,0.363,18,29,0.557,4,5,0.8,6,67,73,24,19,8,11,31,199
2022,Lonnie Walker IV,SG,23,SAS,70,6,1612,311,764,0.407,111,353,0.314,200,411,0.48,116,148,0.784,18,163,181,152,44,19,71,98,849
2022,Lonzo Ball,PG,24,CHI,35,35,1212,162,383,0.423,110,260,0.423,52,123,0.567,21,28,0.75,35,155,190,178,64,31,82,85,455
2022,Lou Williams,PG,35,ATL,56,0,799,125,320,0.391,37,102,0.363,88,218,0.448,67,78,0.859,16,71,87,105,28,3,43,48,354
2022,Louis King,SF,22,SAC,10,0,104,15,47,0.319,8,27,0.296,7,20,0.404,7,10,0.7,0,12,12,9,2,1,0,14,45
2022,Luguentz Dort,SG,22,OKC,51,51,1665,293,726,0.404,130,391,0.332,163,335,0.493,161,191,0.843,38,174,212,88,46,18,88,149,877
2022,Luka Dončić,PG,22,DAL,65,65,2301,641,1403,0.457,201,569,0.353,440,834,0.529,364,489,0.744,56,537,593,568,75,36,292,145,1847
2022,Luka Garza,C,23,DET,32,5,389,66,147,0.449,16,49,0.327,50,98,0.503,38,61,0.623,58,42,100,20,9,6,18,55,186
2022,Luke Kennard,SG,25,LAC,70,13,1919,287,639,0.449,190,423,0.449,97,216,0.598,69,77,0.896,20,209,229,146,42,6,60,101,833
2022,Luke Kornet,C,26,TOT,15,0,103,13,27,0.481,0,5,0,13,22,0.481,4,6,0.667,13,16,29,9,3,3,0,9,30
2022,M.J. Walker,SG,23,PHO,2,0,8,0,4,0,0,2,0,0,2,0,0,0,,0,1,1,1,2,0,0,1,0
2022,Mac McClung,SG-PG,23,TOT,2,0,25,3,6,0.5,1,3,0.333,2,3,0.583,1,1,1,0,3,3,1,1,1,3,5,8
2022,Malachi Flynn,PG,23,TOR,44,5,537,72,183,0.393,30,90,0.333,42,93,0.475,15,24,0.625,10,53,63,70,20,4,13,45,189
2022,Malcolm Brogdon,PG,29,IND,36,36,1206,243,543,0.448,58,186,0.312,185,357,0.501,143,167,0.856,33,152,185,212,30,14,77,71,687
2022,Malcolm Hill,SF-SG,26,TOT,19,0,212,24,52,0.462,13,36,0.361,11,16,0.587,11,14,0.786,11,24,35,8,7,3,3,24,72
2022,Malik Beasley,SG,25,MIN,79,18,1976,332,850,0.391,240,637,0.377,92,213,0.532,49,60,0.817,26,201,227,116,43,12,43,88,953
2022,Malik Fitts,PF,24,TOT,15,0,63,8,19,0.421,5,10,0.5,3,9,0.553,0,0,,2,15,17,5,0,0,2,4,21
2022,Malik Monk,SG,23,LAL,76,37,2139,391,826,0.473,173,442,0.391,218,384,0.578,93,117,0.795,37,219,256,218,61,29,122,138,1048
2022,Malik Newman,PG,24,CLE,1,0,8,3,5,0.6,0,1,0,3,4,0.6,2,2,1,0,1,1,1,0,0,1,0,8
2022,Mamadi Diakite,PF,25,OKC,13,3,188,25,47,0.532,0,5,0,25,42,0.532,6,11,0.545,17,42,59,2,5,9,7,33,56
2022,Marcus Garrett,SG,23,MIA,12,0,128,5,21,0.238,1,4,0.25,4,17,0.262,2,5,0.4,9,14,23,7,5,3,2,16,13
2022,Marcus Morris,PF,32,LAC,54,54,1564,300,691,0.434,101,275,0.367,199,416,0.507,129,148,0.872,26,213,239,113,28,18,69,115,830
2022,Marcus Smart,PG,27,BOS,71,71,2296,300,718,0.418,119,360,0.331,181,358,0.501,142,179,0.793,42,228,270,417,119,18,159,160,861
2022,Markelle Fultz,PG,23,ORL,18,3,360,83,175,0.474,4,17,0.235,79,158,0.486,25,31,0.806,4,45,49,99,20,5,40,22,195
2022,Markieff Morris,PF,32,MIA,17,1,298,54,114,0.474,13,39,0.333,41,75,0.531,8,9,0.889,17,28,45,23,6,1,20,33,129
2022,Marko Simonovic,C,22,CHI,9,0,35,4,15,0.267,1,5,0.2,3,10,0.3,8,11,0.727,5,5,10,0,1,1,2,6,17
2022,Markus Howard,SG,22,DEN,31,0,176,39,101,0.386,28,70,0.4,11,31,0.525,20,23,0.87,2,10,12,7,9,0,7,17,126
2022,Marquese Chriss,PF,24,DAL,34,0,346,62,134,0.463,8,25,0.32,54,109,0.493,22,33,0.667,33,70,103,17,13,12,17,64,154
2022,Marvin Bagley III,PF,22,TOT,48,25,1146,225,446,0.504,23,97,0.237,202,349,0.53,67,101,0.663,105,233,338,36,22,18,39,93,540
2022,Mason Jones,SG,23,LAL,4,0,51,7,15,0.467,1,4,0.25,6,11,0.5,12,15,0.8,1,9,10,4,2,0,1,8,27
2022,Mason Plumlee,C,31,CHO,73,73,1793,205,320,0.641,0,2,0,205,318,0.641,67,171,0.392,176,389,565,226,61,52,100,224,477
2022,Matisse Thybulle,SG,24,PHI,66,50,1685,150,300,0.5,45,144,0.313,105,156,0.575,34,43,0.791,42,109,151,75,115,71,39,158,379
2022,Matt Mooney,SG,24,NYK,1,0,2,0,1,0,0,1,0,0,0,0,0,0,,0,0,0,0,1,0,1,0,0
2022,Matt Ryan,SF,24,BOS,1,0,5,1,5,0.2,1,5,0.2,0,0,0.3,0,0,,0,0,0,0,1,0,0,0,3
2022,Matt Thomas,SG,27,CHI,40,0,459,55,134,0.41,35,91,0.385,20,43,0.541,16,20,0.8,3,47,50,20,8,3,8,18,161
2022,Maurice Harkless,SF,28,SAC,47,24,863,83,181,0.459,31,101,0.307,52,80,0.544,20,28,0.714,12,100,112,23,29,24,31,77,217
2022,Max Strus,SF,25,MIA,68,16,1587,249,564,0.441,181,442,0.41,68,122,0.602,42,53,0.792,24,178,202,92,28,16,57,116,721
2022,Maxi Kleber,PF,30,DAL,59,21,1450,141,354,0.398,83,255,0.325,58,99,0.516,46,65,0.708,70,280,350,68,30,58,47,137,411
2022,McKinley Wright IV,PG,23,MIN,5,0,19,2,3,0.667,1,2,0.5,1,1,0.833,0,0,,0,0,0,3,0,0,1,1,5
2022,Melvin Frazier,SG,25,OKC,3,0,120,13,48,0.271,1,21,0.048,12,27,0.281,5,7,0.714,5,8,13,1,1,0,3,8,32
2022,Micah Potter,C,23,DET,3,0,31,5,11,0.455,0,2,0,5,9,0.455,2,2,1,4,5,9,0,1,1,1,4,12
2022,Michael Porter Jr.,SF,23,DEN,9,9,265,37,103,0.359,10,48,0.208,27,55,0.408,5,9,0.556,9,50,59,17,10,2,12,16,89
2022,Mikal Bridges,SF,25,PHO,82,82,2854,458,858,0.534,115,312,0.369,343,546,0.601,131,157,0.834,74,273,347,185,96,36,68,150,1162
2022,Mike Conley,PG,34,UTA,72,72,2058,344,791,0.435,169,414,0.408,175,377,0.542,129,162,0.796,47,170,217,385,96,21,123,142,986
2022,Mike Muscala,C,30,OKC,43,0,592,113,248,0.456,70,163,0.429,43,85,0.597,48,57,0.842,21,108,129,22,18,26,14,58,344
2022,Miles Bridges,PF,23,CHO,80,80,2837,596,1214,0.491,154,465,0.331,442,749,0.554,267,333,0.802,90,469,559,300,74,67,150,193,1613
2022,Miles McBride,PG,21,NYK,40,2,372,32,108,0.296,17,68,0.25,15,40,0.375,8,12,0.667,4,38,42,41,14,1,5,45,89
2022,Mitchell Robinson,C,23,NYK,72,62,1848,261,343,0.761,0,0,,261,343,0.761,88,181,0.486,295,322,617,38,58,133,60,195,610
2022,Miye Oni,SG,24,UTA,16,0,44,2,9,0.222,1,8,0.125,1,1,0.278,0,1,0,1,6,7,5,0,0,1,7,5
2022,Mo Bamba,C,23,ORL,71,69,1824,296,617,0.48,107,281,0.381,189,336,0.566,57,73,0.781,148,424,572,85,38,118,77,182,756
2022,Monte Morris,PG,26,DEN,75,74,2239,374,773,0.484,124,314,0.395,250,459,0.564,73,84,0.869,27,199,226,333,56,14,78,92,945
2022,Montrezl Harrell,C,28,TOT,71,3,1641,358,555,0.645,4,17,0.235,354,538,0.649,212,296,0.716,149,282,431,145,29,43,72,137,932
2022,Moritz Wagner,C,24,ORL,63,3,960,197,396,0.497,66,201,0.328,131,195,0.581,104,129,0.806,42,190,232,87,20,13,56,123,564
2022,Moses Brown,C,22,TOT,40,6,345,64,108,0.593,0,0,,64,108,0.593,43,72,0.597,39,96,135,1,7,16,20,53,171
2022,Moses Moody,SG,19,GSW,52,11,607,80,183,0.437,40,110,0.364,40,73,0.546,28,36,0.778,17,63,80,23,7,10,13,43,228
2022,Moses Wright,PF,23,TOT,4,0,14,1,4,0.25,0,1,0,1,3,0.25,3,3,1,1,2,3,2,0,1,0,0,5
2022,Mychal Mulder,PG,27,TOT,17,3,239,24,77,0.312,17,54,0.315,7,23,0.422,4,4,1,2,22,24,5,4,2,8,13,69
2022,Myles Powell,PG,24,PHI,11,0,52,5,17,0.294,1,6,0.167,4,11,0.324,2,2,1,1,5,6,3,1,0,3,8,13
2022,Myles Turner,C,25,IND,42,42,1235,200,393,0.509,61,183,0.333,139,210,0.587,79,105,0.752,65,232,297,44,28,118,54,119,540
2022,Naji Marshall,SF,24,NOP,55,4,735,109,269,0.405,21,105,0.2,88,164,0.444,74,93,0.796,38,104,142,62,33,8,46,69,313
2022,Nassir Little,SF,21,POR,42,23,1088,145,315,0.46,51,154,0.331,94,161,0.541,69,94,0.734,58,178,236,54,25,36,40,82,410
2022,Nate Hinton,SG,22,IND,2,0,2,0,1,0,0,0,,0,1,0,0,0,,0,0,0,0,0,0,1,0,0
2022,Nathan Knight,PF,24,MIN,37,2,267,45,88,0.511,4,13,0.308,41,75,0.534,44,60,0.733,32,53,85,22,7,8,18,42,138
2022,Naz Reid,C,22,MIN,77,6,1215,233,476,0.489,57,166,0.343,176,310,0.549,114,149,0.765,102,199,301,71,40,71,82,172,637
2022,Neemias Queta,C,22,SAC,15,0,120,17,38,0.447,0,0,,17,38,0.447,11,17,0.647,14,17,31,6,1,8,6,18,45
2022,Nemanja Bjelica,C,33,GSW,71,0,1142,160,342,0.468,54,149,0.362,106,193,0.547,59,81,0.728,62,232,294,159,41,26,87,128,433
2022,Nerlens Noel,C,27,NYK,25,11,562,32,60,0.533,0,3,0,32,57,0.533,21,30,0.7,48,93,141,23,30,31,20,67,85
2022,Nic Claxton,C,22,BRK,47,19,974,178,264,0.674,0,0,,178,264,0.674,54,93,0.581,91,173,264,43,24,51,38,110,410
2022,Nick Richards,C,24,CHO,50,5,367,60,90,0.667,0,0,,60,90,0.667,30,43,0.698,34,52,86,13,9,21,24,51,150
2022,Nickeil Alexander-Walker,SG,23,TOT,65,21,1466,253,680,0.372,105,338,0.311,148,342,0.449,81,109,0.743,37,150,187,156,46,23,93,103,692
2022,Nicolas Batum,PF,33,LAC,59,54,1462,179,387,0.463,108,270,0.4,71,117,0.602,25,38,0.658,29,225,254,100,58,42,40,80,491
2022,Nik Stauskas,SG,28,TOT,8,0,39,5,14,0.357,4,10,0.4,1,4,0.5,4,6,0.667,1,2,3,2,0,0,1,1,18
2022,Nikola Jokić,C,26,DEN,74,74,2476,764,1311,0.583,97,288,0.337,667,1023,0.62,379,468,0.81,206,813,1019,584,109,63,281,191,2004
2022,Nikola Vučević,C,31,CHI,73,73,2418,546,1154,0.473,104,331,0.314,442,823,0.518,92,121,0.76,142,662,804,236,70,71,136,181,1288
2022,Norman Powell,SF-SG,28,TOT,45,41,1458,279,605,0.461,106,253,0.419,173,352,0.549,189,233,0.811,20,125,145,96,42,21,69,106,853
2022,Norvel Pelle,C,28,UTA,3,0,19,3,5,0.6,0,0,,3,5,0.6,0,0,,3,3,6,0,0,1,2,1,6
2022,Obi Toppin,PF,23,NYK,72,10,1230,251,473,0.531,52,169,0.308,199,304,0.586,94,124,0.758,69,199,268,77,25,33,56,102,648
2022,OG Anunoby,SF,24,TOR,48,48,1728,309,697,0.443,115,317,0.363,194,380,0.526,89,118,0.754,74,190,264,125,71,25,80,131,822
2022,Olivier Sarr,C,22,OKC,22,2,421,58,101,0.574,13,29,0.448,45,72,0.639,24,29,0.828,34,59,93,19,6,15,22,52,153
2022,Omer Yurtseven,C,23,MIA,56,12,706,130,247,0.526,1,11,0.091,129,236,0.528,38,61,0.623,85,209,294,49,17,20,41,84,299
2022,Onyeka Okongwu,C,21,ATL,48,6,992,156,226,0.69,0,0,,156,226,0.69,80,110,0.727,115,168,283,53,31,60,44,149,392
2022,Oshae Brissett,SF,23,IND,67,25,1564,208,506,0.411,83,237,0.35,125,269,0.493,114,164,0.695,108,250,358,72,44,29,54,116,613
2022,Otto Porter Jr.,PF,28,GSW,63,15,1396,193,416,0.464,80,216,0.37,113,200,0.56,49,61,0.803,86,276,362,94,68,29,37,83,515
2022,P.J. Tucker,PF,36,MIA,71,70,1981,207,428,0.484,80,193,0.415,127,235,0.577,45,61,0.738,100,287,387,149,58,15,66,161,539
2022,P.J. Washington,C,23,CHO,65,28,1768,250,532,0.47,110,301,0.365,140,231,0.573,58,81,0.716,82,255,337,147,57,61,82,152,668
2022,Paris Bass,SF,26,PHO,2,0,7,2,6,0.333,0,2,0,2,4,0.333,2,2,1,2,2,4,0,1,0,2,2,6
2022,Pascal Siakam,PF,27,TOR,68,68,2578,596,1207,0.494,75,218,0.344,521,989,0.525,284,379,0.749,128,452,580,360,85,42,181,225,1551
2022,Pat Connaughton,SF,29,MIL,65,19,1691,227,496,0.458,146,370,0.395,81,126,0.605,45,54,0.833,45,228,273,82,59,15,35,86,645
2022,Patrick Beverley,PG,33,MIN,58,54,1476,177,436,0.406,83,242,0.343,94,194,0.501,96,133,0.722,62,178,240,268,67,52,73,174,533
2022,Patrick Williams,PF,20,CHI,17,9,422,54,102,0.529,15,29,0.517,39,73,0.603,30,41,0.732,17,52,69,15,9,9,16,28,153
2022,Patty Mills,SG,33,BRK,81,48,2346,324,794,0.408,227,568,0.4,97,226,0.551,48,59,0.814,18,138,156,183,51,17,73,112,923
2022,Paul George,PF,31,LAC,31,31,1077,268,636,0.421,91,257,0.354,177,379,0.493,127,148,0.858,12,201,213,176,67,13,126,74,754
2022,Paul Millsap,C,36,TOT,33,1,376,45,115,0.391,8,35,0.229,37,80,0.426,17,24,0.708,41,73,114,29,10,13,19,67,115
2022,Paul Reed,C,22,PHI,38,2,302,54,96,0.563,2,8,0.25,52,88,0.573,6,14,0.429,44,48,92,16,33,14,10,57,116
2022,Paul Watson,SF,27,OKC,9,3,156,12,35,0.343,6,26,0.231,6,9,0.429,1,2,0.5,3,24,27,8,3,3,4,10,31
2022,Payton Pritchard,PG,24,BOS,71,2,1001,160,373,0.429,101,245,0.412,59,128,0.564,21,21,1,32,102,134,139,25,6,41,61,442
2022,Petr Cornelie,PF,26,DEN,13,0,38,5,15,0.333,1,8,0.125,4,7,0.367,3,4,0.75,7,7,14,3,1,1,4,7,14
2022,PJ Dozier,SG,25,DEN,18,0,340,36,99,0.364,15,48,0.313,21,51,0.439,10,13,0.769,14,49,63,29,11,6,13,33,97
2022,Precious Achiuwa,C,22,TOR,73,28,1725,265,603,0.439,56,156,0.359,209,447,0.486,78,131,0.595,146,327,473,82,37,41,84,151,664
2022,Quentin Grimes,SG,21,NYK,46,6,786,95,235,0.404,72,189,0.381,23,46,0.557,13,19,0.684,24,70,94,44,31,11,28,72,275
2022,Quinndary Weatherspoon,SG,25,GSW,11,0,73,12,21,0.571,1,5,0.2,11,16,0.595,5,5,1,2,12,14,5,1,1,3,15,30
2022,R.J. Hampton,SG,20,ORL,64,14,1402,175,457,0.383,64,183,0.35,111,274,0.453,75,117,0.641,23,171,194,158,42,13,87,101,489
2022,Rajon Rondo,PG,35,TOT,39,1,697,68,176,0.386,31,88,0.352,37,88,0.474,19,26,0.731,15,93,108,170,30,6,68,56,186
2022,Raul Neto,PG,29,WAS,70,19,1372,204,441,0.463,35,120,0.292,169,321,0.502,83,108,0.769,13,121,134,217,55,3,79,104,526
2022,Rayjon Tucker,SG,24,TOT,5,0,71,6,9,0.667,4,5,0.8,2,4,0.889,5,7,0.714,3,5,8,10,4,0,1,5,21
2022,Reggie Bullock,SF,30,DAL,68,37,1902,201,501,0.401,141,392,0.36,60,109,0.542,40,48,0.833,33,208,241,83,41,14,40,111,583
2022,Reggie Jackson,SG,31,LAC,75,75,2337,479,1222,0.392,167,512,0.326,312,710,0.46,138,163,0.847,39,232,271,359,55,15,173,159,1263
2022,Reggie Perry,PF,21,TOT,10,1,187,40,79,0.506,3,16,0.188,37,63,0.525,9,15,0.6,15,32,47,12,9,6,11,33,92
2022,Richaun Holmes,C,28,SAC,45,37,1074,198,300,0.66,2,5,0.4,196,295,0.663,70,90,0.778,93,224,317,48,17,41,56,128,468
2022,Ricky Rubio,PG,31,CLE,34,8,970,149,411,0.363,59,174,0.339,90,237,0.434,88,103,0.854,15,126,141,225,49,7,90,75,445
2022,RJ Barrett,SF,21,NYK,70,70,2417,487,1194,0.408,138,404,0.342,349,790,0.466,290,406,0.714,66,342,408,208,43,16,151,142,1402
2022,RJ Nembhard Jr.,SG,22,CLE,14,0,63,6,18,0.333,0,2,0,6,16,0.333,3,4,0.75,3,4,7,12,1,0,3,2,15
2022,Rob Edwards,SG,25,OKC,2,0,11,1,4,0.25,1,4,0.25,0,0,0.375,0,0,,0,3,3,0,0,0,1,0,3
2022,Robert Covington,PF,31,TOT,71,42,1940,209,498,0.42,128,339,0.378,81,159,0.548,58,69,0.841,59,332,391,92,103,91,75,190,604
2022,Robert Williams,C,24,BOS,61,61,1804,271,368,0.736,0,1,0,271,367,0.736,65,90,0.722,238,350,588,121,56,134,63,137,607
2022,Robert Woodard II,SF,22,SAC,12,0,42,2,16,0.125,1,4,0.25,1,12,0.156,2,2,1,5,6,11,3,1,1,1,3,7
2022,Robin Lopez,C,33,ORL,36,9,612,110,199,0.553,2,6,0.333,108,193,0.558,32,54,0.593,68,58,126,54,2,18,44,67,254
2022,Rodney Hood,PF-SF,29,TOT,52,0,709,58,157,0.369,30,91,0.33,28,66,0.465,17,19,0.895,15,62,77,38,15,6,11,31,163
2022,Rodney McGruder,SG,30,DET,51,2,754,98,225,0.436,58,146,0.397,40,79,0.564,19,26,0.731,31,80,111,48,21,7,24,58,273
2022,Romeo Langford,SG,22,TOT,48,5,771,83,191,0.435,29,85,0.341,54,106,0.51,23,42,0.548,30,78,108,21,22,16,16,47,218
2022,Royce O'Neale,SF,28,UTA,77,77,2406,203,444,0.457,119,306,0.389,84,138,0.591,45,56,0.804,64,304,368,191,86,32,79,183,570
2022,Rudy Gay,PF,35,UTA,55,1,1038,157,379,0.414,70,203,0.345,87,176,0.507,62,79,0.785,55,187,242,56,25,19,47,95,446
2022,Rudy Gobert,C,29,UTA,66,66,2120,362,508,0.713,0,4,0,362,504,0.713,303,439,0.69,241,727,968,72,45,137,119,176,1027
2022,Rui Hachimura,PF,23,WAS,42,13,943,187,381,0.491,55,123,0.447,132,258,0.563,46,66,0.697,25,135,160,48,23,9,33,53,475
2022,Russell Westbrook,PG,33,LAL,78,78,2678,548,1233,0.444,79,265,0.298,469,968,0.476,266,399,0.667,110,470,580,550,75,20,295,235,1441
2022,Ryan Arcidiacono,PG,27,NYK,10,0,76,6,12,0.5,4,9,0.444,2,3,0.667,0,0,,0,8,8,4,1,0,3,5,16
2022,Saben Lee,PG,22,DET,37,0,604,69,177,0.39,14,60,0.233,55,117,0.429,56,71,0.789,18,69,87,107,36,12,36,44,208
2022,Saddiq Bey,SF,22,DET,82,82,2704,450,1136,0.396,211,610,0.346,239,526,0.489,210,254,0.827,107,334,441,233,73,16,96,128,1321
2022,Sam Dekker,PF,27,TOR,1,0,1,0,0,,0,0,,0,0,,0,0,,0,0,0,0,0,0,0,0,0
2022,Sam Hauser,SF,24,BOS,26,0,158,23,50,0.46,19,44,0.432,4,6,0.65,0,0,,5,24,29,10,1,2,2,7,65
2022,Sam Merrill,SG,25,MEM,6,0,58,8,24,0.333,7,23,0.304,1,1,0.479,2,4,0.5,1,6,7,4,0,0,2,3,25
2022,Sandro Mamukelashvili,PF,22,MIL,41,3,407,57,115,0.496,22,52,0.423,35,63,0.591,18,22,0.818,35,47,82,22,9,9,15,28,154
2022,Santi Aldama,PF,21,MEM,32,0,360,53,132,0.402,6,48,0.125,47,84,0.424,20,32,0.625,33,54,87,21,6,10,16,36,132
2022,Scottie Barnes,PF,20,TOR,74,74,2617,459,932,0.492,58,193,0.301,401,739,0.524,158,215,0.735,195,362,557,256,80,55,136,192,1134
2022,Scottie Lewis,SG,21,CHO,2,0,7,0,0,,0,0,,0,0,,1,2,0.5,0,0,0,1,1,0,0,0,1
2022,Scotty Hopson,SG,32,OKC,1,0,18,2,4,0.5,0,1,0,2,3,0.5,0,0,,0,1,1,1,0,0,2,1,4
2022,Sekou Doumbouya,PF,21,LAL,2,0,16,5,8,0.625,1,2,0.5,4,6,0.688,3,4,0.75,2,4,6,0,3,2,2,1,14
2022,Semi Ojeleye,PF,27,TOT,30,0,406,30,99,0.303,15,50,0.3,15,49,0.379,23,29,0.793,27,47,74,9,7,6,9,30,98
2022,Serge Ibaka,C,32,TOT,54,12,877,148,296,0.5,37,99,0.374,111,197,0.563,32,44,0.727,62,188,250,49,11,33,43,102,365
2022,Seth Curry,SG,31,TOT,64,64,2135,360,739,0.487,158,374,0.422,202,365,0.594,82,94,0.872,21,179,200,230,53,14,109,148,960
2022,Shai Gilgeous-Alexander,PG,23,OKC,56,56,1942,477,1052,0.453,89,297,0.3,388,755,0.496,328,405,0.81,37,241,278,331,71,46,154,142,1371
2022,Shake Milton,SG,25,PHI,55,6,1179,173,403,0.429,43,133,0.323,130,270,0.483,61,73,0.836,30,112,142,139,28,17,44,99,450
2022,Shaq Buchanan,SG,25,MEM,2,0,10,1,4,0.25,0,2,0,1,2,0.25,0,0,,1,1,2,2,1,0,2,1,2
2022,Shaquille Harrison,SG,28,BRK,2,0,23,2,6,0.333,0,2,0,2,4,0.333,0,0,,1,3,4,3,1,1,2,3,4
2022,Sharife Cooper,PG,20,ATL,13,0,39,3,14,0.214,1,6,0.167,2,8,0.25,0,0,,0,5,5,5,0,0,5,1,7
2022,Skylar Mays,SG,24,ATL,28,5,220,32,64,0.5,8,25,0.32,24,39,0.563,8,9,0.889,5,20,25,17,7,0,10,9,80
2022,Solomon Hill,SF,30,ATL,13,1,139,3,20,0.15,2,13,0.154,1,7,0.2,0,0,,6,17,23,12,4,2,1,16,8
2022,Spencer Dinwiddie,PG,28,TOT,67,51,1980,306,735,0.416,112,330,0.339,194,405,0.493,195,252,0.774,45,234,279,346,44,13,104,150,919
2022,Stanley Johnson,PF,25,LAL,48,27,1094,117,251,0.466,33,105,0.314,84,146,0.532,53,74,0.716,34,121,155,80,43,14,35,109,320
2022,Stephen Curry,PG,33,GSW,64,64,2211,535,1224,0.437,285,750,0.38,250,474,0.554,275,298,0.923,34,301,335,404,85,23,206,130,1630
2022,Sterling Brown,SG,26,DAL,49,3,628,59,155,0.381,28,92,0.304,31,63,0.471,14,15,0.933,26,123,149,34,14,7,23,56,160
2022,Steven Adams,C,28,MEM,76,75,1999,210,384,0.547,0,1,0,210,383,0.547,108,199,0.543,349,411,760,256,65,60,115,153,528
2022,Svi Mykhailiuk,SF,24,TOR,56,5,716,91,234,0.389,41,134,0.306,50,100,0.476,32,37,0.865,20,72,92,45,26,4,32,54,255
2022,T.J. McConnell,PG,29,IND,27,8,652,100,208,0.481,10,33,0.303,90,175,0.505,19,23,0.826,20,70,90,131,29,10,29,53,229
2022,Tacko Fall,C,26,CLE,11,1,59,5,12,0.417,0,0,,5,12,0.417,2,7,0.286,7,16,23,2,0,6,3,3,12
2022,Taj Gibson,C,36,NYK,52,4,946,86,166,0.518,15,38,0.395,71,128,0.563,42,52,0.808,88,141,229,32,22,40,27,137,229
2022,Talen Horton-Tucker,SG,21,LAL,60,19,1511,224,538,0.416,49,182,0.269,175,356,0.462,100,125,0.8,37,156,193,159,59,29,82,148,597
2022,Taurean Prince,PF,27,MIN,69,8,1177,177,390,0.454,86,229,0.376,91,161,0.564,62,82,0.756,26,148,174,68,47,23,53,116,502
2022,Terance Mann,SF,25,LAC,81,33,2317,334,690,0.484,76,208,0.365,258,482,0.539,128,164,0.78,104,321,425,209,55,21,84,178,872
2022,Terence Davis,SG,24,SAC,30,11,536,113,267,0.423,49,149,0.329,64,118,0.515,36,44,0.818,11,83,94,40,25,11,33,70,311
2022,Terrence Ross,SG,30,ORL,63,0,1448,220,554,0.397,77,264,0.292,143,290,0.467,112,130,0.862,20,141,161,116,28,12,75,68,629
2022,Terry Rozier,SG,27,CHO,73,73,2458,518,1167,0.444,222,593,0.374,296,574,0.539,150,176,0.852,56,259,315,326,93,25,96,119,1408
2022,Terry Taylor,PF,22,IND,33,7,714,135,220,0.614,12,38,0.316,123,182,0.641,36,51,0.706,95,77,172,41,14,8,23,61,318
2022,Thaddeus Young,PF,33,TOT,52,1,845,141,272,0.518,17,48,0.354,124,224,0.55,23,49,0.469,80,128,208,104,54,18,52,81,322
2022,Thanasis Antetokounmpo,SF,29,MIL,48,6,473,70,128,0.547,2,14,0.143,68,114,0.555,29,46,0.63,40,61,101,22,16,12,26,68,171
2022,Théo Maledon,PG,20,OKC,51,7,908,119,317,0.375,44,150,0.293,75,167,0.445,79,100,0.79,20,111,131,111,31,11,65,67,361
2022,Theo Pinson,SF,26,DAL,19,0,148,14,39,0.359,10,30,0.333,4,9,0.487,10,10,1,2,19,21,17,5,2,5,12,48
2022,Thomas Bryant,C,24,WAS,27,9,439,77,148,0.52,12,42,0.286,65,106,0.561,35,40,0.875,26,82,108,23,6,21,19,43,201
2022,Tim Frazier,PG,31,TOT,12,3,208,14,45,0.311,6,17,0.353,8,28,0.378,5,9,0.556,5,14,19,34,3,1,15,27,39
2022,Tim Hardaway Jr.,SG,29,DAL,42,20,1245,209,530,0.394,102,304,0.336,107,226,0.491,78,103,0.757,13,143,156,92,38,6,34,74,598
2022,Timothé Luwawu-Cabarrot,SF,26,ATL,52,18,685,74,186,0.398,44,122,0.361,30,64,0.516,35,41,0.854,17,65,82,40,18,6,20,76,227
2022,Tobias Harris,PF,29,PHI,73,73,2543,493,1022,0.482,101,275,0.367,392,747,0.532,170,202,0.842,77,419,496,252,47,43,116,164,1257
2022,Tomáš Satoranský,SG-PG-SF,30,TOT,55,13,906,72,191,0.377,11,53,0.208,61,138,0.406,43,54,0.796,27,99,126,184,29,5,46,71,198
2022,Tony Bradley,C,24,CHI,55,7,549,72,123,0.585,0,0,,72,123,0.585,19,29,0.655,67,119,186,27,10,33,34,62,163
2022,Tony Snell,SG,30,TOT,53,12,823,69,171,0.404,45,128,0.352,24,43,0.535,4,4,1,16,87,103,28,16,9,19,70,187
2022,Torrey Craig,SF,31,TOT,78,16,1596,200,441,0.454,77,234,0.329,123,207,0.541,39,52,0.75,86,224,310,91,46,36,67,151,516
2022,Trae Young,PG,23,ATL,76,76,2652,711,1544,0.46,233,610,0.382,478,934,0.536,500,553,0.904,50,234,284,737,72,7,303,128,2155
2022,Trayvon Palmer,SG,27,DET,1,0,17,0,1,0,0,0,,0,1,0,0,0,,0,2,2,0,0,0,1,2,0
2022,Tre Jones,PG,22,SAS,69,11,1148,166,339,0.49,10,51,0.196,156,288,0.504,71,91,0.78,29,126,155,233,42,7,46,78,413
2022,Tre Mann,PG,20,OKC,60,26,1367,231,588,0.393,98,272,0.36,133,316,0.476,65,82,0.793,25,146,171,91,47,12,71,102,625
2022,Tre Scott,SF,25,CLE,2,0,11,3,6,0.5,0,1,0,3,5,0.5,0,0,,1,1,2,0,1,1,0,2,6
2022,Tremont Waters,PG,24,TOT,3,0,50,4,14,0.286,2,9,0.222,2,5,0.357,0,0,,0,4,4,7,5,0,4,4,10
2022,Trendon Watford,SF,21,POR,48,10,869,142,267,0.532,9,38,0.237,133,229,0.549,71,94,0.755,57,142,199,81,25,28,44,116,364
2022,Trent Forrest,PG,23,UTA,60,6,765,76,155,0.49,5,27,0.185,71,128,0.506,38,48,0.792,23,76,99,106,30,6,48,43,195
2022,Trevelin Queen,SG,24,HOU,10,0,74,15,33,0.455,9,24,0.375,6,9,0.591,4,4,1,7,9,16,4,5,1,7,6,43
2022,Trevor Ariza,SF,36,LAL,24,11,462,33,99,0.333,20,74,0.27,13,25,0.434,10,18,0.556,10,72,82,27,13,6,11,20,96
2022,Trey Burke,PG,29,DAL,42,0,441,84,215,0.391,26,82,0.317,58,133,0.451,20,23,0.87,4,29,33,57,12,0,26,39,214
2022,Trey Lyles,PF,26,TOT,75,23,1537,262,562,0.466,67,209,0.321,195,353,0.526,195,243,0.802,89,290,379,88,29,32,73,123,786
2022,Trey Murphy III,SF,21,NOP,62,1,864,109,277,0.394,71,186,0.382,38,91,0.522,45,51,0.882,47,100,147,38,23,7,16,60,334
2022,Tristan Thompson,PF,30,TOT,57,6,897,141,267,0.528,1,3,0.333,140,264,0.53,61,116,0.526,120,168,288,34,23,21,45,98,344
2022,Troy Brown Jr.,SF,22,CHI,66,7,1055,108,258,0.419,47,133,0.353,61,125,0.51,20,26,0.769,39,164,203,66,36,5,26,62,283
2022,Ty Jerome,SG,24,OKC,48,4,801,124,328,0.378,54,186,0.29,70,142,0.46,38,47,0.809,19,59,78,109,30,5,37,73,340
2022,Tyler Cook,PF,24,CHI,20,2,200,23,38,0.605,0,0,,23,38,0.605,21,32,0.656,16,37,53,3,4,4,7,28,67
2022,Tyler Hall,SG,24,NYK,1,0,2,0,0,,0,0,,0,0,,0,0,,0,0,0,0,0,0,0,0,0
2022,Tyler Herro,SG,22,MIA,66,10,2151,501,1122,0.447,175,439,0.399,326,683,0.525,190,219,0.868,32,297,329,263,44,8,174,95,1367
2022,Tyler Johnson,PG,29,TOT,6,0,91,6,20,0.3,5,13,0.385,1,7,0.425,0,0,,3,9,12,7,3,3,2,7,17
2022,Tyrell Terry,PG,21,MEM,2,0,3,1,1,1,0,0,,1,1,1,0,0,,0,0,0,0,0,0,0,1,2
2022,Tyrese Haliburton,SG-PG,21,TOT,77,77,2695,430,909,0.473,161,389,0.414,269,520,0.562,160,190,0.842,61,250,311,628,134,49,199,121,1181
2022,Tyrese Maxey,PG,21,PHI,75,74,2650,483,995,0.485,132,309,0.427,351,686,0.552,213,246,0.866,26,214,240,321,55,32,88,156,1311
2022,Tyrone Wallace,SG,27,NOP,6,0,75,7,20,0.35,2,8,0.25,5,12,0.4,1,5,0.2,0,8,8,1,3,1,2,7,17
2022,Tyus Jones,PG,25,MEM,73,23,1549,249,552,0.451,80,205,0.39,169,347,0.524,54,66,0.818,17,159,176,324,66,2,46,32,632
2022,Udoka Azubuike,C,22,UTA,17,6,195,37,49,0.755,0,0,,37,49,0.755,6,11,0.545,18,53,71,0,1,11,12,25,80
2022,Udonis Haslem,C,41,MIA,13,0,83,14,31,0.452,1,4,0.25,13,27,0.468,3,3,1,4,21,25,4,1,1,5,15,32
2022,Usman Garuba,PF,19,HOU,24,2,239,19,44,0.432,5,20,0.25,14,24,0.489,5,7,0.714,21,62,83,17,10,11,6,28,48
2022,Vernon Carey Jr.,C,20,TOT,7,1,44,7,13,0.538,0,0,,7,13,0.538,6,13,0.462,8,4,12,0,2,1,3,4,20
2022,Victor Oladipo,SG,29,MIA,8,1,173,35,73,0.479,15,36,0.417,20,37,0.582,14,19,0.737,3,20,23,28,5,1,16,13,99
2022,Vit Krejci,SG,21,OKC,30,8,690,68,167,0.407,32,98,0.327,36,69,0.503,19,22,0.864,18,83,101,57,19,8,29,65,187
2022,Vlatko Čančar,PF,24,DEN,15,1,176,23,41,0.561,7,12,0.583,16,29,0.646,9,14,0.643,8,23,31,17,2,3,9,18,62
2022,Wayne Ellington,SG,34,LAL,43,9,810,98,237,0.414,82,211,0.389,16,26,0.586,9,11,0.818,10,67,77,30,23,5,19,42,287
2022,Wayne Selden,SG,27,NYK,3,0,19,1,4,0.25,1,2,0.5,0,2,0.375,2,4,0.5,0,1,1,1,0,0,0,1,5
2022,Wendell Carter Jr.,PF,22,ORL,62,61,1852,359,684,0.525,70,214,0.327,289,470,0.576,143,207,0.691,139,509,648,171,36,43,117,169,931
2022,Wenyen Gabriel,PF,24,TOT,26,5,358,54,110,0.491,8,28,0.286,46,82,0.527,25,42,0.595,39,58,97,14,5,11,16,68,141
2022,Wes Iwundu,SF,27,ATL,3,1,82,8,18,0.444,3,5,0.6,5,13,0.528,3,4,0.75,3,10,13,0,1,0,1,8,22
2022,Wesley Matthews,SG,35,MIL,49,14,1002,87,220,0.395,53,157,0.338,34,63,0.516,22,28,0.786,30,62,92,36,23,8,18,87,249
2022,Will Barton,SG,31,DEN,71,71,2277,392,896,0.438,157,430,0.365,235,466,0.525,102,127,0.803,44,296,340,276,55,31,127,114,1043
2022,Willie Cauley-Stein,C,28,TOT,20,2,183,16,35,0.457,1,2,0.5,15,33,0.471,1,2,0.5,13,27,40,10,6,3,7,19,34
2022,Willy Hernangómez,C,27,NOP,50,8,839,170,327,0.52,4,12,0.333,166,315,0.526,109,141,0.773,143,195,338,63,21,19,51,97,453
2022,Xavier Moon,SG,27,LAC,10,0,137,25,51,0.49,5,14,0.357,20,37,0.539,3,5,0.6,2,12,14,24,7,3,6,9,58
2022,Xavier Sneed,SF,24,TOT,9,0,39,2,10,0.2,1,8,0.125,1,2,0.25,0,0,,2,4,6,1,0,0,0,2,5
2022,Xavier Tillman Sr.,PF,23,MEM,53,2,701,98,216,0.454,10,49,0.204,88,167,0.477,46,71,0.648,66,95,161,62,49,15,34,63,252
2022,Yuta Watanabe,SF,27,TOR,38,4,445,56,138,0.406,27,79,0.342,29,59,0.504,24,40,0.6,18,74,92,21,11,16,19,38,163
2022,Yves Pons,SF,22,MEM,12,0,71,5,16,0.313,3,9,0.333,2,7,0.406,0,2,0,5,7,12,1,1,4,1,6,13
2022,Zach Collins,C,24,SAS,28,4,502,76,155,0.49,14,41,0.341,62,114,0.535,52,65,0.8,46,107,153,61,13,23,45,67,218
2022,Zach LaVine,SG,26,CHI,67,67,2328,565,1186,0.476,185,475,0.389,380,711,0.554,320,375,0.853,22,286,308,303,41,23,171,120,1635
2022,Zavier Simpson,PG,24,OKC,4,4,174,19,52,0.365,1,8,0.125,18,44,0.375,5,5,1,2,19,21,30,5,4,10,15,44
2022,Zeke Nnaji,PF,21,DEN,41,1,698,96,186,0.516,37,80,0.463,59,106,0.616,41,65,0.631,56,91,147,17,16,13,23,79,270
2022,Ziaire Williams,SF,20,MEM,62,31,1346,191,424,0.45,76,242,0.314,115,182,0.54,43,55,0.782,26,103,129,65,35,12,41,113,501
2022,Zylan Cheatham,SF,26,UTA,1,0,5,0,3,0,0,2,0,0,1,0,0,0,,0,0,0,0,0,0,0,0,0
,,,,,,,,,,,,,,,,,,,,,,,,,,,,
,,,,,,,,,,,,,,,,,,,,,,,,,,,,
,,,,,,,,,,,,,,,,,,,,,,,,,,,,
,,,,,,,,,,,,,,,,,,,,,,,,,,,,
,,,,,,,,,,,,,,,,,,,,,,,,,,,,
,,,,,,,,,,,,,,,,,,,,,,,,,,,,
,,,,,,,,,,,,,,,,,,,,,,,,,,,,
,,,,,,,,,,,,,,,,,,,,,,,,,,,,
,,,,,,,,,,,,,,,,,,,,,,,,,,,,
,,,,,,,,,,,,,,,,,,,,,,,,,,,,
,,,,,,,,,,,,,,,,,,,,,,,,,,,,
,,,,,,,,,,,,,,,,,,,,,,,,,,,,
,,,,,,,,,,,,,,,,,,,,,,,,,,,,
,,,,,,,,,,,,,,,,,,,,,,,,,,,,
,,,,,,,,,,,,,,,,,,,,,,,,,,,,
,,,,,,,,,,,,,,,,,,,,,,,,,,,,
,,,,,,,,,,,,,,,,,,,,,,,,,,,,
,,,,,,,,,,,,,,,,,,,,,,,,,,,,
,,,,,,,,,,,,,,,,,,,,,,,,,,,,
,,,,,,,,,,,,,,,,,,,,,,,,,,,,
,,,,,,,,,,,,,,,,,,,,,,,,,,,,
,,,,,,,,,,,,,,,,,,,,,,,,,,,,
,,,,,,,,,,,,,,,,,,,,,,,,,,,,
,,,,,,,,,,,,,,,,,,,,,,,,,,,,
,,,,,,,,,,,,,,,,,,,,,,,,,,,,
,,,,,,,,,,,,,,,,,,,,,,,,,,,,
,,,,,,,,,,,,,,,,,,,,,,,,,,,,
,,,,,,,,,,,,,,,,,,,,,,,,,,,,
,,,,,,,,,,,,,,,,,,,,,,,,,,,,
,,,,,,,,,,,,,,,,,,,,,,,,,,,,
,,,,,,,,,,,,,,,,,,,,,,,,,,,,
,,,,,,,,,,,,,,,,,,,,,,,,,,,,
,,,,,,,,,,,,,,,,,,,,,,,,,,,,
,,,,,,,,,,,,,,,,,,,,,,,,,,,,
,,,,,,,,,,,,,,,,,,,,,,,,,,,,
,,,,,,,,,,,,,,,,,,,,,,,,,,,,
,,,,,,,,,,,,,,,,,,,,,,,,,,,,
,,,,,,,,,,,,,,,,,,,,,,,,,,,,
,,,,,,,,,,,,,,,,,,,,,,,,,,,,
,,,,,,,,,,,,,,,,,,,,,,,,,,,,
,,,,,,,,,,,,,,,,,,,,,,,,,,,,
,,,,,,,,,,,,,,,,,,,,,,,,,,,,
,,,,,,,,,,,,,,,,,,,,,,,,,,,,
,,,,,,,,,,,,,,,,,,,,,,,,,,,,
,,,,,,,,,,,,,,,,,,,,,,,,,,,,
,,,,,,,,,,,,,,,,,,,,,,,,,,,,
,,,,,,,,,,,,,,,,,,,,,,,,,,,,
,,,,,,,,,,,,,,,,,,,,,,,,,,,,
,,,,,,,,,,,,,,,,,,,,,,,,,,,,
,,,,,,,,,,,,,,,,,,,,,,,,,,,,
,,,,,,,,,,,,,,,,,,,,,,,,,,,,
,,,,,,,,,,,,,,,,,,,,,,,,,,,,
,,,,,,,,,,,,,,,,,,,,,,,,,,,,
,,,,,,,,,,,,,,,,,,,,,,,,,,,,
,,,,,,,,,,,,,,,,,,,,,,,,,,,,
,,,,,,,,,,,,,,,,,,,,,,,,,,,,
,,,,,,,,,,,,,,,,,,,,,,,,,,,,
,,,,,,,,,,,,,,,,,,,,,,,,,,,,
,,,,,,,,,,,,,,,,,,,,,,,,,,,,
,,,,,,,,,,,,,,,,,,,,,,,,,,,,
,,,,,,,,,,,,,,,,,,,,,,,,,,,,
,,,,,,,,,,,,,,,,,,,,,,,,,,,,
,,,,,,,,,,,,,,,,,,,,,,,,,,,,
,,,,,,,,,,,,,,,,,,,,,,,,,,,,
,,,,,,,,,,,,,,,,,,,,,,,,,,,,
,,,,,,,,,,,,,,,,,,,,,,,,,,,,
,,,,,,,,,,,,,,,,,,,,,,,,,,,,
,,,,,,,,,,,,,,,,,,,,,,,,,,,,
,,,,,,,,,,,,,,,,,,,,,,,,,,,,
,,,,,,,,,,,,,,,,,,,,,,,,,,,,
,,,,,,,,,,,,,,,,,,,,,,,,,,,,